"Date","Long-MEXICAN PESO","Short-MEXICAN PESO","Net-MEXICAN PESO","Names","Unit"
2014-01-07,38449,20842,17607,"MEXICAN PESO - CHICAGO MERCANTILE EXCHANGE ","(CONTRACTS OF MXN 500,000) "
2014-01-14,32495,18778,13717,"MEXICAN PESO - CHICAGO MERCANTILE EXCHANGE ","(CONTRACTS OF MXN 500,000) "
2014-01-21,26739,30367,-3628,"MEXICAN PESO - CHICAGO MERCANTILE EXCHANGE ","(CONTRACTS OF MXN 500,000) "
2014-01-28,20730,56046,-35316,"MEXICAN PESO - CHICAGO MERCANTILE EXCHANGE ","(CONTRACTS OF MXN 500,000) "
2014-02-04,13694,48209,-34515,"MEXICAN PESO - CHICAGO MERCANTILE EXCHANGE ","(CONTRACTS OF MXN 500,000) "
2014-02-11,9682,43622,-33940,"MEXICAN PESO - CHICAGO MERCANTILE EXCHANGE ","(CONTRACTS OF MXN 500,000) "
2014-02-18,8094,31406,-23312,"MEXICAN PESO - CHICAGO MERCANTILE EXCHANGE ","(CONTRACTS OF MXN 500,000) "
2014-02-25,9971,31540,-21569,"MEXICAN PESO - CHICAGO MERCANTILE EXCHANGE ","(CONTRACTS OF MXN 500,000) "
2014-03-04,8230,28980,-20750,"MEXICAN PESO - CHICAGO MERCANTILE EXCHANGE ","(CONTRACTS OF MXN 500,000) "
2014-03-11,12739,20986,-8247,"MEXICAN PESO - CHICAGO MERCANTILE EXCHANGE ","(CONTRACTS OF MXN 500,000) "
2014-03-18,19320,20590,-1270,"MEXICAN PESO - CHICAGO MERCANTILE EXCHANGE ","(CONTRACTS OF MXN 500,000) "
2014-03-25,22769,24423,-1654,"MEXICAN PESO - CHICAGO MERCANTILE EXCHANGE ","(CONTRACTS OF MXN 500,000) "
2014-04-01,49893,28109,21784,"MEXICAN PESO - CHICAGO MERCANTILE EXCHANGE ","(CONTRACTS OF MXN 500,000) "
2014-04-08,70371,13870,56501,"MEXICAN PESO - CHICAGO MERCANTILE EXCHANGE ","(CONTRACTS OF MXN 500,000) "
2014-04-15,71038,16801,54237,"MEXICAN PESO - CHICAGO MERCANTILE EXCHANGE ","(CONTRACTS OF MXN 500,000) "
2014-04-22,68329,14818,53511,"MEXICAN PESO - CHICAGO MERCANTILE EXCHANGE ","(CONTRACTS OF MXN 500,000) "
2014-04-29,68073,18455,49618,"MEXICAN PESO - CHICAGO MERCANTILE EXCHANGE ","(CONTRACTS OF MXN 500,000) "
2014-05-06,67663,19779,47884,"MEXICAN PESO - CHICAGO MERCANTILE EXCHANGE ","(CONTRACTS OF MXN 500,000) "
2014-05-13,86137,17515,68622,"MEXICAN PESO - CHICAGO MERCANTILE EXCHANGE ","(CONTRACTS OF MXN 500,000) "
2014-05-20,92730,15464,77266,"MEXICAN PESO - CHICAGO MERCANTILE EXCHANGE ","(CONTRACTS OF MXN 500,000) "
2014-05-27,101808,18507,83301,"MEXICAN PESO - CHICAGO MERCANTILE EXCHANGE ","(CONTRACTS OF MXN 500,000) "
2014-06-03,105666,19650,86016,"MEXICAN PESO - CHICAGO MERCANTILE EXCHANGE ","(CONTRACTS OF MXN 500,000) "
2014-06-10,106566,16363,90203,"MEXICAN PESO - CHICAGO MERCANTILE EXCHANGE ","(CONTRACTS OF MXN 500,000) "
2014-06-17,91227,22152,69075,"MEXICAN PESO - CHICAGO MERCANTILE EXCHANGE ","(CONTRACTS OF MXN 500,000) "
2014-06-24,84943,15974,68969,"MEXICAN PESO - CHICAGO MERCANTILE EXCHANGE ","(CONTRACTS OF MXN 500,000) "
2014-07-01,85387,15825,69562,"MEXICAN PESO - CHICAGO MERCANTILE EXCHANGE ","(CONTRACTS OF MXN 500,000) "
2014-07-08,82777,13966,68811,"MEXICAN PESO - CHICAGO MERCANTILE EXCHANGE ","(CONTRACTS OF MXN 500,000) "
2014-07-15,86707,17070,69637,"MEXICAN PESO - CHICAGO MERCANTILE EXCHANGE ","(CONTRACTS OF MXN 500,000) "
2014-07-22,98823,19689,79134,"MEXICAN PESO - CHICAGO MERCANTILE EXCHANGE ","(CONTRACTS OF MXN 500,000) "
2014-07-29,100551,23436,77115,"MEXICAN PESO - CHICAGO MERCANTILE EXCHANGE ","(CONTRACTS OF MXN 500,000) "
2014-08-05,77535,45102,32433,"MEXICAN PESO - CHICAGO MERCANTILE EXCHANGE ","(CONTRACTS OF MXN 500,000) "
2014-08-12,51933,51974,-41,"MEXICAN PESO - CHICAGO MERCANTILE EXCHANGE ","(CONTRACTS OF MXN 500,000) "
2014-08-19,56207,43800,12407,"MEXICAN PESO - CHICAGO MERCANTILE EXCHANGE ","(CONTRACTS OF MXN 500,000) "
2014-08-26,71680,35010,36670,"MEXICAN PESO - CHICAGO MERCANTILE EXCHANGE ","(CONTRACTS OF MXN 500,000) "
2014-09-02,75444,36280,39164,"MEXICAN PESO - CHICAGO MERCANTILE EXCHANGE ","(CONTRACTS OF MXN 500,000) "
2014-09-09,71021,32503,38518,"MEXICAN PESO - CHICAGO MERCANTILE EXCHANGE ","(CONTRACTS OF MXN 500,000) "
2014-09-16,69430,47384,22046,"MEXICAN PESO - CHICAGO MERCANTILE EXCHANGE ","(CONTRACTS OF MXN 500,000) "
2014-09-23,58278,47774,10504,"MEXICAN PESO - CHICAGO MERCANTILE EXCHANGE ","(CONTRACTS OF MXN 500,000) "
2014-09-30,48864,56178,-7314,"MEXICAN PESO - CHICAGO MERCANTILE EXCHANGE ","(CONTRACTS OF MXN 500,000) "
2014-10-07,43781,51364,-7583,"MEXICAN PESO - CHICAGO MERCANTILE EXCHANGE ","(CONTRACTS OF MXN 500,000) "
2014-10-14,39798,45561,-5763,"MEXICAN PESO - CHICAGO MERCANTILE EXCHANGE ","(CONTRACTS OF MXN 500,000) "
2014-10-21,30087,51211,-21124,"MEXICAN PESO - CHICAGO MERCANTILE EXCHANGE ","(CONTRACTS OF MXN 500,000) "
2014-10-28,26832,53675,-26843,"MEXICAN PESO - CHICAGO MERCANTILE EXCHANGE ","(CONTRACTS OF MXN 500,000) "
2014-11-04,30218,56808,-26590,"MEXICAN PESO - CHICAGO MERCANTILE EXCHANGE ","(CONTRACTS OF MXN 500,000) "
2014-11-11,29393,59067,-29674,"MEXICAN PESO - CHICAGO MERCANTILE EXCHANGE ","(CONTRACTS OF MXN 500,000) "
2014-11-18,31305,60339,-29034,"MEXICAN PESO - CHICAGO MERCANTILE EXCHANGE ","(CONTRACTS OF MXN 500,000) "
2014-11-25,26386,58938,-32552,"MEXICAN PESO - CHICAGO MERCANTILE EXCHANGE ","(CONTRACTS OF MXN 500,000) "
2014-12-02,30210,73214,-43004,"MEXICAN PESO - CHICAGO MERCANTILE EXCHANGE ","(CONTRACTS OF MXN 500,000) "
2014-12-09,32116,80710,-48594,"MEXICAN PESO - CHICAGO MERCANTILE EXCHANGE ","(CONTRACTS OF MXN 500,000) "
2014-12-16,25843,78599,-52756,"MEXICAN PESO - CHICAGO MERCANTILE EXCHANGE ","(CONTRACTS OF MXN 500,000) "
2014-12-23,17311,80681,-63370,"MEXICAN PESO - CHICAGO MERCANTILE EXCHANGE ","(CONTRACTS OF MXN 500,000) "
2014-12-30,15878,79683,-63805,"MEXICAN PESO - CHICAGO MERCANTILE EXCHANGE ","(CONTRACTS OF MXN 500,000) "
2015-01-06,18667,83118,-64451,"MEXICAN PESO - CHICAGO MERCANTILE EXCHANGE","(CONTRACTS OF MXN 500,000)"
2015-01-13,17305,71600,-54295,"MEXICAN PESO - CHICAGO MERCANTILE EXCHANGE","(CONTRACTS OF MXN 500,000)"
2015-01-20,19017,65280,-46263,"MEXICAN PESO - CHICAGO MERCANTILE EXCHANGE","(CONTRACTS OF MXN 500,000)"
2015-01-27,26739,71312,-44573,"MEXICAN PESO - CHICAGO MERCANTILE EXCHANGE","(CONTRACTS OF MXN 500,000)"
2015-02-03,23599,71836,-48237,"MEXICAN PESO - CHICAGO MERCANTILE EXCHANGE","(CONTRACTS OF MXN 500,000)"
2015-02-10,25691,74926,-49235,"MEXICAN PESO - CHICAGO MERCANTILE EXCHANGE","(CONTRACTS OF MXN 500,000)"
2015-02-17,28873,74318,-45445,"MEXICAN PESO - CHICAGO MERCANTILE EXCHANGE","(CONTRACTS OF MXN 500,000)"
2015-02-24,34105,82449,-48344,"MEXICAN PESO - CHICAGO MERCANTILE EXCHANGE","(CONTRACTS OF MXN 500,000)"
2015-03-03,31414,74821,-43407,"MEXICAN PESO - CHICAGO MERCANTILE EXCHANGE","(CONTRACTS OF MXN 500,000)"
2015-03-10,30622,66269,-35647,"MEXICAN PESO - CHICAGO MERCANTILE EXCHANGE","(CONTRACTS OF MXN 500,000)"
2015-03-17,23702,79641,-55939,"MEXICAN PESO - CHICAGO MERCANTILE EXCHANGE","(CONTRACTS OF MXN 500,000)"
2015-03-24,35044,76144,-41100,"MEXICAN PESO - CHICAGO MERCANTILE EXCHANGE","(CONTRACTS OF MXN 500,000)"
2015-03-31,43289,73578,-30289,"MEXICAN PESO - CHICAGO MERCANTILE EXCHANGE","(CONTRACTS OF MXN 500,000)"
2015-04-07,42185,65110,-22925,"MEXICAN PESO - CHICAGO MERCANTILE EXCHANGE","(CONTRACTS OF MXN 500,000)"
2015-04-14,63521,55160,8361,"MEXICAN PESO - CHICAGO MERCANTILE EXCHANGE","(CONTRACTS OF MXN 500,000)"
2015-04-21,50343,64018,-13675,"MEXICAN PESO - CHICAGO MERCANTILE EXCHANGE","(CONTRACTS OF MXN 500,000)"
2015-04-28,38003,61394,-23391,"MEXICAN PESO - CHICAGO MERCANTILE EXCHANGE","(CONTRACTS OF MXN 500,000)"
2015-05-05,24046,74162,-50116,"MEXICAN PESO - CHICAGO MERCANTILE EXCHANGE","(CONTRACTS OF MXN 500,000)"
2015-05-12,34027,61066,-27039,"MEXICAN PESO - CHICAGO MERCANTILE EXCHANGE","(CONTRACTS OF MXN 500,000)"
2015-05-19,23706,55037,-31331,"MEXICAN PESO - CHICAGO MERCANTILE EXCHANGE","(CONTRACTS OF MXN 500,000)"
2015-05-26,23943,56459,-32516,"MEXICAN PESO - CHICAGO MERCANTILE EXCHANGE","(CONTRACTS OF MXN 500,000)"
2015-06-02,33983,79110,-45127,"MEXICAN PESO - CHICAGO MERCANTILE EXCHANGE","(CONTRACTS OF MXN 500,000)"
2015-06-09,28602,79734,-51132,"MEXICAN PESO - CHICAGO MERCANTILE EXCHANGE","(CONTRACTS OF MXN 500,000)"
2015-06-16,28245,80735,-52490,"MEXICAN PESO - CHICAGO MERCANTILE EXCHANGE","(CONTRACTS OF MXN 500,000)"
2015-06-23,39402,67269,-27867,"MEXICAN PESO - CHICAGO MERCANTILE EXCHANGE","(CONTRACTS OF MXN 500,000)"
2015-06-30,36051,74810,-38759,"MEXICAN PESO - CHICAGO MERCANTILE EXCHANGE","(CONTRACTS OF MXN 500,000)"
2015-07-07,24067,96482,-72415,"MEXICAN PESO - CHICAGO MERCANTILE EXCHANGE","(CONTRACTS OF MXN 500,000)"
2015-07-14,19965,92683,-72718,"MEXICAN PESO - CHICAGO MERCANTILE EXCHANGE","(CONTRACTS OF MXN 500,000)"
2015-07-21,21371,102795,-81424,"MEXICAN PESO - CHICAGO MERCANTILE EXCHANGE","(CONTRACTS OF MXN 500,000)"
2015-07-28,21846,110689,-88843,"MEXICAN PESO - CHICAGO MERCANTILE EXCHANGE","(CONTRACTS OF MXN 500,000)"
2015-08-04,22590,104638,-82048,"MEXICAN PESO - CHICAGO MERCANTILE EXCHANGE","(CONTRACTS OF MXN 500,000)"
2015-08-11,18163,88732,-70569,"MEXICAN PESO - CHICAGO MERCANTILE EXCHANGE","(CONTRACTS OF MXN 500,000)"
2015-08-18,24629,85056,-60427,"MEXICAN PESO - CHICAGO MERCANTILE EXCHANGE","(CONTRACTS OF MXN 500,000)"
2015-08-25,20401,103454,-83053,"MEXICAN PESO - CHICAGO MERCANTILE EXCHANGE","(CONTRACTS OF MXN 500,000)"
2015-09-01,21353,98290,-76937,"MEXICAN PESO - CHICAGO MERCANTILE EXCHANGE","(CONTRACTS OF MXN 500,000)"
2015-09-08,22880,93831,-70951,"MEXICAN PESO - CHICAGO MERCANTILE EXCHANGE","(CONTRACTS OF MXN 500,000)"
2015-09-15,21749,77034,-55285,"MEXICAN PESO - CHICAGO MERCANTILE EXCHANGE","(CONTRACTS OF MXN 500,000)"
2015-09-22,47626,59982,-12356,"MEXICAN PESO - CHICAGO MERCANTILE EXCHANGE","(CONTRACTS OF MXN 500,000)"
2015-09-29,31276,75727,-44451,"MEXICAN PESO - CHICAGO MERCANTILE EXCHANGE","(CONTRACTS OF MXN 500,000)"
2015-10-06,50942,56185,-5243,"MEXICAN PESO - CHICAGO MERCANTILE EXCHANGE","(CONTRACTS OF MXN 500,000)"
2015-10-13,47411,51554,-4143,"MEXICAN PESO - CHICAGO MERCANTILE EXCHANGE","(CONTRACTS OF MXN 500,000)"
2015-10-20,50627,51243,-616,"MEXICAN PESO - CHICAGO MERCANTILE EXCHANGE","(CONTRACTS OF MXN 500,000)"
2015-10-27,52078,52161,-83,"MEXICAN PESO - CHICAGO MERCANTILE EXCHANGE","(CONTRACTS OF MXN 500,000)"
2015-11-03,52097,52832,-735,"MEXICAN PESO - CHICAGO MERCANTILE EXCHANGE","(CONTRACTS OF MXN 500,000)"
2015-11-10,43865,62700,-18835,"MEXICAN PESO - CHICAGO MERCANTILE EXCHANGE","(CONTRACTS OF MXN 500,000)"
2015-11-17,41435,79698,-38263,"MEXICAN PESO - CHICAGO MERCANTILE EXCHANGE","(CONTRACTS OF MXN 500,000)"
2015-11-24,50323,79584,-29261,"MEXICAN PESO - CHICAGO MERCANTILE EXCHANGE","(CONTRACTS OF MXN 500,000)"
2015-12-01,48974,74439,-25465,"MEXICAN PESO - CHICAGO MERCANTILE EXCHANGE","(CONTRACTS OF MXN 500,000)"
2015-12-08,45226,69607,-24381,"MEXICAN PESO - CHICAGO MERCANTILE EXCHANGE","(CONTRACTS OF MXN 500,000)"
2015-12-15,34779,95151,-60372,"MEXICAN PESO - CHICAGO MERCANTILE EXCHANGE","(CONTRACTS OF MXN 500,000)"
2015-12-22,28736,85455,-56719,"MEXICAN PESO - CHICAGO MERCANTILE EXCHANGE","(CONTRACTS OF MXN 500,000)"
2015-12-29,30566,87953,-57387,"MEXICAN PESO - CHICAGO MERCANTILE EXCHANGE","(CONTRACTS OF MXN 500,000)"
2016-01-05,33894,95882,-61988,"MEXICAN PESO - CHICAGO MERCANTILE EXCHANGE","(CONTRACTS OF MXN 500,000)"
2016-01-12,29415,103430,-74015,"MEXICAN PESO - CHICAGO MERCANTILE EXCHANGE","(CONTRACTS OF MXN 500,000)"
2016-01-19,30361,106364,-76003,"MEXICAN PESO - CHICAGO MERCANTILE EXCHANGE","(CONTRACTS OF MXN 500,000)"
2016-01-26,28487,105094,-76607,"MEXICAN PESO - CHICAGO MERCANTILE EXCHANGE","(CONTRACTS OF MXN 500,000)"
2016-02-02,24958,103552,-78594,"MEXICAN PESO - CHICAGO MERCANTILE EXCHANGE","(CONTRACTS OF MXN 500,000)"
2016-02-09,41732,88254,-46522,"MEXICAN PESO - CHICAGO MERCANTILE EXCHANGE","(CONTRACTS OF MXN 500,000)"
2016-02-16,21445,98830,-77385,"MEXICAN PESO - CHICAGO MERCANTILE EXCHANGE","(CONTRACTS OF MXN 500,000)"
2016-02-23,30149,83008,-52859,"MEXICAN PESO - CHICAGO MERCANTILE EXCHANGE","(CONTRACTS OF MXN 500,000)"
2016-03-01,25194,81667,-56473,"MEXICAN PESO - CHICAGO MERCANTILE EXCHANGE","(CONTRACTS OF MXN 500,000)"
2016-03-08,20441,77995,-57554,"MEXICAN PESO - CHICAGO MERCANTILE EXCHANGE","(CONTRACTS OF MXN 500,000)"
2016-03-15,23040,68077,-45037,"MEXICAN PESO - CHICAGO MERCANTILE EXCHANGE","(CONTRACTS OF MXN 500,000)"
2016-03-22,28550,74246,-45696,"MEXICAN PESO - CHICAGO MERCANTILE EXCHANGE","(CONTRACTS OF MXN 500,000)"
2016-03-29,33005,73801,-40796,"MEXICAN PESO - CHICAGO MERCANTILE EXCHANGE","(CONTRACTS OF MXN 500,000)"
2016-04-05,40864,72742,-31878,"MEXICAN PESO - CHICAGO MERCANTILE EXCHANGE","(CONTRACTS OF MXN 500,000)"
2016-04-12,40518,87109,-46591,"MEXICAN PESO - CHICAGO MERCANTILE EXCHANGE","(CONTRACTS OF MXN 500,000)"
2016-04-19,43925,58334,-14409,"MEXICAN PESO - CHICAGO MERCANTILE EXCHANGE","(CONTRACTS OF MXN 500,000)"
2016-04-26,34602,53917,-19315,"MEXICAN PESO - CHICAGO MERCANTILE EXCHANGE","(CONTRACTS OF MXN 500,000)"
2016-05-03,35753,48173,-12420,"MEXICAN PESO - CHICAGO MERCANTILE EXCHANGE","(CONTRACTS OF MXN 500,000)"
2016-05-10,16149,61369,-45220,"MEXICAN PESO - CHICAGO MERCANTILE EXCHANGE","(CONTRACTS OF MXN 500,000)"
2016-05-17,25219,70910,-45691,"MEXICAN PESO - CHICAGO MERCANTILE EXCHANGE","(CONTRACTS OF MXN 500,000)"
2016-05-24,27017,74477,-47460,"MEXICAN PESO - CHICAGO MERCANTILE EXCHANGE","(CONTRACTS OF MXN 500,000)"
2016-05-31,20193,75808,-55615,"MEXICAN PESO - CHICAGO MERCANTILE EXCHANGE","(CONTRACTS OF MXN 500,000)"
2016-06-07,22389,81698,-59309,"MEXICAN PESO - CHICAGO MERCANTILE EXCHANGE","(CONTRACTS OF MXN 500,000)"
2016-06-14,16894,82513,-65619,"MEXICAN PESO - CHICAGO MERCANTILE EXCHANGE","(CONTRACTS OF MXN 500,000)"
2016-06-21,13509,82389,-68880,"MEXICAN PESO - CHICAGO MERCANTILE EXCHANGE","(CONTRACTS OF MXN 500,000)"
2016-06-28,13390,78717,-65327,"MEXICAN PESO - CHICAGO MERCANTILE EXCHANGE","(CONTRACTS OF MXN 500,000)"
2016-07-05,24238,69095,-44857,"MEXICAN PESO - CHICAGO MERCANTILE EXCHANGE","(CONTRACTS OF MXN 500,000)"
2016-07-12,28648,65820,-37172,"MEXICAN PESO - CHICAGO MERCANTILE EXCHANGE","(CONTRACTS OF MXN 500,000)"
2016-07-19,24675,64041,-39366,"MEXICAN PESO - CHICAGO MERCANTILE EXCHANGE","(CONTRACTS OF MXN 500,000)"
2016-07-26,24114,70676,-46562,"MEXICAN PESO - CHICAGO MERCANTILE EXCHANGE","(CONTRACTS OF MXN 500,000)"
2016-08-02,23915,76038,-52123,"MEXICAN PESO - CHICAGO MERCANTILE EXCHANGE","(CONTRACTS OF MXN 500,000)"
2016-08-09,19963,74325,-54362,"MEXICAN PESO - CHICAGO MERCANTILE EXCHANGE","(CONTRACTS OF MXN 500,000)"
2016-08-16,24542,70265,-45723,"MEXICAN PESO - CHICAGO MERCANTILE EXCHANGE","(CONTRACTS OF MXN 500,000)"
2016-08-23,26845,55386,-28541,"MEXICAN PESO - CHICAGO MERCANTILE EXCHANGE","(CONTRACTS OF MXN 500,000)"
2016-08-30,19848,53082,-33234,"MEXICAN PESO - CHICAGO MERCANTILE EXCHANGE","(CONTRACTS OF MXN 500,000)"
2016-09-06,16790,75189,-58399,"MEXICAN PESO - CHICAGO MERCANTILE EXCHANGE","(CONTRACTS OF MXN 500,000)"
2016-09-13,19930,85677,-65747,"MEXICAN PESO - CHICAGO MERCANTILE EXCHANGE","(CONTRACTS OF MXN 500,000)"
2016-09-20,20526,109868,-89342,"MEXICAN PESO - CHICAGO MERCANTILE EXCHANGE","(CONTRACTS OF MXN 500,000)"
2016-09-27,24865,110738,-85873,"MEXICAN PESO - CHICAGO MERCANTILE EXCHANGE","(CONTRACTS OF MXN 500,000)"
2016-10-04,22358,108250,-85892,"MEXICAN PESO - CHICAGO MERCANTILE EXCHANGE","(CONTRACTS OF MXN 500,000)"
2016-10-11,38060,89852,-51792,"MEXICAN PESO - CHICAGO MERCANTILE EXCHANGE","(CONTRACTS OF MXN 500,000)"
2016-10-18,33364,64083,-30719,"MEXICAN PESO - CHICAGO MERCANTILE EXCHANGE","(CONTRACTS OF MXN 500,000)"
2016-10-25,28677,54020,-25343,"MEXICAN PESO - CHICAGO MERCANTILE EXCHANGE","(CONTRACTS OF MXN 500,000)"
2016-11-01,30838,67310,-36472,"MEXICAN PESO - CHICAGO MERCANTILE EXCHANGE","(CONTRACTS OF MXN 500,000)"
2016-11-08,25298,58294,-32996,"MEXICAN PESO - CHICAGO MERCANTILE EXCHANGE","(CONTRACTS OF MXN 500,000)"
2016-11-15,22124,67277,-45153,"MEXICAN PESO - CHICAGO MERCANTILE EXCHANGE","(CONTRACTS OF MXN 500,000)"
2016-11-22,19884,68198,-48314,"MEXICAN PESO - CHICAGO MERCANTILE EXCHANGE","(CONTRACTS OF MXN 500,000)"
2016-11-29,19314,73814,-54500,"MEXICAN PESO - CHICAGO MERCANTILE EXCHANGE","(CONTRACTS OF MXN 500,000)"
2016-12-06,18619,72685,-54066,"MEXICAN PESO - CHICAGO MERCANTILE EXCHANGE","(CONTRACTS OF MXN 500,000)"
2016-12-13,19001,76660,-57659,"MEXICAN PESO - CHICAGO MERCANTILE EXCHANGE","(CONTRACTS OF MXN 500,000)"
2016-12-20,20806,87487,-66681,"MEXICAN PESO - CHICAGO MERCANTILE EXCHANGE","(CONTRACTS OF MXN 500,000)"
2016-12-27,21411,83068,-61657,"MEXICAN PESO - CHICAGO MERCANTILE EXCHANGE","(CONTRACTS OF MXN 500,000)"
2017-01-03,22279,87915,-65636,"MEXICAN PESO - CHICAGO MERCANTILE EXCHANGE","(CONTRACTS OF MXN 500,000)"
2017-01-10,23878,95654,-71776,"MEXICAN PESO - CHICAGO MERCANTILE EXCHANGE","(CONTRACTS OF MXN 500,000)"
2017-01-17,22573,95894,-73321,"MEXICAN PESO - CHICAGO MERCANTILE EXCHANGE","(CONTRACTS OF MXN 500,000)"
2017-01-24,32133,96787,-64654,"MEXICAN PESO - CHICAGO MERCANTILE EXCHANGE","(CONTRACTS OF MXN 500,000)"
2017-01-31,26000,89208,-63208,"MEXICAN PESO - CHICAGO MERCANTILE EXCHANGE","(CONTRACTS OF MXN 500,000)"
2017-02-07,31229,89717,-58488,"MEXICAN PESO - CHICAGO MERCANTILE EXCHANGE","(CONTRACTS OF MXN 500,000)"
2017-02-14,30271,90484,-60213,"MEXICAN PESO - CHICAGO MERCANTILE EXCHANGE","(CONTRACTS OF MXN 500,000)"
2017-02-21,35125,91606,-56481,"MEXICAN PESO - CHICAGO MERCANTILE EXCHANGE","(CONTRACTS OF MXN 500,000)"
2017-02-28,39057,84840,-45783,"MEXICAN PESO - CHICAGO MERCANTILE EXCHANGE","(CONTRACTS OF MXN 500,000)"
2017-03-07,38707,81465,-42758,"MEXICAN PESO - CHICAGO MERCANTILE EXCHANGE","(CONTRACTS OF MXN 500,000)"
2017-03-14,51271,56738,-5467,"MEXICAN PESO - CHICAGO MERCANTILE EXCHANGE","(CONTRACTS OF MXN 500,000)"
2017-03-21,57730,61011,-3281,"MEXICAN PESO - CHICAGO MERCANTILE EXCHANGE","(CONTRACTS OF MXN 500,000)"
2017-03-28,72728,77465,-4737,"MEXICAN PESO - CHICAGO MERCANTILE EXCHANGE","(CONTRACTS OF MXN 500,000)"
2017-04-04,80979,90667,-9688,"MEXICAN PESO - CHICAGO MERCANTILE EXCHANGE","(CONTRACTS OF MXN 500,000)"
2017-04-11,86813,99488,-12675,"MEXICAN PESO - CHICAGO MERCANTILE EXCHANGE","(CONTRACTS OF MXN 500,000)"
2017-04-18,97027,82783,14244,"MEXICAN PESO - CHICAGO MERCANTILE EXCHANGE","(CONTRACTS OF MXN 500,000)"
2017-04-25,91689,75651,16038,"MEXICAN PESO - CHICAGO MERCANTILE EXCHANGE","(CONTRACTS OF MXN 500,000)"
2017-05-02,91142,76027,15115,"MEXICAN PESO - CHICAGO MERCANTILE EXCHANGE","(CONTRACTS OF MXN 500,000)"
2017-05-09,92514,22611,69903,"MEXICAN PESO - CHICAGO MERCANTILE EXCHANGE","(CONTRACTS OF MXN 500,000)"
2017-05-16,92686,22632,70054,"MEXICAN PESO - CHICAGO MERCANTILE EXCHANGE","(CONTRACTS OF MXN 500,000)"
2017-05-23,98609,44311,54298,"MEXICAN PESO - CHICAGO MERCANTILE EXCHANGE","(CONTRACTS OF MXN 500,000)"
2017-05-30,112479,37477,75002,"MEXICAN PESO - CHICAGO MERCANTILE EXCHANGE","(CONTRACTS OF MXN 500,000)"
