"Date","Long-RUSSIAN RUBLE","Short-RUSSIAN RUBLE","Net-RUSSIAN RUBLE","Names","Unit"
2014-01-07,8225,5660,2565,"RUSSIAN RUBLE - CHICAGO MERCANTILE EXCHANGE ","(CONTRACTS OF RUB 2,500,000) "
2014-01-14,6636,5234,1402,"RUSSIAN RUBLE - CHICAGO MERCANTILE EXCHANGE ","(CONTRACTS OF RUB 2,500,000) "
2014-01-21,4217,4503,-286,"RUSSIAN RUBLE - CHICAGO MERCANTILE EXCHANGE ","(CONTRACTS OF RUB 2,500,000) "
2014-01-28,3457,4758,-1301,"RUSSIAN RUBLE - CHICAGO MERCANTILE EXCHANGE ","(CONTRACTS OF RUB 2,500,000) "
2014-02-04,2738,4830,-2092,"RUSSIAN RUBLE - CHICAGO MERCANTILE EXCHANGE ","(CONTRACTS OF RUB 2,500,000) "
2014-02-11,5757,7649,-1892,"RUSSIAN RUBLE - CHICAGO MERCANTILE EXCHANGE ","(CONTRACTS OF RUB 2,500,000) "
2014-02-18,4386,9317,-4931,"RUSSIAN RUBLE - CHICAGO MERCANTILE EXCHANGE ","(CONTRACTS OF RUB 2,500,000) "
2014-02-25,4028,8596,-4568,"RUSSIAN RUBLE - CHICAGO MERCANTILE EXCHANGE ","(CONTRACTS OF RUB 2,500,000) "
2014-03-04,5095,8877,-3782,"RUSSIAN RUBLE - CHICAGO MERCANTILE EXCHANGE ","(CONTRACTS OF RUB 2,500,000) "
2014-03-18,3732,7879,-4147,"RUSSIAN RUBLE - CHICAGO MERCANTILE EXCHANGE ","(CONTRACTS OF RUB 2,500,000) "
2014-04-01,3438,5672,-2234,"RUSSIAN RUBLE - CHICAGO MERCANTILE EXCHANGE ","(CONTRACTS OF RUB 2,500,000) "
2014-04-15,4219,6619,-2400,"RUSSIAN RUBLE - CHICAGO MERCANTILE EXCHANGE ","(CONTRACTS OF RUB 2,500,000) "
2014-04-22,4830,7220,-2390,"RUSSIAN RUBLE - CHICAGO MERCANTILE EXCHANGE ","(CONTRACTS OF RUB 2,500,000) "
2014-04-29,5549,8641,-3092,"RUSSIAN RUBLE - CHICAGO MERCANTILE EXCHANGE ","(CONTRACTS OF RUB 2,500,000) "
2014-05-06,5688,9142,-3454,"RUSSIAN RUBLE - CHICAGO MERCANTILE EXCHANGE ","(CONTRACTS OF RUB 2,500,000) "
2014-05-13,5932,8945,-3013,"RUSSIAN RUBLE - CHICAGO MERCANTILE EXCHANGE ","(CONTRACTS OF RUB 2,500,000) "
2014-05-20,6399,8200,-1801,"RUSSIAN RUBLE - CHICAGO MERCANTILE EXCHANGE ","(CONTRACTS OF RUB 2,500,000) "
2014-05-27,6531,7170,-639,"RUSSIAN RUBLE - CHICAGO MERCANTILE EXCHANGE ","(CONTRACTS OF RUB 2,500,000) "
2014-06-03,7409,7285,124,"RUSSIAN RUBLE - CHICAGO MERCANTILE EXCHANGE ","(CONTRACTS OF RUB 2,500,000) "
2014-06-10,7084,7213,-129,"RUSSIAN RUBLE - CHICAGO MERCANTILE EXCHANGE ","(CONTRACTS OF RUB 2,500,000) "
2014-06-17,7487,3661,3826,"RUSSIAN RUBLE - CHICAGO MERCANTILE EXCHANGE ","(CONTRACTS OF RUB 2,500,000) "
2014-06-24,7763,3661,4102,"RUSSIAN RUBLE - CHICAGO MERCANTILE EXCHANGE ","(CONTRACTS OF RUB 2,500,000) "
2014-07-01,7619,3663,3956,"RUSSIAN RUBLE - CHICAGO MERCANTILE EXCHANGE ","(CONTRACTS OF RUB 2,500,000) "
2014-07-08,6215,3663,2552,"RUSSIAN RUBLE - CHICAGO MERCANTILE EXCHANGE ","(CONTRACTS OF RUB 2,500,000) "
2014-07-15,6652,4015,2637,"RUSSIAN RUBLE - CHICAGO MERCANTILE EXCHANGE ","(CONTRACTS OF RUB 2,500,000) "
2014-07-22,5538,4109,1429,"RUSSIAN RUBLE - CHICAGO MERCANTILE EXCHANGE ","(CONTRACTS OF RUB 2,500,000) "
2014-07-29,6450,5650,800,"RUSSIAN RUBLE - CHICAGO MERCANTILE EXCHANGE ","(CONTRACTS OF RUB 2,500,000) "
2014-08-05,3900,6407,-2507,"RUSSIAN RUBLE - CHICAGO MERCANTILE EXCHANGE ","(CONTRACTS OF RUB 2,500,000) "
2014-08-12,4850,6909,-2059,"RUSSIAN RUBLE - CHICAGO MERCANTILE EXCHANGE ","(CONTRACTS OF RUB 2,500,000) "
2014-08-19,7150,7920,-770,"RUSSIAN RUBLE - CHICAGO MERCANTILE EXCHANGE ","(CONTRACTS OF RUB 2,500,000) "
2014-08-26,6915,7679,-764,"RUSSIAN RUBLE - CHICAGO MERCANTILE EXCHANGE ","(CONTRACTS OF RUB 2,500,000) "
2014-09-02,7606,8477,-871,"RUSSIAN RUBLE - CHICAGO MERCANTILE EXCHANGE ","(CONTRACTS OF RUB 2,500,000) "
2014-09-09,6517,8036,-1519,"RUSSIAN RUBLE - CHICAGO MERCANTILE EXCHANGE ","(CONTRACTS OF RUB 2,500,000) "
2014-09-16,4477,7148,-2671,"RUSSIAN RUBLE - CHICAGO MERCANTILE EXCHANGE ","(CONTRACTS OF RUB 2,500,000) "
2014-09-23,6315,7157,-842,"RUSSIAN RUBLE - CHICAGO MERCANTILE EXCHANGE ","(CONTRACTS OF RUB 2,500,000) "
2014-09-30,6883,7807,-924,"RUSSIAN RUBLE - CHICAGO MERCANTILE EXCHANGE ","(CONTRACTS OF RUB 2,500,000) "
2014-10-07,7094,8828,-1734,"RUSSIAN RUBLE - CHICAGO MERCANTILE EXCHANGE ","(CONTRACTS OF RUB 2,500,000) "
2014-10-14,6316,10234,-3918,"RUSSIAN RUBLE - CHICAGO MERCANTILE EXCHANGE ","(CONTRACTS OF RUB 2,500,000) "
2014-10-21,4433,9936,-5503,"RUSSIAN RUBLE - CHICAGO MERCANTILE EXCHANGE ","(CONTRACTS OF RUB 2,500,000) "
2014-10-28,4760,10527,-5767,"RUSSIAN RUBLE - CHICAGO MERCANTILE EXCHANGE ","(CONTRACTS OF RUB 2,500,000) "
2014-11-04,5237,11429,-6192,"RUSSIAN RUBLE - CHICAGO MERCANTILE EXCHANGE ","(CONTRACTS OF RUB 2,500,000) "
2014-11-11,4445,8527,-4082,"RUSSIAN RUBLE - CHICAGO MERCANTILE EXCHANGE ","(CONTRACTS OF RUB 2,500,000) "
2014-11-18,4445,8050,-3605,"RUSSIAN RUBLE - CHICAGO MERCANTILE EXCHANGE ","(CONTRACTS OF RUB 2,500,000) "
2014-11-25,6755,8852,-2097,"RUSSIAN RUBLE - CHICAGO MERCANTILE EXCHANGE ","(CONTRACTS OF RUB 2,500,000) "
2014-12-02,4519,7057,-2538,"RUSSIAN RUBLE - CHICAGO MERCANTILE EXCHANGE ","(CONTRACTS OF RUB 2,500,000) "
2014-12-09,4519,7081,-2562,"RUSSIAN RUBLE - CHICAGO MERCANTILE EXCHANGE ","(CONTRACTS OF RUB 2,500,000) "
2014-12-16,3936,1349,2587,"RUSSIAN RUBLE - CHICAGO MERCANTILE EXCHANGE ","(CONTRACTS OF RUB 2,500,000) "
2014-12-23,5099,1203,3896,"RUSSIAN RUBLE - CHICAGO MERCANTILE EXCHANGE ","(CONTRACTS OF RUB 2,500,000) "
2014-12-30,5039,1176,3863,"RUSSIAN RUBLE - CHICAGO MERCANTILE EXCHANGE ","(CONTRACTS OF RUB 2,500,000) "
2015-01-06,5047,1068,3979,"RUSSIAN RUBLE - CHICAGO MERCANTILE EXCHANGE","(CONTRACTS OF RUB 2,500,000)"
2015-01-13,5243,942,4301,"RUSSIAN RUBLE - CHICAGO MERCANTILE EXCHANGE","(CONTRACTS OF RUB 2,500,000)"
2015-01-20,5688,1132,4556,"RUSSIAN RUBLE - CHICAGO MERCANTILE EXCHANGE","(CONTRACTS OF RUB 2,500,000)"
2015-01-27,6114,1372,4742,"RUSSIAN RUBLE - CHICAGO MERCANTILE EXCHANGE","(CONTRACTS OF RUB 2,500,000)"
2015-02-03,3870,2259,1611,"RUSSIAN RUBLE - CHICAGO MERCANTILE EXCHANGE","(CONTRACTS OF RUB 2,500,000)"
2015-02-10,4581,2615,1966,"RUSSIAN RUBLE - CHICAGO MERCANTILE EXCHANGE","(CONTRACTS OF RUB 2,500,000)"
2015-02-17,3435,2059,1376,"RUSSIAN RUBLE - CHICAGO MERCANTILE EXCHANGE","(CONTRACTS OF RUB 2,500,000)"
2015-02-24,4874,1901,2973,"RUSSIAN RUBLE - CHICAGO MERCANTILE EXCHANGE","(CONTRACTS OF RUB 2,500,000)"
2015-03-03,8263,3039,5224,"RUSSIAN RUBLE - CHICAGO MERCANTILE EXCHANGE","(CONTRACTS OF RUB 2,500,000)"
2015-03-10,8627,4489,4138,"RUSSIAN RUBLE - CHICAGO MERCANTILE EXCHANGE","(CONTRACTS OF RUB 2,500,000)"
2015-03-17,7999,5617,2382,"RUSSIAN RUBLE - CHICAGO MERCANTILE EXCHANGE","(CONTRACTS OF RUB 2,500,000)"
2015-03-24,8089,5354,2735,"RUSSIAN RUBLE - CHICAGO MERCANTILE EXCHANGE","(CONTRACTS OF RUB 2,500,000)"
2015-03-31,8211,5279,2932,"RUSSIAN RUBLE - CHICAGO MERCANTILE EXCHANGE","(CONTRACTS OF RUB 2,500,000)"
2015-04-07,6668,5198,1470,"RUSSIAN RUBLE - CHICAGO MERCANTILE EXCHANGE","(CONTRACTS OF RUB 2,500,000)"
2015-04-14,5857,5239,618,"RUSSIAN RUBLE - CHICAGO MERCANTILE EXCHANGE","(CONTRACTS OF RUB 2,500,000)"
2015-04-21,6164,4798,1366,"RUSSIAN RUBLE - CHICAGO MERCANTILE EXCHANGE","(CONTRACTS OF RUB 2,500,000)"
2015-04-28,6201,4954,1247,"RUSSIAN RUBLE - CHICAGO MERCANTILE EXCHANGE","(CONTRACTS OF RUB 2,500,000)"
2015-05-05,6018,5289,729,"RUSSIAN RUBLE - CHICAGO MERCANTILE EXCHANGE","(CONTRACTS OF RUB 2,500,000)"
2015-05-12,6198,5568,630,"RUSSIAN RUBLE - CHICAGO MERCANTILE EXCHANGE","(CONTRACTS OF RUB 2,500,000)"
2015-05-19,5949,5792,157,"RUSSIAN RUBLE - CHICAGO MERCANTILE EXCHANGE","(CONTRACTS OF RUB 2,500,000)"
2015-05-26,6074,5781,293,"RUSSIAN RUBLE - CHICAGO MERCANTILE EXCHANGE","(CONTRACTS OF RUB 2,500,000)"
2015-06-02,6984,4849,2135,"RUSSIAN RUBLE - CHICAGO MERCANTILE EXCHANGE","(CONTRACTS OF RUB 2,500,000)"
2015-06-09,5668,4566,1102,"RUSSIAN RUBLE - CHICAGO MERCANTILE EXCHANGE","(CONTRACTS OF RUB 2,500,000)"
2015-06-16,3494,1310,2184,"RUSSIAN RUBLE - CHICAGO MERCANTILE EXCHANGE","(CONTRACTS OF RUB 2,500,000)"
2015-06-23,3879,1812,2067,"RUSSIAN RUBLE - CHICAGO MERCANTILE EXCHANGE","(CONTRACTS OF RUB 2,500,000)"
2015-06-30,3390,1399,1991,"RUSSIAN RUBLE - CHICAGO MERCANTILE EXCHANGE","(CONTRACTS OF RUB 2,500,000)"
2015-07-07,2308,1309,999,"RUSSIAN RUBLE - CHICAGO MERCANTILE EXCHANGE","(CONTRACTS OF RUB 2,500,000)"
2015-07-14,2212,4213,-2001,"RUSSIAN RUBLE - CHICAGO MERCANTILE EXCHANGE","(CONTRACTS OF RUB 2,500,000)"
2015-07-21,2277,3970,-1693,"RUSSIAN RUBLE - CHICAGO MERCANTILE EXCHANGE","(CONTRACTS OF RUB 2,500,000)"
2015-07-28,2375,3494,-1119,"RUSSIAN RUBLE - CHICAGO MERCANTILE EXCHANGE","(CONTRACTS OF RUB 2,500,000)"
2015-08-04,2665,3690,-1025,"RUSSIAN RUBLE - CHICAGO MERCANTILE EXCHANGE","(CONTRACTS OF RUB 2,500,000)"
2015-08-11,2815,3505,-690,"RUSSIAN RUBLE - CHICAGO MERCANTILE EXCHANGE","(CONTRACTS OF RUB 2,500,000)"
2015-08-18,3444,3733,-289,"RUSSIAN RUBLE - CHICAGO MERCANTILE EXCHANGE","(CONTRACTS OF RUB 2,500,000)"
2015-08-25,2839,3369,-530,"RUSSIAN RUBLE - CHICAGO MERCANTILE EXCHANGE","(CONTRACTS OF RUB 2,500,000)"
2015-09-01,2566,5962,-3396,"RUSSIAN RUBLE - CHICAGO MERCANTILE EXCHANGE","(CONTRACTS OF RUB 2,500,000)"
2015-09-08,2732,3539,-807,"RUSSIAN RUBLE - CHICAGO MERCANTILE EXCHANGE","(CONTRACTS OF RUB 2,500,000)"
2015-09-15,2761,3290,-529,"RUSSIAN RUBLE - CHICAGO MERCANTILE EXCHANGE","(CONTRACTS OF RUB 2,500,000)"
2015-09-22,1157,3700,-2543,"RUSSIAN RUBLE - CHICAGO MERCANTILE EXCHANGE","(CONTRACTS OF RUB 2,500,000)"
2015-09-29,1157,2937,-1780,"RUSSIAN RUBLE - CHICAGO MERCANTILE EXCHANGE","(CONTRACTS OF RUB 2,500,000)"
2015-10-06,1487,1615,-128,"RUSSIAN RUBLE - CHICAGO MERCANTILE EXCHANGE","(CONTRACTS OF RUB 2,500,000)"
2015-10-13,3706,2535,1171,"RUSSIAN RUBLE - CHICAGO MERCANTILE EXCHANGE","(CONTRACTS OF RUB 2,500,000)"
2015-10-20,3802,1728,2074,"RUSSIAN RUBLE - CHICAGO MERCANTILE EXCHANGE","(CONTRACTS OF RUB 2,500,000)"
2015-10-27,3433,1343,2090,"RUSSIAN RUBLE - CHICAGO MERCANTILE EXCHANGE","(CONTRACTS OF RUB 2,500,000)"
2015-11-03,3495,1442,2053,"RUSSIAN RUBLE - CHICAGO MERCANTILE EXCHANGE","(CONTRACTS OF RUB 2,500,000)"
2015-11-10,3534,1263,2271,"RUSSIAN RUBLE - CHICAGO MERCANTILE EXCHANGE","(CONTRACTS OF RUB 2,500,000)"
2015-11-17,2160,812,1348,"RUSSIAN RUBLE - CHICAGO MERCANTILE EXCHANGE","(CONTRACTS OF RUB 2,500,000)"
2015-11-24,2969,1353,1616,"RUSSIAN RUBLE - CHICAGO MERCANTILE EXCHANGE","(CONTRACTS OF RUB 2,500,000)"
2015-12-01,2276,1446,830,"RUSSIAN RUBLE - CHICAGO MERCANTILE EXCHANGE","(CONTRACTS OF RUB 2,500,000)"
2015-12-08,2464,2341,123,"RUSSIAN RUBLE - CHICAGO MERCANTILE EXCHANGE","(CONTRACTS OF RUB 2,500,000)"
2015-12-15,3252,2416,836,"RUSSIAN RUBLE - CHICAGO MERCANTILE EXCHANGE","(CONTRACTS OF RUB 2,500,000)"
2015-12-22,2492,3327,-835,"RUSSIAN RUBLE - CHICAGO MERCANTILE EXCHANGE","(CONTRACTS OF RUB 2,500,000)"
2015-12-29,2809,3593,-784,"RUSSIAN RUBLE - CHICAGO MERCANTILE EXCHANGE","(CONTRACTS OF RUB 2,500,000)"
2016-01-05,2880,3378,-498,"RUSSIAN RUBLE - CHICAGO MERCANTILE EXCHANGE","(CONTRACTS OF RUB 2,500,000)"
2016-01-12,3080,3737,-657,"RUSSIAN RUBLE - CHICAGO MERCANTILE EXCHANGE","(CONTRACTS OF RUB 2,500,000)"
2016-01-19,3372,2721,651,"RUSSIAN RUBLE - CHICAGO MERCANTILE EXCHANGE","(CONTRACTS OF RUB 2,500,000)"
2016-01-26,4188,2124,2064,"RUSSIAN RUBLE - CHICAGO MERCANTILE EXCHANGE","(CONTRACTS OF RUB 2,500,000)"
2016-02-02,5325,3685,1640,"RUSSIAN RUBLE - CHICAGO MERCANTILE EXCHANGE","(CONTRACTS OF RUB 2,500,000)"
2016-02-09,5093,3437,1656,"RUSSIAN RUBLE - CHICAGO MERCANTILE EXCHANGE","(CONTRACTS OF RUB 2,500,000)"
2016-02-16,5928,4700,1228,"RUSSIAN RUBLE - CHICAGO MERCANTILE EXCHANGE","(CONTRACTS OF RUB 2,500,000)"
2016-02-23,5427,3993,1434,"RUSSIAN RUBLE - CHICAGO MERCANTILE EXCHANGE","(CONTRACTS OF RUB 2,500,000)"
2016-03-01,5115,3273,1842,"RUSSIAN RUBLE - CHICAGO MERCANTILE EXCHANGE","(CONTRACTS OF RUB 2,500,000)"
2016-03-08,5804,3203,2601,"RUSSIAN RUBLE - CHICAGO MERCANTILE EXCHANGE","(CONTRACTS OF RUB 2,500,000)"
2016-03-15,5939,797,5142,"RUSSIAN RUBLE - CHICAGO MERCANTILE EXCHANGE","(CONTRACTS OF RUB 2,500,000)"
2016-03-22,5920,2792,3128,"RUSSIAN RUBLE - CHICAGO MERCANTILE EXCHANGE","(CONTRACTS OF RUB 2,500,000)"
2016-03-29,5907,2903,3004,"RUSSIAN RUBLE - CHICAGO MERCANTILE EXCHANGE","(CONTRACTS OF RUB 2,500,000)"
2016-04-05,6046,2665,3381,"RUSSIAN RUBLE - CHICAGO MERCANTILE EXCHANGE","(CONTRACTS OF RUB 2,500,000)"
2016-04-12,6141,3345,2796,"RUSSIAN RUBLE - CHICAGO MERCANTILE EXCHANGE","(CONTRACTS OF RUB 2,500,000)"
2016-04-19,7173,4372,2801,"RUSSIAN RUBLE - CHICAGO MERCANTILE EXCHANGE","(CONTRACTS OF RUB 2,500,000)"
2016-04-26,7075,4358,2717,"RUSSIAN RUBLE - CHICAGO MERCANTILE EXCHANGE","(CONTRACTS OF RUB 2,500,000)"
2016-05-03,7945,3494,4451,"RUSSIAN RUBLE - CHICAGO MERCANTILE EXCHANGE","(CONTRACTS OF RUB 2,500,000)"
2016-05-10,6627,2485,4142,"RUSSIAN RUBLE - CHICAGO MERCANTILE EXCHANGE","(CONTRACTS OF RUB 2,500,000)"
2016-05-17,6849,2747,4102,"RUSSIAN RUBLE - CHICAGO MERCANTILE EXCHANGE","(CONTRACTS OF RUB 2,500,000)"
2016-05-24,6849,2537,4312,"RUSSIAN RUBLE - CHICAGO MERCANTILE EXCHANGE","(CONTRACTS OF RUB 2,500,000)"
2016-05-31,7509,2918,4591,"RUSSIAN RUBLE - CHICAGO MERCANTILE EXCHANGE","(CONTRACTS OF RUB 2,500,000)"
2016-06-07,8086,3908,4178,"RUSSIAN RUBLE - CHICAGO MERCANTILE EXCHANGE","(CONTRACTS OF RUB 2,500,000)"
2016-06-14,14538,8311,6227,"RUSSIAN RUBLE - CHICAGO MERCANTILE EXCHANGE","(CONTRACTS OF RUB 2,500,000)"
2016-06-21,16553,11165,5388,"RUSSIAN RUBLE - CHICAGO MERCANTILE EXCHANGE","(CONTRACTS OF RUB 2,500,000)"
2016-06-28,16470,10530,5940,"RUSSIAN RUBLE - CHICAGO MERCANTILE EXCHANGE","(CONTRACTS OF RUB 2,500,000)"
2016-07-05,17072,11394,5678,"RUSSIAN RUBLE - CHICAGO MERCANTILE EXCHANGE","(CONTRACTS OF RUB 2,500,000)"
2016-07-12,18937,11205,7732,"RUSSIAN RUBLE - CHICAGO MERCANTILE EXCHANGE","(CONTRACTS OF RUB 2,500,000)"
2016-07-19,21423,11552,9871,"RUSSIAN RUBLE - CHICAGO MERCANTILE EXCHANGE","(CONTRACTS OF RUB 2,500,000)"
2016-07-26,20146,10688,9458,"RUSSIAN RUBLE - CHICAGO MERCANTILE EXCHANGE","(CONTRACTS OF RUB 2,500,000)"
2016-08-02,15822,7557,8265,"RUSSIAN RUBLE - CHICAGO MERCANTILE EXCHANGE","(CONTRACTS OF RUB 2,500,000)"
2016-08-09,13541,6483,7058,"RUSSIAN RUBLE - CHICAGO MERCANTILE EXCHANGE","(CONTRACTS OF RUB 2,500,000)"
2016-08-16,15892,7943,7949,"RUSSIAN RUBLE - CHICAGO MERCANTILE EXCHANGE","(CONTRACTS OF RUB 2,500,000)"
2016-08-23,20294,11350,8944,"RUSSIAN RUBLE - CHICAGO MERCANTILE EXCHANGE","(CONTRACTS OF RUB 2,500,000)"
2016-08-30,21442,10744,10698,"RUSSIAN RUBLE - CHICAGO MERCANTILE EXCHANGE","(CONTRACTS OF RUB 2,500,000)"
2016-09-06,21344,11095,10249,"RUSSIAN RUBLE - CHICAGO MERCANTILE EXCHANGE","(CONTRACTS OF RUB 2,500,000)"
2016-09-13,21869,11173,10696,"RUSSIAN RUBLE - CHICAGO MERCANTILE EXCHANGE","(CONTRACTS OF RUB 2,500,000)"
2016-09-20,22550,14811,7739,"RUSSIAN RUBLE - CHICAGO MERCANTILE EXCHANGE","(CONTRACTS OF RUB 2,500,000)"
2016-09-27,24138,12109,12029,"RUSSIAN RUBLE - CHICAGO MERCANTILE EXCHANGE","(CONTRACTS OF RUB 2,500,000)"
2016-10-04,31116,13710,17406,"RUSSIAN RUBLE - CHICAGO MERCANTILE EXCHANGE","(CONTRACTS OF RUB 2,500,000)"
2016-10-11,31537,13867,17670,"RUSSIAN RUBLE - CHICAGO MERCANTILE EXCHANGE","(CONTRACTS OF RUB 2,500,000)"
2016-10-18,32552,654,31898,"RUSSIAN RUBLE - CHICAGO MERCANTILE EXCHANGE","(CONTRACTS OF RUB 2,500,000)"
2016-10-25,32755,416,32339,"RUSSIAN RUBLE - CHICAGO MERCANTILE EXCHANGE","(CONTRACTS OF RUB 2,500,000)"
2016-11-01,31865,674,31191,"RUSSIAN RUBLE - CHICAGO MERCANTILE EXCHANGE","(CONTRACTS OF RUB 2,500,000)"
2016-11-08,30416,713,29703,"RUSSIAN RUBLE - CHICAGO MERCANTILE EXCHANGE","(CONTRACTS OF RUB 2,500,000)"
2016-11-15,26703,140,26563,"RUSSIAN RUBLE - CHICAGO MERCANTILE EXCHANGE","(CONTRACTS OF RUB 2,500,000)"
2016-11-22,21926,0,21926,"RUSSIAN RUBLE - CHICAGO MERCANTILE EXCHANGE","(CONTRACTS OF RUB 2,500,000)"
2016-11-29,21996,0,21996,"RUSSIAN RUBLE - CHICAGO MERCANTILE EXCHANGE","(CONTRACTS OF RUB 2,500,000)"
2016-12-06,21413,0,21413,"RUSSIAN RUBLE - CHICAGO MERCANTILE EXCHANGE","(CONTRACTS OF RUB 2,500,000)"
2016-12-13,20962,134,20828,"RUSSIAN RUBLE - CHICAGO MERCANTILE EXCHANGE","(CONTRACTS OF RUB 2,500,000)"
2016-12-20,16865,2297,14568,"RUSSIAN RUBLE - CHICAGO MERCANTILE EXCHANGE","(CONTRACTS OF RUB 2,500,000)"
2016-12-27,16429,2050,14379,"RUSSIAN RUBLE - CHICAGO MERCANTILE EXCHANGE","(CONTRACTS OF RUB 2,500,000)"
2017-01-03,16903,2175,14728,"RUSSIAN RUBLE - CHICAGO MERCANTILE EXCHANGE","(CONTRACTS OF RUB 2,500,000)"
2017-01-10,17746,2117,15629,"RUSSIAN RUBLE - CHICAGO MERCANTILE EXCHANGE","(CONTRACTS OF RUB 2,500,000)"
2017-01-17,18279,1483,16796,"RUSSIAN RUBLE - CHICAGO MERCANTILE EXCHANGE","(CONTRACTS OF RUB 2,500,000)"
2017-01-24,19744,2279,17465,"RUSSIAN RUBLE - CHICAGO MERCANTILE EXCHANGE","(CONTRACTS OF RUB 2,500,000)"
2017-01-31,19617,2382,17235,"RUSSIAN RUBLE - CHICAGO MERCANTILE EXCHANGE","(CONTRACTS OF RUB 2,500,000)"
2017-02-07,19931,2403,17528,"RUSSIAN RUBLE - CHICAGO MERCANTILE EXCHANGE","(CONTRACTS OF RUB 2,500,000)"
2017-02-14,19639,1437,18202,"RUSSIAN RUBLE - CHICAGO MERCANTILE EXCHANGE","(CONTRACTS OF RUB 2,500,000)"
2017-02-21,19175,1515,17660,"RUSSIAN RUBLE - CHICAGO MERCANTILE EXCHANGE","(CONTRACTS OF RUB 2,500,000)"
2017-02-28,18310,1113,17197,"RUSSIAN RUBLE - CHICAGO MERCANTILE EXCHANGE","(CONTRACTS OF RUB 2,500,000)"
2017-03-07,17635,913,16722,"RUSSIAN RUBLE - CHICAGO MERCANTILE EXCHANGE","(CONTRACTS OF RUB 2,500,000)"
2017-03-14,18169,750,17419,"RUSSIAN RUBLE - CHICAGO MERCANTILE EXCHANGE","(CONTRACTS OF RUB 2,500,000)"
2017-03-21,19800,1157,18643,"RUSSIAN RUBLE - CHICAGO MERCANTILE EXCHANGE","(CONTRACTS OF RUB 2,500,000)"
2017-03-28,20805,1429,19376,"RUSSIAN RUBLE - CHICAGO MERCANTILE EXCHANGE","(CONTRACTS OF RUB 2,500,000)"
2017-04-04,26561,6429,20132,"RUSSIAN RUBLE - CHICAGO MERCANTILE EXCHANGE","(CONTRACTS OF RUB 2,500,000)"
2017-04-11,27233,7170,20063,"RUSSIAN RUBLE - CHICAGO MERCANTILE EXCHANGE","(CONTRACTS OF RUB 2,500,000)"
2017-04-18,27013,7353,19660,"RUSSIAN RUBLE - CHICAGO MERCANTILE EXCHANGE","(CONTRACTS OF RUB 2,500,000)"
2017-04-25,27896,7687,20209,"RUSSIAN RUBLE - CHICAGO MERCANTILE EXCHANGE","(CONTRACTS OF RUB 2,500,000)"
2017-05-02,22631,3665,18966,"RUSSIAN RUBLE - CHICAGO MERCANTILE EXCHANGE","(CONTRACTS OF RUB 2,500,000)"
2017-05-09,12648,1653,10995,"RUSSIAN RUBLE - CHICAGO MERCANTILE EXCHANGE","(CONTRACTS OF RUB 2,500,000)"
2017-05-16,11976,1983,9993,"RUSSIAN RUBLE - CHICAGO MERCANTILE EXCHANGE","(CONTRACTS OF RUB 2,500,000)"
2017-05-23,10272,2147,8125,"RUSSIAN RUBLE - CHICAGO MERCANTILE EXCHANGE","(CONTRACTS OF RUB 2,500,000)"
2017-05-30,9990,2127,7863,"RUSSIAN RUBLE - CHICAGO MERCANTILE EXCHANGE","(CONTRACTS OF RUB 2,500,000)"
2017-06-06,9806,2184,7622,"RUSSIAN RUBLE - CHICAGO MERCANTILE EXCHANGE","(CONTRACTS OF RUB 2,500,000)"
2017-06-13,8954,2601,6353,"RUSSIAN RUBLE - CHICAGO MERCANTILE EXCHANGE","(CONTRACTS OF RUB 2,500,000)"
2017-06-20,4128,2696,1432,"RUSSIAN RUBLE - CHICAGO MERCANTILE EXCHANGE","(CONTRACTS OF RUB 2,500,000)"
2017-06-27,4906,5574,-668,"RUSSIAN RUBLE - CHICAGO MERCANTILE EXCHANGE","(CONTRACTS OF RUB 2,500,000)"
