"Date","OPEC:Import","OPEC:Export","OPEC:Balance(E-I)","European Union:Import","European Union:Export","European Union:Balance(E-I)","World, Seasonally Adjusted:Import","World, Seasonally Adjusted:Export","World, Seasonally Adjusted:Balance(E-I)","NAFTA with Mexico (Consump):Import","NAFTA with Mexico (Consump):Export","NAFTA with Mexico (Consump):Balance(E-I)","NAFTA with Canada (Consump):Import","NAFTA with Canada (Consump):Export","NAFTA with Canada (Consump):Balance(E-I)","Advance Technology Products:Import","Advance Technology Products:Export","Advance Technology Products:Balance(E-I)","NICS:Import","NICS:Export","NICS:Balance(E-I)","South and Central America:Import","South and Central America:Export","South and Central America:Balance(E-I)","North America:Import","North America:Export","North America:Balance(E-I)","Europe:Import","Europe:Export","Europe:Balance(E-I)","Africa:Import","Africa:Export","Africa:Balance(E-I)","Pacific Rim:Import","Pacific Rim:Export","Pacific Rim:Balance(E-I)","World, Not Seasonally Adjusted:Import","World, Not Seasonally Adjusted:Export","World, Not Seasonally Adjusted:Balance(E-I)","Asia:Import","Asia:Export","Asia:Balance(E-I)","CAFTA-DR:Import","CAFTA-DR:Export","CAFTA-DR:Balance(E-I)","Australia and Oceania:Import","Australia and Oceania:Export","Australia and Oceania:Balance(E-I)","Sub Saharan Africa:Import","Sub Saharan Africa:Export","Sub Saharan Africa:Balance(E-I)","Greenland:Import","Greenland:Export","Greenland:Balance(E-I)","Canada:Import","Canada:Export","Canada:Balance(E-I)","St Pierre and Miquelon:Import","St Pierre and Miquelon:Export","St Pierre and Miquelon:Balance(E-I)","Mexico:Import","Mexico:Export","Mexico:Balance(E-I)","Guatemala:Import","Guatemala:Export","Guatemala:Balance(E-I)","Belize:Import","Belize:Export","Belize:Balance(E-I)","El Salvador:Import","El Salvador:Export","El Salvador:Balance(E-I)","Honduras:Import","Honduras:Export","Honduras:Balance(E-I)","Nicaragua:Import","Nicaragua:Export","Nicaragua:Balance(E-I)","Costa Rica:Import","Costa Rica:Export","Costa Rica:Balance(E-I)","Panama:Import","Panama:Export","Panama:Balance(E-I)","Bermuda:Import","Bermuda:Export","Bermuda:Balance(E-I)","Bahamas:Import","Bahamas:Export","Bahamas:Balance(E-I)","Cuba:Import","Cuba:Export","Cuba:Balance(E-I)","Jamaica:Import","Jamaica:Export","Jamaica:Balance(E-I)","Turks and Caicos Islands:Import","Turks and Caicos Islands:Export","Turks and Caicos Islands:Balance(E-I)","Cayman Islands:Import","Cayman Islands:Export","Cayman Islands:Balance(E-I)","Haiti:Import","Haiti:Export","Haiti:Balance(E-I)","Dominican Republic:Import","Dominican Republic:Export","Dominican Republic:Balance(E-I)","Anguilla:Import","Anguilla:Export","Anguilla:Balance(E-I)","British Virgin Islands:Import","British Virgin Islands:Export","British Virgin Islands:Balance(E-I)","St Kitts and Nevis:Import","St Kitts and Nevis:Export","St Kitts and Nevis:Balance(E-I)","Antigua and Barbuda:Import","Antigua and Barbuda:Export","Antigua and Barbuda:Balance(E-I)","Montserrat:Import","Montserrat:Export","Montserrat:Balance(E-I)","Dominica:Import","Dominica:Export","Dominica:Balance(E-I)","St Lucia:Import","St Lucia:Export","St Lucia:Balance(E-I)","St Vincent and the Grenadines:Import","St Vincent and the Grenadines:Export","St Vincent and the Grenadines:Balance(E-I)","Grenada:Import","Grenada:Export","Grenada:Balance(E-I)","Barbados:Import","Barbados:Export","Barbados:Balance(E-I)","Trinidad and Tobago:Import","Trinidad and Tobago:Export","Trinidad and Tobago:Balance(E-I)","Netherlands Antilles:Import","Netherlands Antilles:Export","Netherlands Antilles:Balance(E-I)","Sint Maarten:Import","Sint Maarten:Export","Sint Maarten:Balance(E-I)","Curacao:Import","Curacao:Export","Curacao:Balance(E-I)","Aruba:Import","Aruba:Export","Aruba:Balance(E-I)","Guadeloupe:Import","Guadeloupe:Export","Guadeloupe:Balance(E-I)","Martinique:Import","Martinique:Export","Martinique:Balance(E-I)","Colombia:Import","Colombia:Export","Colombia:Balance(E-I)","Venezuela:Import","Venezuela:Export","Venezuela:Balance(E-I)","Guyana:Import","Guyana:Export","Guyana:Balance(E-I)","Suriname:Import","Suriname:Export","Suriname:Balance(E-I)","French Guiana:Import","French Guiana:Export","French Guiana:Balance(E-I)","Ecuador:Import","Ecuador:Export","Ecuador:Balance(E-I)","Peru:Import","Peru:Export","Peru:Balance(E-I)","Bolivia:Import","Bolivia:Export","Bolivia:Balance(E-I)","Chile:Import","Chile:Export","Chile:Balance(E-I)","Brazil:Import","Brazil:Export","Brazil:Balance(E-I)","Paraguay:Import","Paraguay:Export","Paraguay:Balance(E-I)","Uruguay:Import","Uruguay:Export","Uruguay:Balance(E-I)","Argentina:Import","Argentina:Export","Argentina:Balance(E-I)","Falkland Islands(Islas Malvin:Import","Falkland Islands(Islas Malvin:Export","Falkland Islands(Islas Malvin:Balance(E-I)","Iceland:Import","Iceland:Export","Iceland:Balance(E-I)","Sweden:Import","Sweden:Export","Sweden:Balance(E-I)","Svalbard, Jan Mayen Island:Import","Svalbard, Jan Mayen Island:Export","Svalbard, Jan Mayen Island:Balance(E-I)","Norway:Import","Norway:Export","Norway:Balance(E-I)","Finland:Import","Finland:Export","Finland:Balance(E-I)","Faroe Islands:Import","Faroe Islands:Export","Faroe Islands:Balance(E-I)","Denmark:Import","Denmark:Export","Denmark:Balance(E-I)","United Kingdom:Import","United Kingdom:Export","United Kingdom:Balance(E-I)","Ireland:Import","Ireland:Export","Ireland:Balance(E-I)","Netherlands:Import","Netherlands:Export","Netherlands:Balance(E-I)","Belgium:Import","Belgium:Export","Belgium:Balance(E-I)","Luxembourg:Import","Luxembourg:Export","Luxembourg:Balance(E-I)","Andorra:Import","Andorra:Export","Andorra:Balance(E-I)","Monaco:Import","Monaco:Export","Monaco:Balance(E-I)","France:Import","France:Export","France:Balance(E-I)","Germany:Import","Germany:Export","Germany:Balance(E-I)","Austria:Import","Austria:Export","Austria:Balance(E-I)","Czechoslovakia:Import","Czechoslovakia:Export","Czechoslovakia:Balance(E-I)","Czech Republic:Import","Czech Republic:Export","Czech Republic:Balance(E-I)","Slovakia:Import","Slovakia:Export","Slovakia:Balance(E-I)","Hungary:Import","Hungary:Export","Hungary:Balance(E-I)","Liechtenstein:Import","Liechtenstein:Export","Liechtenstein:Balance(E-I)","Switzerland:Import","Switzerland:Export","Switzerland:Balance(E-I)","Estonia:Import","Estonia:Export","Estonia:Balance(E-I)","Latvia:Import","Latvia:Export","Latvia:Balance(E-I)","Lithuania:Import","Lithuania:Export","Lithuania:Balance(E-I)","Poland:Import","Poland:Export","Poland:Balance(E-I)","USSR:Import","USSR:Export","USSR:Balance(E-I)","Russia:Import","Russia:Export","Russia:Balance(E-I)","Belarus:Import","Belarus:Export","Belarus:Balance(E-I)","Ukraine:Import","Ukraine:Export","Ukraine:Balance(E-I)","Armenia:Import","Armenia:Export","Armenia:Balance(E-I)","Azerbaijan:Import","Azerbaijan:Export","Azerbaijan:Balance(E-I)","Georgia:Import","Georgia:Export","Georgia:Balance(E-I)","Kazakhstan:Import","Kazakhstan:Export","Kazakhstan:Balance(E-I)","Kyrgyzstan:Import","Kyrgyzstan:Export","Kyrgyzstan:Balance(E-I)","Moldova:Import","Moldova:Export","Moldova:Balance(E-I)","Tajikistan:Import","Tajikistan:Export","Tajikistan:Balance(E-I)","Turkmenistan:Import","Turkmenistan:Export","Turkmenistan:Balance(E-I)","Uzbekistan:Import","Uzbekistan:Export","Uzbekistan:Balance(E-I)","Spain:Import","Spain:Export","Spain:Balance(E-I)","Portugal:Import","Portugal:Export","Portugal:Balance(E-I)","Gibraltar:Import","Gibraltar:Export","Gibraltar:Balance(E-I)","Malta:Import","Malta:Export","Malta:Balance(E-I)","San Marino:Import","San Marino:Export","San Marino:Balance(E-I)","Vatican City:Import","Vatican City:Export","Vatican City:Balance(E-I)","Italy:Import","Italy:Export","Italy:Balance(E-I)","Yugoslavia (former):Import","Yugoslavia (former):Export","Yugoslavia (former):Balance(E-I)","Croatia:Import","Croatia:Export","Croatia:Balance(E-I)","Slovenia:Import","Slovenia:Export","Slovenia:Balance(E-I)","Bosnia and Herzegovina:Import","Bosnia and Herzegovina:Export","Bosnia and Herzegovina:Balance(E-I)","Macedonia:Import","Macedonia:Export","Macedonia:Balance(E-I)","Serbia and Montenegro:Import","Serbia and Montenegro:Export","Serbia and Montenegro:Balance(E-I)","Serbia:Import","Serbia:Export","Serbia:Balance(E-I)","Kosovo:Import","Kosovo:Export","Kosovo:Balance(E-I)","Montenegro:Import","Montenegro:Export","Montenegro:Balance(E-I)","Albania:Import","Albania:Export","Albania:Balance(E-I)","Greece:Import","Greece:Export","Greece:Balance(E-I)","Romania:Import","Romania:Export","Romania:Balance(E-I)","Bulgaria:Import","Bulgaria:Export","Bulgaria:Balance(E-I)","Turkey:Import","Turkey:Export","Turkey:Balance(E-I)","Cyprus:Import","Cyprus:Export","Cyprus:Balance(E-I)","Syria:Import","Syria:Export","Syria:Balance(E-I)","Lebanon:Import","Lebanon:Export","Lebanon:Balance(E-I)","Iraq:Import","Iraq:Export","Iraq:Balance(E-I)","Iran:Import","Iran:Export","Iran:Balance(E-I)","Israel:Import","Israel:Export","Israel:Balance(E-I)","Gaza Strip admin. by Israel:Import","Gaza Strip admin. by Israel:Export","Gaza Strip admin. by Israel:Balance(E-I)","West Bank admin. by Israel:Import","West Bank admin. by Israel:Export","West Bank admin. by Israel:Balance(E-I)","Jordan:Import","Jordan:Export","Jordan:Balance(E-I)","Kuwait:Import","Kuwait:Export","Kuwait:Balance(E-I)","Iraq-Saudi Arabia Neutral Zone:Import","Iraq-Saudi Arabia Neutral Zone:Export","Iraq-Saudi Arabia Neutral Zone:Balance(E-I)","Saudi Arabia:Import","Saudi Arabia:Export","Saudi Arabia:Balance(E-I)","Qatar:Import","Qatar:Export","Qatar:Balance(E-I)","United Arab Emirates:Import","United Arab Emirates:Export","United Arab Emirates:Balance(E-I)","Republic of Yemen:Import","Republic of Yemen:Export","Republic of Yemen:Balance(E-I)","Oman:Import","Oman:Export","Oman:Balance(E-I)","Bahrain:Import","Bahrain:Export","Bahrain:Balance(E-I)","Afghanistan:Import","Afghanistan:Export","Afghanistan:Balance(E-I)","India:Import","India:Export","India:Balance(E-I)","Pakistan:Import","Pakistan:Export","Pakistan:Balance(E-I)","Nepal:Import","Nepal:Export","Nepal:Balance(E-I)","Bangladesh:Import","Bangladesh:Export","Bangladesh:Balance(E-I)","Sri Lanka:Import","Sri Lanka:Export","Sri Lanka:Balance(E-I)","Burma:Import","Burma:Export","Burma:Balance(E-I)","Thailand:Import","Thailand:Export","Thailand:Balance(E-I)","Vietnam:Import","Vietnam:Export","Vietnam:Balance(E-I)","Laos:Import","Laos:Export","Laos:Balance(E-I)","Cambodia:Import","Cambodia:Export","Cambodia:Balance(E-I)","Malaysia:Import","Malaysia:Export","Malaysia:Balance(E-I)","Singapore:Import","Singapore:Export","Singapore:Balance(E-I)","Indonesia:Import","Indonesia:Export","Indonesia:Balance(E-I)","East Timor:Import","East Timor:Export","East Timor:Balance(E-I)","Brunei:Import","Brunei:Export","Brunei:Balance(E-I)","Philippines:Import","Philippines:Export","Philippines:Balance(E-I)","Macau:Import","Macau:Export","Macau:Balance(E-I)","Bhutan:Import","Bhutan:Export","Bhutan:Balance(E-I)","Maldives:Import","Maldives:Export","Maldives:Balance(E-I)","China:Import","China:Export","China:Balance(E-I)","Mongolia:Import","Mongolia:Export","Mongolia:Balance(E-I)","Korea, North:Import","Korea, North:Export","Korea, North:Balance(E-I)","Korea, South:Import","Korea, South:Export","Korea, South:Balance(E-I)","Hong Kong:Import","Hong Kong:Export","Hong Kong:Balance(E-I)","Taiwan:Import","Taiwan:Export","Taiwan:Balance(E-I)","Japan:Import","Japan:Export","Japan:Balance(E-I)","Australia:Import","Australia:Export","Australia:Balance(E-I)","Norfolk Island:Import","Norfolk Island:Export","Norfolk Island:Balance(E-I)","Cocos (Keeling) Islands:Import","Cocos (Keeling) Islands:Export","Cocos (Keeling) Islands:Balance(E-I)","Christmas Island:Import","Christmas Island:Export","Christmas Island:Balance(E-I)","Heard and McDonald Islands:Import","Heard and McDonald Islands:Export","Heard and McDonald Islands:Balance(E-I)","Papua New Guinea:Import","Papua New Guinea:Export","Papua New Guinea:Balance(E-I)","New Zealand:Import","New Zealand:Export","New Zealand:Balance(E-I)","Cook Islands:Import","Cook Islands:Export","Cook Islands:Balance(E-I)","Tokelau:Import","Tokelau:Export","Tokelau:Balance(E-I)","Niue:Import","Niue:Export","Niue:Balance(E-I)","Samoa:Import","Samoa:Export","Samoa:Balance(E-I)","Solomon Islands:Import","Solomon Islands:Export","Solomon Islands:Balance(E-I)","Vanuatu:Import","Vanuatu:Export","Vanuatu:Balance(E-I)","Pitcairn Islands:Import","Pitcairn Islands:Export","Pitcairn Islands:Balance(E-I)","Kiribati:Import","Kiribati:Export","Kiribati:Balance(E-I)","Tuvalu:Import","Tuvalu:Export","Tuvalu:Balance(E-I)","New Caledonia:Import","New Caledonia:Export","New Caledonia:Balance(E-I)","Wallis and Futuna:Import","Wallis and Futuna:Export","Wallis and Futuna:Balance(E-I)","French Polynesia:Import","French Polynesia:Export","French Polynesia:Balance(E-I)","Marshall Islands:Import","Marshall Islands:Export","Marshall Islands:Balance(E-I)","Micronesia:Import","Micronesia:Export","Micronesia:Balance(E-I)","Palau:Import","Palau:Export","Palau:Balance(E-I)","Nauru:Import","Nauru:Export","Nauru:Balance(E-I)","Fiji:Import","Fiji:Export","Fiji:Balance(E-I)","Tonga:Import","Tonga:Export","Tonga:Balance(E-I)","Morocco:Import","Morocco:Export","Morocco:Balance(E-I)","Algeria:Import","Algeria:Export","Algeria:Balance(E-I)","Tunisia:Import","Tunisia:Export","Tunisia:Balance(E-I)","Libya:Import","Libya:Export","Libya:Balance(E-I)","Egypt:Import","Egypt:Export","Egypt:Balance(E-I)","Sudan:Import","Sudan:Export","Sudan:Balance(E-I)","South Sudan:Import","South Sudan:Export","South Sudan:Balance(E-I)","Western Sahara:Import","Western Sahara:Export","Western Sahara:Balance(E-I)","Equatorial Guinea:Import","Equatorial Guinea:Export","Equatorial Guinea:Balance(E-I)","Mauritania:Import","Mauritania:Export","Mauritania:Balance(E-I)","Cameroon:Import","Cameroon:Export","Cameroon:Balance(E-I)","Senegal:Import","Senegal:Export","Senegal:Balance(E-I)","Mali:Import","Mali:Export","Mali:Balance(E-I)","Guinea:Import","Guinea:Export","Guinea:Balance(E-I)","Sierra Leone:Import","Sierra Leone:Export","Sierra Leone:Balance(E-I)","Cote d'Ivoire:Import","Cote d'Ivoire:Export","Cote d'Ivoire:Balance(E-I)","Ghana:Import","Ghana:Export","Ghana:Balance(E-I)","Gambia:Import","Gambia:Export","Gambia:Balance(E-I)","Niger:Import","Niger:Export","Niger:Balance(E-I)","Togo:Import","Togo:Export","Togo:Balance(E-I)","Nigeria:Import","Nigeria:Export","Nigeria:Balance(E-I)","Central African Republic:Import","Central African Republic:Export","Central African Republic:Balance(E-I)","Gabon:Import","Gabon:Export","Gabon:Balance(E-I)","Chad:Import","Chad:Export","Chad:Balance(E-I)","St Helena:Import","St Helena:Export","St Helena:Balance(E-I)","Burkina Faso:Import","Burkina Faso:Export","Burkina Faso:Balance(E-I)","Benin:Import","Benin:Export","Benin:Balance(E-I)","Angola:Import","Angola:Export","Angola:Balance(E-I)","Congo (Brazzaville):Import","Congo (Brazzaville):Export","Congo (Brazzaville):Balance(E-I)","Guinea-Bissau:Import","Guinea-Bissau:Export","Guinea-Bissau:Balance(E-I)","Cabo Verde:Import","Cabo Verde:Export","Cabo Verde:Balance(E-I)","Sao Tome and Principe:Import","Sao Tome and Principe:Export","Sao Tome and Principe:Balance(E-I)","Liberia:Import","Liberia:Export","Liberia:Balance(E-I)","Congo (Kinshasa):Import","Congo (Kinshasa):Export","Congo (Kinshasa):Balance(E-I)","Burundi:Import","Burundi:Export","Burundi:Balance(E-I)","Rwanda:Import","Rwanda:Export","Rwanda:Balance(E-I)","Somalia:Import","Somalia:Export","Somalia:Balance(E-I)","Ethiopia:Import","Ethiopia:Export","Ethiopia:Balance(E-I)","Eritrea:Import","Eritrea:Export","Eritrea:Balance(E-I)","Djibouti:Import","Djibouti:Export","Djibouti:Balance(E-I)","Uganda:Import","Uganda:Export","Uganda:Balance(E-I)","Kenya:Import","Kenya:Export","Kenya:Balance(E-I)","Seychelles:Import","Seychelles:Export","Seychelles:Balance(E-I)","British Indian Ocean Terr.:Import","British Indian Ocean Terr.:Export","British Indian Ocean Terr.:Balance(E-I)","Tanzania:Import","Tanzania:Export","Tanzania:Balance(E-I)","Mauritius:Import","Mauritius:Export","Mauritius:Balance(E-I)","Mozambique:Import","Mozambique:Export","Mozambique:Balance(E-I)","Madagascar:Import","Madagascar:Export","Madagascar:Balance(E-I)","Mayotte:Import","Mayotte:Export","Mayotte:Balance(E-I)","Comoros:Import","Comoros:Export","Comoros:Balance(E-I)","Reunion:Import","Reunion:Export","Reunion:Balance(E-I)","French Southern and Antarctic:Import","French Southern and Antarctic:Export","French Southern and Antarctic:Balance(E-I)","South Africa:Import","South Africa:Export","South Africa:Balance(E-I)","Namibia:Import","Namibia:Export","Namibia:Balance(E-I)","Botswana:Import","Botswana:Export","Botswana:Balance(E-I)","Zambia:Import","Zambia:Export","Zambia:Balance(E-I)","Swaziland:Import","Swaziland:Export","Swaziland:Balance(E-I)","Zimbabwe:Import","Zimbabwe:Export","Zimbabwe:Balance(E-I)","Malawi:Import","Malawi:Export","Malawi:Balance(E-I)","Lesotho:Import","Lesotho:Export","Lesotho:Balance(E-I)","Unidentified Countries:Import","Unidentified Countries:Export","Unidentified Countries:Balance(E-I)","International Organizations:Import","International Organizations:Export","International Organizations:Balance(E-I)"
1985-01-01,1733,1033,-700,,,,,,,,,,,,,,,,3221.6,1579.9,-1641.7,2608.1,1295.2,-1312.9,6622.4,4915,-1707.4,,,,,,,,,,,,,11335.7,5563.3,-5772.4,,,,348.2,669.4,321.2,529,231,-298,,,,5319.1,3779.6,-1539.5,,,,1303.3,1135.4,-167.9,32.7,23.7,-9,,,,35.2,41.4,6.2,36.7,20.7,-16,,,,39.6,31.6,-8,27.6,59.3,31.7,,,,154.4,59,-95.4,,,,22.7,35.7,13,,,,,,,31.2,31.2,0,84.3,51,-33.3,,,,,,,,,,,,,,,,,,,,,,,,,,,,,,,108.5,44,-64.5,160.5,65.6,-94.9,,,,,,,,,,,,,,,,114.8,98.5,-16.3,481.6,244.4,-237.2,,,,,,,,,,188.9,35.2,-153.7,127.4,44.7,-82.7,,,,57.8,57.8,0,751.5,277.4,-474.1,1.7,7,5.3,69.3,4.9,-64.4,81.7,62.1,-19.6,,,,13.6,3.2,-10.4,391.3,129.4,-261.9,,,,149.6,54.7,-94.9,101.4,30.2,-71.2,,,,149.5,60,-89.5,1141,1032.4,-108.6,63.4,112.9,49.5,323.3,618.5,295.2,258.3,391.9,133.6,,,,,,,,,,909.2,548.9,-360.3,1836.8,792.6,-1044.2,65.7,35,-30.7,,,,,,,,,,25.3,12.1,-13.2,,,,289.7,202.3,-87.4,,,,,,,,,,22.5,17.9,-4.6,39.3,348.6,309.3,,,,,,,,,,,,,,,,,,,,,,,,,,,,,,,,,,,,,205.3,261,55.7,40.5,70.6,30.1,,,,,,,,,,,,,759.7,393.5,-366.2,38.1,41.1,3,,,,,,,,,,,,,,,,,,,,,,,,,,,,39.1,26.7,-12.4,,,,,,,44.2,104.1,59.9,,,,,,,,,,,,,7.4,5.2,-2.2,,,,,,,,,,,,,6.9,43.5,36.6,,,,155.7,410.3,254.6,,,,136.4,54.5,-81.9,,,,,,,27,13.3,-13.7,,,,355.4,141.7,-213.7,18.1,61.5,43.4,,,,16.7,40,23.3,23.7,12.9,-10.8,,,,115.6,83.3,-32.3,,,,,,,,,,234.7,173.5,-61.2,359.5,297,-62.5,349.9,70.3,-279.6,,,,,,,196.3,126.7,-69.6,24.7,0.3,-24.4,,,,,,,293.1,319.2,26.1,,,,,,,800.7,572.1,-228.6,675.2,288.3,-386.9,1386.2,422.5,-963.7,5968.8,2100,-3868.8,288.5,595.5,307,,,,,,,,,,,,,,,,59.7,73.9,14.2,,,,,,,,,,,,,,,,,,,,,,,,,,,,,,,,,,,,,,,,,,,,,,,,,,,,,,,,,,196,51.9,-144.1,,,,,,,6.7,170.2,163.5,,,,,,,,,,,,,,,,,,,,,,,,,,,,,,,91.6,3.5,-88.1,,,,,,,,,,,,,180.9,58.1,-122.8,,,,15.6,2.4,-13.2,,,,,,,,,,,,,44,10.9,-33.1,31.8,0.9,-30.9,,,,,,,,,,,,,24.9,7.9,-17,,,,,,,,,,,,,,,,,,,,,,,,,,,,,,,,,,,,,,,,,,,,,,,,,,,,,,,140.2,147.3,7.10000000000002,,,,,,,,,,,,,,,,,,,,,,,,,,,
1985-02-01,1607,995,-612,,,,,,,,,,,,,,,,2970.1,1339.8,-1630.3,2315.9,1202.4,-1113.5,7050.1,4823.7,-2226.4,,,,,,,,,,,,,9645,4629.4,-5015.6,,,,224.6,412.5,187.9,650.4,234.1,-416.3,,,,5548.5,3706.6,-1841.9,,,,1501.6,1117.1,-384.5,28.7,21.5,-7.2,,,,42.3,34.6,-7.7,30.8,20.9,-9.9,,,,45.8,32.8,-13,32.3,48.3,16,,,,73.7,43.2,-30.5,,,,37.8,35,-2.8,,,,,,,30.4,31.8,1.4,62.1,58.8,-3.3,,,,,,,,,,,,,,,,,,,,,,,,,,,,,,,111.9,31.2,-80.7,179.7,44.6,-135.1,,,,,,,,,,,,,,,,123.4,91.4,-32,502.8,257.7,-245.1,,,,,,,,,,111.1,51.7,-59.4,89.1,40.8,-48.3,,,,61.2,59,-2.2,625.4,225.8,-399.6,3.1,5.2,2.1,38,4.4,-33.6,86.3,63.7,-22.6,,,,27,2.3,-24.7,344.1,133.2,-210.9,,,,86.3,47.9,-38.4,65.7,23.6,-42.1,,,,132.8,54.3,-78.5,1037.4,974.6,-62.8000000000001,60.4,113.7,53.3,283.6,619.1,335.5,271.5,462.8,191.3,,,,,,,,,,555.9,483.2,-72.7,1426.5,777.8,-648.7,53,50.5,-2.5,,,,,,,,,,20.9,14.6,-6.3,,,,233.3,192.6,-40.7,,,,,,,,,,17,23,6,47.4,315,267.6,,,,,,,,,,,,,,,,,,,,,,,,,,,,,,,,,,,,,151.2,225.6,74.4,35.6,56.6,21,,,,,,,,,,,,,678.6,381.3,-297.3,38.5,29.5,-9,,,,,,,,,,,,,,,,,,,,,,,,,,,,21.8,36.8,15,,,,,,,61.9,91.7,29.8,,,,,,,,,,,,,8.2,7.7,-0.499999999999999,,,,,,,,,,,,,17.4,51.9,34.5,,,,138.3,309.6,171.3,,,,87.3,63.6,-23.7,,,,,,,2.1,10.6,8.5,,,,196.4,113.6,-82.8,31.1,51.7,20.6,,,,13.6,36.8,23.2,27.4,8.7,-18.7,,,,108.6,80.9,-27.7,,,,,,,,,,184.6,132.9,-51.7,355.7,262.9,-92.8,406.7,71.6,-335.1,,,,,,,173.6,105.2,-68.4,29.1,0,-29.1,,,,,,,281,222.7,-58.3,,,,,,,732.3,447.9,-284.4,657.3,233.9,-423.4,1224.8,395.1,-829.7,4799.8,1823.6,-2976.2,163.6,360.1,196.5,,,,,,,,,,,,,,,,61,52.4,-8.6,,,,,,,,,,,,,,,,,,,,,,,,,,,,,,,,,,,,,,,,,,,,,,,,,,,,,,,,,,150.1,30.1,-120,,,,,,,5,278.5,273.5,,,,,,,,,,,,,,,,,,,,,,,,,,,,,,,80.6,13.6,-67,,,,,,,,,,,,,176.1,83.2,-92.9,,,,8.8,6.6,-2.2,,,,,,,,,,,,,66.9,26.6,-40.3,68,1.9,-66.1,,,,,,,,,,,,,28.5,8.7,-19.8,,,,,,,,,,,,,,,,,,,,,,,,,,,,,,,,,,,,,,,,,,,,,,,,,,,,,,,221.5,93.5,-128,,,,,,,,,,,,,,,,,,,,,,,,,,,
1985-03-01,1339,1242,-97,,,,,,,,,,,,,,,,3476,1636.1,-1839.9,2233.7,1313.6,-920.1,7773.5,5507.1,-2266.4,,,,,,,,,,,,,10925.5,5880,-5045.5,,,,277.3,489.5,212.2,336.2,252.8,-83.4,,,,6075.3,4246.2,-1829.1,,,,1698.2,1260.9,-437.3,34.7,36.1,1.4,,,,29.8,34,4.2,30.9,25.7,-5.2,,,,50.2,37.6,-12.6,33.6,64.8,31.2,,,,47.7,43.4,-4.3,,,,32.4,32.8,0.399999999999999,,,,,,,36.7,31.9,-4.8,77.8,53.8,-24,,,,,,,,,,,,,,,,,,,,,,,,,,,,,,,90.4,40.5,-49.9,41.5,26.8,-14.7,,,,,,,,,,,,,,,,102.2,135.5,33.3,535.8,250.2,-285.6,,,,,,,,,,158.4,63,-95.4,94.9,51.5,-43.4,,,,99.3,53.7,-45.6,633.9,259.6,-374.3,2.2,7,4.8,25.3,5.7,-19.6,76,60,-16,,,,10.5,3.5,-7,372.3,216.5,-155.8,,,,70.2,61.3,-8.90000000000001,86.5,30.2,-56.3,,,,156.9,58.9,-98,1029.1,1410.2,381.1,91.4,133.6,42.2,354.9,593.5,238.6,291.4,431.5,140.1,,,,,,,,,,762,611.3,-150.7,1774.6,923.1,-851.5,65.6,59.2,-6.39999999999999,,,,,,,,,,22.2,10.7,-11.5,,,,315.8,273.3,-42.5,,,,,,,,,,17.4,26.1,8.7,28.3,324.2,295.9,,,,,,,,,,,,,,,,,,,,,,,,,,,,,,,,,,,,,192.6,232.5,39.9,43.8,91.9,48.1,,,,,,,,,,,,,836.1,440.2,-395.9,39.4,27.7,-11.7,,,,,,,,,,,,,,,,,,,,,,,,,,,,22.1,51.7,29.6,,,,,,,48.7,56.9,8.2,,,,,,,,,,,,,10.4,9,-1.4,,,,,,,,,,,,,0.4,63.9,63.5,,,,49.6,493.8,444.2,,,,19.9,65.3,45.4,,,,,,,3.2,10.3,7.1,,,,226.9,150,-76.9,25.7,130.5,104.8,,,,18.1,43.3,25.2,24.8,3.2,-21.6,,,,141,117.7,-23.3,,,,,,,,,,198.9,187,-11.9,371.4,382.9,11.5,305.4,100.7,-204.7,,,,,,,198.4,113,-85.4,25.1,0.2,-24.9,,,,,,,293,239.5,-53.5,,,,,,,847.7,545.5,-302.2,780.1,275.7,-504.4,1476.8,432,-1044.8,5724.9,2328.7,-3396.2,207.6,431.3,223.7,,,,,,,,,,,,,,,,69.7,58.2,-11.5,,,,,,,,,,,,,,,,,,,,,,,,,,,,,,,,,,,,,,,,,,,,,,,,,,,,,,,,,,207.9,46.5,-161.4,,,,,,,2.9,237.8,234.9,,,,,,,,,,,,,,,,,,,,,,,,,,,,,,,70.7,4.1,-66.6,,,,,,,,,,,,,49.4,89.2,39.8,,,,0.7,3.9,3.2,,,,,,,,,,,,,32.3,3,-29.3,24,0.7,-23.3,,,,,,,,,,,,,5.6,10.7,5.1,,,,,,,,,,,,,,,,,,,,,,,,,,,,,,,,,,,,,,,,,,,,,,,,,,,,,,,153.5,141.2,-12.3,,,,,,,,,,,,,,,,,,,,,,,,,,,
1985-04-01,1885,976,-909,,,,,,,,,,,,,,,,2869.8,1485.4,-1384.4,1963.4,1313.6,-649.8,7913.2,5408.4,-2504.8,,,,,,,,,,,,,10632,4736.6,-5895.4,,,,319,492.5,173.5,792.2,200.4,-591.8,,,,5976.2,4171.7,-1804.5,,,,1937,1236.7,-700.3,39.2,30.3,-8.9,,,,37,45.6,8.6,25.7,30,4.3,,,,40.6,36.5,-4.1,36.3,62.5,26.2,,,,25.5,57.9,32.4,,,,23.4,40.4,17,,,,,,,33.2,32.9,-0.300000000000004,75.3,70.5,-4.8,,,,,,,,,,,,,,,,,,,,,,,,,,,,,,,99.5,38.2,-61.3,52,27.3,-24.7,,,,,,,,,,,,,,,,85.5,128.1,42.6,466.3,275.3,-191,,,,,,,,,,99.9,43.9,-56,97,36.2,-60.8,,,,101.5,48.8,-52.7,515.5,237.4,-278.1,1,5.8,4.8,34.8,5.3,-29.5,74.2,60.7,-13.5,,,,15.7,3.3,-12.4,355.4,124,-231.4,,,,141.2,56.8,-84.4,77.7,26.7,-51,,,,120.4,48.3,-72.1,1098.2,963.9,-134.3,69.5,114.3,44.8,321.4,649.7,328.3,222.7,352.2,129.5,,,,,,,,,,745.2,487.7,-257.5,1690,758.7,-931.3,66.1,27.1,-39,,,,,,,,,,14.8,5.3,-9.5,,,,253.9,193.3,-60.6,,,,,,,,,,18.2,12.4,-5.8,26.1,308.9,282.8,,,,,,,,,,,,,,,,,,,,,,,,,,,,,,,,,,,,,173.1,194.2,21.1,42.3,64.4,22.1,,,,,,,,,,,,,767.3,487.2,-280.1,40.1,33.1,-7,,,,,,,,,,,,,,,,,,,,,,,,,,,,41.6,41.9,0.299999999999997,,,,,,,50.9,147.5,96.6,,,,,,,,,,,,,6.3,10.9,4.6,,,,,,,,,,,,,4.2,41.6,37.4,,,,198.1,330.8,132.7,,,,48.9,45.6,-3.3,,,,,,,8.5,7.6,-0.9,,,,156.4,146,-10.4,27.7,51.1,23.4,,,,15.6,8.6,-7,21.7,4.7,-17,,,,103.2,75,-28.2,,,,,,,,,,203.3,126.4,-76.9,321.5,345.5,24,400.3,64.9,-335.4,,,,,,,179.9,141.1,-38.8,15.4,0.1,-15.3,,,,,,,283.3,265.6,-17.7,,,,,,,754.9,591.7,-163.2,542.6,210,-332.6,1250.8,338.2,-912.6,5931,1732.7,-4198.3,222.3,441.9,219.6,,,,,,,,,,,,,,,,96.7,50.6,-46.1,,,,,,,,,,,,,,,,,,,,,,,,,,,,,,,,,,,,,,,,,,,,,,,,,,,,,,,,,,303.7,30.7,-273,,,,,,,4,194.2,190.2,,,,,,,,,,,,,,,,,,,,,,,,,,,,,,,31.7,8.1,-23.6,,,,,,,,,,,,,307.3,48.4,-258.9,,,,49.1,24.4,-24.7,,,,,,,,,,,,,99.5,13.2,-86.3,47.4,4.9,-42.5,,,,,,,,,,,,,69.8,9.5,-60.3,,,,,,,,,,,,,,,,,,,,,,,,,,,,,,,,,,,,,,,,,,,,,,,,,,,,,,,187.4,91.9,-95.5,,,,,,,,,,,,,,,,,,,,,,,,,,,
1985-05-01,2063,1084,-979,,,,,,,,,,,,,,,,3207.8,1420.2,-1787.6,2173.7,1352.2,-821.5,7369.2,5330.8,-2038.4,,,,,,,,,,,,,10798.3,5000,-5798.3,,,,304.5,489.8,185.3,734.6,177.6,-557,,,,6041.7,4467.5,-1574.2,,,,1327.5,863.3,-464.2,29.8,28.1,-1.7,,,,30,30.2,0.199999999999999,28.2,27,-1.2,,,,47.4,40.2,-7.2,35.9,55.8,19.9,,,,38.3,68,29.7,,,,16.7,33.1,16.4,,,,,,,31,35.3,4.3,103.1,65.1,-38,,,,,,,,,,,,,,,,,,,,,,,,,,,,,,,103.7,43,-60.7,42.8,31.2,-11.6,,,,,,,,,,,,,,,,111.9,130.7,18.8,506.3,340.3,-166,,,,,,,,,,137.4,42.6,-94.8,68.5,51.4,-17.1,,,,75.6,50.6,-25,650.1,210.8,-439.3,1.6,9,7.4,51.5,6.5,-45,63.9,53.3,-10.6,,,,25.4,2.7,-22.7,348.9,124.9,-224,,,,139.6,57.8,-81.8,80.5,27.5,-53,,,,114.8,79.6,-35.2,1242.6,935.2,-307.4,75.9,116.3,40.4,401.4,599,197.6,302.2,407.4,105.2,,,,,,,,,,1045.9,566.3,-479.6,1656.4,767.5,-888.9,84.8,31,-53.8,,,,,,,,,,17.3,4.2,-13.1,,,,314,216.3,-97.7,,,,,,,,,,16.3,17.8,1.5,46,295.7,249.7,,,,,,,,,,,,,,,,,,,,,,,,,,,,,,,,,,,,,208.1,166.8,-41.3,50.9,38.3,-12.6,,,,,,,,,,,,,807.2,476.9,-330.3,41.4,45.2,3.8,,,,,,,,,,,,,,,,,,,,,,,,,,,,34,42.4,8.4,,,,,,,53,118.7,65.7,,,,,,,,,,,,,43.3,9.3,-34,,,,,,,,,,,,,12.8,38.5,25.7,,,,103.8,374.8,271,,,,94.7,44.1,-50.6,,,,,,,4.3,8,3.7,,,,204.5,134.6,-69.9,24.9,120.5,95.6,,,,14.3,5.1,-9.2,23,3.7,-19.3,,,,132,62.4,-69.6,,,,,,,,,,179.4,138.2,-41.2,350.2,288.3,-61.9,375.2,67.4,-307.8,,,,,,,178.9,124.1,-54.8,26.4,0.2,-26.2,,,,,,,295.1,329.3,34.2,,,,,,,841,529.5,-311.5,625.8,244.7,-381.1,1390.8,357.7,-1033.1,5719.2,1814.5,-3904.7,220.5,440.1,219.6,,,,,,,,,,,,,,,,84,49.7,-34.3,,,,,,,,,,,,,,,,,,,,,,,,,,,,,,,,,,,,,,,,,,,,,,,,,,,,,,,,,,297.6,47.3,-250.3,,,,,,,14.1,249.5,235.4,,,,,,,,,,,,,,,,,,,,,,,,,,,,,,,44.2,6.4,-37.8,,,,,,,,,,,,,331,42.5,-288.5,,,,20.7,4,-16.7,,,,,,,,,,,,,112.7,10.1,-102.6,41.7,1.1,-40.6,,,,,,,,,,,,,31.7,7.9,-23.8,,,,,,,,,,,,,,,,,,,,,,,,,,,,,,,,,,,,,,,,,,,,,,,,,,,,,,,152.6,105.6,-47,,,,,,,,,,,,,,,,,,,,,,,,,,,
1985-06-01,1891,983,-908,,,,,,,,,,,,,,,,3294.5,1456.1,-1838.4,2184.7,1271.2,-913.5,8011.4,5947.8,-2063.6,,,,,,,,,,,,,11029.2,4877.9,-6151.3,,,,316.4,399.2,82.8,735.9,193.3,-542.6,,,,6291.8,4570.5,-1721.3,,,,1719.6,1377.3,-342.3,39.4,33.1,-6.3,,,,34.3,31.1,-3.2,31,28.2,-2.8,,,,34.8,35.7,0.900000000000006,38,55.5,17.5,,,,37.6,47.5,9.9,,,,22,31.1,9.1,,,,,,,39.6,28.8,-10.8,109.4,58.9,-50.5,,,,,,,,,,,,,,,,,,,,,,,,,,,,,,,84.7,38.9,-45.8,85,30.6,-54.4,,,,,,,,,,,,,,,,106.7,118.1,11.4,507.1,278.8,-228.3,,,,,,,,,,120.2,51.8,-68.4,82.8,42.6,-40.2,,,,62.4,43.3,-19.1,629.7,243.4,-386.3,0.6,8.8,8.2,21.8,5.2,-16.6,97.6,59.8,-37.8,,,,28.8,2.8,-26,390.1,124.5,-265.6,,,,119.7,49.8,-69.9,80.7,54.2,-26.5,,,,134,77.2,-56.8,1447.2,854.9,-592.3,77.1,123.4,46.3,386.2,541.4,155.2,343.9,393.9,50,,,,,,,,,,851.8,465.3,-386.5,1680.6,743.2,-937.4,75.9,32.1,-43.8,,,,,,,,,,19.3,9.5,-9.8,,,,281.7,198.3,-83.4,,,,,,,,,,19.3,20.3,1,56.6,77.8,21.2,,,,,,,,,,,,,,,,,,,,,,,,,,,,,,,,,,,,,202.3,146.7,-55.6,49.2,62.7,13.5,,,,,,,,,,,,,816.8,351.3,-465.5,51,56,5,,,,,,,,,,,,,,,,,,,,,,,,,,,,47.1,39.9,-7.2,,,,,,,40.7,98.4,57.7,,,,,,,,,,,,,48,5.7,-42.3,,,,,,,,,,,,,27.7,34.9,7.2,,,,48.3,310.3,262,,,,98.3,46.3,-52,,,,,,,19,10.6,-8.4,,,,145.7,139.5,-6.19999999999999,25.1,172.5,147.4,,,,16.5,23.6,7.1,22.3,7.3,-15,,,,128.2,58.9,-69.3,,,,,,,,,,190.2,146.7,-43.5,432.4,241.7,-190.7,399.8,61.7,-338.1,,,,,,,196.9,110.8,-86.1,25.6,0.1,-25.5,,,,,,,348.7,280.9,-67.8,,,,,,,830.4,551.9,-278.5,631.9,282.7,-349.2,1399.8,379.8,-1020,5824.1,1750.6,-4073.5,247.9,348.3,100.4,,,,,,,,,,,,,,,,68.5,50.9,-17.6,,,,,,,,,,,,,,,,,,,,,,,,,,,,,,,,,,,,,,,,,,,,,,,,,,,,,,,,,,265.1,48.7,-216.4,,,,,,,31,184.3,153.3,,,,,,,,,,,,,,,,,,,,,,,,,,,,,,,38.4,4.5,-33.9,,,,,,,,,,,,,248.3,55.2,-193.1,,,,72.2,2.6,-69.6,,,,,,,,,,,,,107.2,23.5,-83.7,82.3,0.9,-81.4,,,,,,,,,,,,,27.2,10.8,-16.4,,,,,,,,,,,,,,,,,,,,,,,,,,,,,,,,,,,,,,,,,,,,,,,,,,,,,,,160.3,95.8,-64.5,,,,,,,,,,,,,,,,,,,,,,,,,,,
1985-07-01,1724,1167,-557,,,,,,,,,,,,,,,,3254.9,1369.7,-1885.2,1980.2,1390.6,-589.6,6781.1,4541.2,-2239.9,,,,,,,,,,,,,10477.3,4998.2,-5479.1,,,,443.7,669.3,225.6,619.1,163.1,-456,,,,5073.1,3720.9,-1352.2,,,,1708,820.3,-887.7,28.8,38.4,9.6,,,,32.3,37.6,5.3,31.9,25.8,-6.1,,,,34.5,37.6,3.1,25.9,60.3,34.4,,,,45.4,63.7,18.3,,,,16.6,36.6,20,,,,,,,30.2,33.3,3.1,77,56.7,-20.3,,,,,,,,,,,,,,,,,,,,,,,,,,,,,,,133.3,49.9,-83.4,50.9,25.9,-25,,,,,,,,,,,,,,,,92.7,125.2,32.5,430.4,334.7,-95.7,,,,,,,,,,170.4,55.2,-115.2,69,40.4,-28.6,,,,42.3,74.4,32.1,554.9,223.4,-331.5,1.8,10,8.2,38,4.5,-33.5,73.9,57,-16.9,,,,22.8,3.4,-19.4,274.4,122.2,-152.2,,,,69.7,55,-14.7,65.6,21.6,-44,,,,119.9,46.3,-73.6,1297.1,831.4,-465.7,65.1,101.1,36,305.1,535.7,230.6,249.3,366.9,117.6,,,,,,,,,,670.2,407.1,-263.1,1480.1,638.1,-842,76.7,24.2,-52.5,,,,,,,,,,16.9,6.8,-10.1,,,,295.7,182.5,-113.2,,,,,,,,,,17.6,27.8,10.2,25.1,43.8,18.7,,,,,,,,,,,,,,,,,,,,,,,,,,,,,,,,,,,,,198.7,170,-28.7,42.7,38.1,-4.6,,,,,,,,,,,,,772.6,354.7,-417.9,53.6,40,-13.6,,,,,,,,,,,,,,,,,,,,,,,,,,,,30.5,40.7,10.2,,,,,,,51.3,131.1,79.8,,,,,,,,,,,,,125.1,5.1,-120,,,,,,,,,,,,,10,51.6,41.6,,,,41.3,492.8,451.5,,,,31.6,38.6,7,,,,,,,2,6.7,4.7,,,,154.4,147.2,-7.20000000000002,21.8,112.1,90.3,,,,18.8,9.8,-9,26.1,3.8,-22.3,,,,120.3,59.8,-60.5,,,,,,,,,,174.5,121.9,-52.6,300.2,235.3,-64.9,379.5,55.3,-324.2,,,,,,,157.3,113,-44.3,35.6,0.1,-35.5,,,,,,,344.4,383.1,38.7,,,,,,,900.3,504.3,-396,684.2,211.7,-472.5,1370.2,418.4,-951.8,5418.3,1845.2,-3573.1,362.1,599.7,237.6,,,,,,,,,,,,,,,,81.6,69.6,-12,,,,,,,,,,,,,,,,,,,,,,,,,,,,,,,,,,,,,,,,,,,,,,,,,,,,,,,,,,184.9,24.4,-160.5,,,,,,,2.4,181.1,178.7,,,,,,,,,,,,,,,,,,,,,,,,,,,,,,,25.8,8.5,-17.3,,,,,,,,,,,,,230.9,37.1,-193.8,,,,46.6,3.1,-43.5,,,,,,,,,,,,,80.9,11.6,-69.3,28.7,1,-27.7,,,,,,,,,,,,,23.3,7.9,-15.4,,,,,,,,,,,,,,,,,,,,,,,,,,,,,,,,,,,,,,,,,,,,,,,,,,,,,,,182.9,93.9,-89,,,,,,,,,,,,,,,,,,,,,,,,,,,
1985-08-01,1646,1010,-636,,,,,,,,,,,,,,,,3215,1288.3,-1926.7,2030.8,1273.7,-757.1,6274.7,4907.7,-1367,,,,,,,,,,,,,10382.2,4591.3,-5790.9,,,,299.9,501.3,201.4,748.1,206.6,-541.5,,,,4813.7,3502,-1311.7,,,,1461,1405.7,-55.3,31.9,29,-2.9,,,,31.9,33.4,1.5,28.8,23.1,-5.7,,,,37.8,33.1,-4.7,30,53,23,,,,45.6,54.8,9.2,,,,21.8,33.3,11.5,,,,,,,30.6,34.4,3.8,83.5,70.1,-13.4,,,,,,,,,,,,,,,,,,,,,,,,,,,,,,,96.8,32.1,-64.7,26.8,33.4,6.6,,,,,,,,,,,,,,,,112.6,116,3.40000000000001,454.2,271.5,-182.7,,,,,,,,,,147.9,45.2,-102.7,65.4,38.1,-27.3,,,,43.1,58.9,15.8,638.2,246.8,-391.4,0.6,9.6,9,27.7,4.7,-23,75.6,53.2,-22.4,,,,22.1,4,-18.1,262.9,150.1,-112.8,,,,56.9,45.2,-11.7,64.4,27.5,-36.9,,,,111.2,58.9,-52.3,1233.2,784.4,-448.8,65.7,85,19.3,292.7,595.5,302.8,271,445.5,174.5,,,,,,,,,,675.7,462.5,-213.2,1488.4,692.5,-795.9,61.5,28.9,-32.6,,,,,,,,,,12.8,6.4,-6.4,,,,234.8,140.5,-94.3,,,,,,,,,,16.4,23.2,6.8,12.9,67.3,54.4,,,,,,,,,,,,,,,,,,,,,,,,,,,,,,,,,,,,,229.2,214.2,-15,49.4,63.3,13.9,,,,,,,,,,,,,803.5,308.4,-495.1,36.4,70.2,33.8,,,,,,,,,,,,,,,,,,,,,,,,,,,,25.8,53.7,27.9,,,,,,,30.8,132.9,102.1,,,,,,,,,,,,,31.4,2.7,-28.7,,,,,,,,,,,,,13.1,47.6,34.5,,,,62.2,383.5,321.3,,,,19,45.1,26.1,,,,,,,4.1,6.7,2.6,,,,166.6,125.5,-41.1,17.3,53.5,36.2,,,,17.7,12.3,-5.4,20.6,4.4,-16.2,,,,105,70.8,-34.2,,,,,,,,,,186.5,114,-72.5,320.6,255.3,-65.3,419.8,69.4,-350.4,,,,,,,159.6,111,-48.6,31.5,0,-31.5,,,,,,,311.8,320.9,9.09999999999997,,,,,,,855.7,433.4,-422.3,679.1,226.3,-452.8,1359.6,373.3,-986.3,5444.2,1742.9,-3701.3,215.4,439.7,224.3,,,,,,,,,,,,,,,,84.5,61.6,-22.9,,,,,,,,,,,,,,,,,,,,,,,,,,,,,,,,,,,,,,,,,,,,,,,,,,,,,,,,,,65,18.3,-46.7,,,,,,,2,101.2,99.2,,,,,,,,,,,,,,,,,,,,,,,,,,,,,,,30.1,6.7,-23.4,,,,,,,,,,,,,302.5,79,-223.5,,,,58.8,2.8,-56,,,,,,,,,,,,,120.1,10.5,-109.6,32.2,4.8,-27.4,,,,,,,,,,,,,37.9,9.6,-28.3,,,,,,,,,,,,,,,,,,,,,,,,,,,,,,,,,,,,,,,,,,,,,,,,,,,,,,,166.5,93.2,-73.3,,,,,,,,,,,,,,,,,,,,,,,,,,,
1985-09-01,2218,968,-1250,,,,,,,,,,,,,,,,3896.3,1395.9,-2500.4,2580.7,1377.7,-1203,7633.2,5045.7,-2587.5,,,,,,,,,,,,,12547.3,4758.4,-7788.9,,,,278.3,588.5,310.2,798,170.3,-627.7,,,,6153.8,4030,-2123.8,,,,1479.4,1015.7,-463.7,34.5,52.5,18,,,,28.7,50,21.3,33.5,28.1,-5.4,,,,41.2,36.5,-4.7,27.4,57.3,29.9,,,,42.9,55.5,12.6,,,,28.6,30.8,2.2,,,,,,,27.2,29.7,2.5,89.3,65.3,-24,,,,,,,,,,,,,,,,,,,,,,,,,,,,,,,139.3,38,-101.3,26.4,21.7,-4.7,,,,,,,,,,,,,,,,143,141.3,-1.69999999999999,657.9,316.1,-341.8,,,,,,,,,,184.6,47.4,-137.2,87.7,37.9,-49.8,,,,52.6,67.7,15.1,732.1,234.5,-497.6,1,9,8,101.8,5.6,-96.2,101,52.8,-48.2,,,,24.9,3.2,-21.7,262,172.2,-89.8,,,,86.9,60.5,-26.4,75.7,46.2,-29.5,,,,154.4,51.8,-102.6,1300.1,842.8,-457.3,88.3,111.7,23.4,369.1,580.7,211.6,275.6,402.6,127,,,,,,,,,,760.6,471.9,-288.7,1807.5,651.4,-1156.1,62.6,28.1,-34.5,,,,,,,,,,19.1,3.1,-16,,,,339.2,156.2,-183,,,,,,,,,,18.9,16.9,-2,28.8,50.3,21.5,,,,,,,,,,,,,,,,,,,,,,,,,,,,,,,,,,,,,250.8,194.5,-56.3,62.9,52,-10.9,,,,,,,,,,,,,878.2,315.8,-562.4,55.2,48.7,-6.5,,,,,,,,,,,,,,,,,,,,,,,,,,,,34.2,29.8,-4.4,,,,,,,62.5,106.1,43.6,,,,,,,,,,,,,166.1,2.4,-163.7,,,,,,,,,,,,,25.2,36.6,11.4,,,,77.1,313.1,236,,,,49.1,39.1,-10,,,,,,,3.3,6.4,3.1,,,,207.1,132,-75.1,18.5,71.8,53.3,,,,17,21.4,4.4,23.4,1.9,-21.5,,,,135.7,45.6,-90.1,,,,,,,,,,187.4,105.2,-82.2,408.6,367.9,-40.7,480.3,61.5,-418.8,,,,,,,193.8,114.2,-79.6,40.6,0,-40.6,,,,,,,391.8,339.1,-52.7,,,,,,,967.9,468.8,-499.1,897.2,179.9,-717.3,1622.6,379.3,-1243.3,6451.5,1925.7,-4525.8,207.7,483.5,275.8,,,,,,,,,,,,,,,,70.6,105,34.4,,,,,,,,,,,,,,,,,,,,,,,,,,,,,,,,,,,,,,,,,,,,,,,,,,,,,,,,,,122.8,22.6,-100.2,,,,,,,2.5,142.4,139.9,,,,,,,,,,,,,,,,,,,,,,,,,,,,,,,27.3,4.1,-23.2,,,,,,,,,,,,,268.2,38.8,-229.4,,,,101.5,13.7,-87.8,,,,,,,,,,,,,86.6,11.7,-74.9,35.8,0.8,-35,,,,,,,,,,,,,66.9,6.4,-60.5,,,,,,,,,,,,,,,,,,,,,,,,,,,,,,,,,,,,,,,,,,,,,,,,,,,,,,,211.7,94.8,-116.9,,,,,,,,,,,,,,,,,,,,,,,,,,,
1985-10-01,1990,875,-1115,,,,,,,,,,,,,,,,3297.7,1203.2,-2094.5,2273.6,1383.4,-890.2,7640.6,5256.1,-2384.5,,,,,,,,,,,,,10458.1,4557.2,-5900.9,,,,280,463.2,183.2,664.8,162,-502.8,,,,6077.9,4085.3,-1992.6,,,,1562.7,1170.8,-391.9,36.6,41.4,4.8,,,,28.1,38.9,10.8,32.8,23.9,-8.9,,,,42.2,37.5,-4.7,22,59.1,37.1,,,,33,92.3,59.3,,,,14.9,34.4,19.5,,,,,,,32.4,45.1,12.7,71.6,65.7,-5.89999999999999,,,,,,,,,,,,,,,,,,,,,,,,,,,,,,,68.1,51.4,-16.7,44.4,22.6,-21.8,,,,,,,,,,,,,,,,100.7,128.8,28.1,696.3,253.8,-442.5,,,,,,,,,,155.5,47.3,-108.2,116.6,37.4,-79.2,,,,33.2,66,32.8,607.4,259.7,-347.7,2.6,8.7,6.1,30.7,5.5,-25.2,104.5,63.9,-40.6,,,,19.7,3.2,-16.5,326.9,267,-59.9,,,,72.9,59.5,-13.4,77.3,65.7,-11.6,,,,146.9,60.1,-86.8,1433.2,925.9,-507.3,87.7,133.7,46,330.7,658,327.3,285.3,455.4,170.1,,,,,,,,,,758.3,532.8,-225.5,1511.9,834.4,-677.5,66.8,38.6,-28.2,,,,,,,,,,17.9,3.4,-14.5,,,,304.5,189.2,-115.3,,,,,,,,,,16.7,18.4,1.7,36.6,96,59.4,,,,,,,,,,,,,,,,,,,,,,,,,,,,,,,,,,,,,200.9,238.5,37.6,45.6,62.7,17.1,,,,,,,,,,,,,817.4,356.2,-461.2,45.1,41.9,-3.2,,,,,,,,,,,,,,,,,,,,,,,,,,,,26.2,28.5,2.3,,,,,,,34,75.4,41.4,,,,,,,,,,,,,76.8,11.3,-65.5,,,,,,,,,,,,,25.7,31.2,5.5,,,,135.5,302.6,167.1,,,,23.2,53.9,30.7,,,,,,,4,9.6,5.6,,,,180.4,160.7,-19.7,23.5,61.9,38.4,,,,15.1,8.3,-6.8,24.4,3,-21.4,,,,124.8,64.7,-60.1,,,,,,,,,,171.2,97.7,-73.5,320.9,242.2,-78.7,336.9,56.5,-280.4,,,,,,,173.3,96.8,-76.5,30.6,0,-30.6,,,,,,,385.5,377.1,-8.39999999999998,,,,,,,836.9,420.7,-416.2,788.8,211.5,-577.3,1351.1,328.8,-1022.3,5236.9,1834.1,-3402.8,218.1,405.2,187.1,,,,,,,,,,,,,,,,61.9,58,-3.9,,,,,,,,,,,,,,,,,,,,,,,,,,,,,,,,,,,,,,,,,,,,,,,,,,,,,,,,,,193.2,11.3,-181.9,,,,,,,2.6,202.5,199.9,,,,,,,,,,,,,,,,,,,,,,,,,,,,,,,6.3,3.2,-3.1,,,,,,,,,,,,,310.2,49.6,-260.6,,,,18.5,2.3,-16.2,,,,,,,,,,,,,109,4.4,-104.6,40.4,1.7,-38.7,,,,,,,,,,,,,33.3,10.9,-22.4,,,,,,,,,,,,,,,,,,,,,,,,,,,,,,,,,,,,,,,,,,,,,,,,,,,,,,,147.1,89.9,-57.2,,,,,,,,,,,,,,,,,,,,,,,,,,,
1985-11-01,2279,959,-1320,,,,,,,,,,,,,,,,3294.4,1305.1,-1989.3,2509.1,1431.4,-1077.7,7342.7,4909.8,-2432.9,,,,,,,,,,,,,11579.2,4771.1,-6808.1,,,,269.1,516.2,247.1,652.6,146.1,-506.5,,,,5695.6,3695.7,-1999.9,,,,1647.1,1214.1,-433,28.6,43.2,14.6,,,,20.7,32.6,11.9,27,31,4,,,,40.4,31.6,-8.8,29,56,27,,,,43.7,90.8,47.1,,,,19.6,33.6,14,,,,,,,32,34.7,2.7,74.2,73.6,-0.600000000000009,,,,,,,,,,,,,,,,,,,,,,,,,,,,,,,134.1,55.5,-78.6,46.7,68.4,21.7,,,,,,,,,,,,,,,,128.9,132.8,3.90000000000001,696.9,255.6,-441.3,,,,,,,,,,213.8,58.7,-155.1,98.4,29.5,-68.9,,,,61.6,54.6,-7,608.2,268.4,-339.8,2.2,10.4,8.2,84.2,6.3,-77.9,118.9,64.1,-54.8,,,,9.5,4.6,-4.9,407.5,182.7,-224.8,,,,64.9,56.8,-8.10000000000001,60.9,50.9,-10,,,,167.7,62.6,-105.1,1331.4,896.5,-434.9,74.6,101.2,26.6,323.2,686.9,363.7,293.9,399.7,105.8,,,,,,,,,,904,550.5,-353.5,1851.3,790.8,-1060.5,77.2,58.6,-18.6,,,,,,,,,,14.7,12.2,-2.5,,,,294,179.9,-114.1,,,,,,,,,,19.6,18.8,-0.800000000000001,31.3,292.1,260.8,,,,,,,,,,,,,,,,,,,,,,,,,,,,,,,,,,,,,218.1,201.8,-16.3,40.5,50.8,10.3,,,,,,,,,,,,,896.5,371.6,-524.9,49,34.3,-14.7,,,,,,,,,,,,,,,,,,,,,,,,,,,,19.4,33.1,13.7,,,,,,,40.3,150,109.7,,,,,,,,,,,,,145,3.2,-141.8,,,,,,,,,,,,,34.8,52,17.2,,,,393.8,332.9,-60.9,,,,18.4,39.3,20.9,,,,,,,3.2,9.1,5.9,,,,170.9,118.9,-52,20.2,97.4,77.2,,,,13.8,5.7,-8.1,23.1,4.2,-18.9,,,,100.4,57.9,-42.5,,,,,,,,,,230.9,102.9,-128,381,245.2,-135.8,355.1,56.1,-299,,,,,,,170.6,109.8,-60.8,30.7,0.1,-30.6,,,,,,,327.5,316.3,-11.2,,,,,,,850.2,456.6,-393.6,750.1,226.5,-523.6,1313.1,376.8,-936.3,6042.6,1972.1,-4070.5,217.4,464.2,246.8,,,,,,,,,,,,,,,,51.7,52,0.299999999999997,,,,,,,,,,,,,,,,,,,,,,,,,,,,,,,,,,,,,,,,,,,,,,,,,,,,,,,,,,120.1,54.7,-65.4,,,,,,,3,205.6,202.6,,,,,,,,,,,,,,,,,,,,,,,,,,,,,,,15.3,4.9,-10.4,,,,,,,,,,,,,211.3,44.1,-167.2,,,,57.1,1.5,-55.6,,,,,,,,,,,,,81.6,5.2,-76.4,82,0.2,-81.8,,,,,,,,,,,,,28.4,6,-22.4,,,,,,,,,,,,,,,,,,,,,,,,,,,,,,,,,,,,,,,,,,,,,,,,,,,,,,,176.9,84.2,-92.7,,,,,,,,,,,,,,,,,,,,,,,,,,,
1985-12-01,2426,1186,-1240,,,,,,,,,,,,,,,,3067.8,1438.1,-1629.7,2287.1,1569.6,-717.5,7726,4292.4,-3433.6,,,,,,,,,,,,,11424.2,4961.9,-6462.3,,,,332.3,476.5,144.2,902.2,162.1,-740.1,,,,5939.7,3275,-2664.7,,,,1786.3,1017.4,-768.9,44.1,27.3,-16.8,,,,45.3,36.1,-9.2,38.1,23.5,-14.6,,,,46.8,31,-15.8,72.6,42.9,-29.7,,,,38.5,110.2,71.7,,,,16.2,27.5,11.3,,,,,,,35.1,26.8,-8.3,74.7,52.5,-22.2,,,,,,,,,,,,,,,,,,,,,,,,,,,,,,,88.1,41,-47.1,51.3,29.4,-21.9,,,,,,,,,,,,,,,,108.3,121.3,13,601.5,321,-280.5,,,,,,,,,,148.4,49.1,-99.3,89.8,45.4,-44.4,,,,54.6,47.4,-7.2,579.3,452.4,-126.9,5.2,8.4,3.2,33.5,5.7,-27.8,115.7,70.7,-45,,,,27.8,1.8,-26,387.9,178.2,-209.7,,,,106.4,60.6,-45.8,58.8,33.4,-25.4,,,,155.9,47.7,-108.2,1346.7,820.6,-526.1,82,94.9,12.9,389.7,591,201.3,290.1,407.9,117.8,,,,,,,,,,843.2,508.1,-335.1,2035.1,680.1,-1355,77.8,27.9,-49.9,,,,,,,,,,17.1,6.2,-10.9,,,,319.5,163.3,-156.2,,,,,,,,,,20.3,15.3,-5,30.1,203.1,173,,,,,,,,,,,,,,,,,,,,,,,,,,,,,,,,,,,,,284.9,278.3,-6.59999999999997,42.6,43.1,0.5,,,,,,,,,,,,,839.9,388.1,-451.8,54.4,127,72.6,,,,,,,,,,,,,,,,,,,,,,,,,,,,52.9,72.6,19.7,,,,,,,83.6,81.8,-1.8,,,,,,,,,,,,,57.1,1.4,-55.7,,,,,,,,,,,,,5.8,57.3,51.5,,,,503.4,419.8,-83.6,,,,44.2,61.1,16.9,,,,,,,2.6,8.1,5.5,,,,130,132.2,2.19999999999999,20,57.2,37.2,,,,18.8,4,-14.8,21.4,15,-6.4,,,,113.5,72.1,-41.4,,,,,,,,,,158.3,92.8,-65.5,337.9,311.4,-26.5,360,59.6,-300.4,,,,,,,166.4,113.6,-52.8,26.6,0,-26.6,,,,,,,306.5,462,155.5,,,,,,,795.3,433.9,-361.4,684.1,194.7,-489.4,1250.5,498.1,-752.4,6221.6,1760.8,-4460.8,265.2,430.9,165.7,,,,,,,,,,,,,,,,67.1,45.6,-21.5,,,,,,,,,,,,,,,,,,,,,,,,,,,,,,,,,,,,,,,,,,,,,,,,,,,,,,,,,,226.6,43.6,-183,,,,,,,2.9,175.3,172.4,,,,,,,,,,,,,,,,,,,,,,,,,,,,,,,62.8,2.1,-60.7,,,,,,,,,,,,,385.8,50.5,-335.3,,,,52.3,23.9,-28.4,,,,,,,,,,,,,112.8,6.2,-106.6,95,0.5,-94.5,,,,,,,,,,,,,23.2,5.2,-18,,,,,,,,,,,,,,,,,,,,,,,,,,,,,,,,,,,,,,,,,,,,,,,,,,,,,,,170.3,73.7,-96.6,,,,,,,,,,,,,,,,,,,,,,,,,,,
1986-01-01,2631,947,-1684,,,,,,,,,,,,,,,,3567,1290.7,-2276.3,2499.9,1238.9,-1261,7181.8,5022.3,-2159.5,,,,,,,,,,,,,13084.3,4590.7,-8493.6,,,,310,450.4,140.4,834.3,138.2,-696.1,,,,5680.7,3999.1,-1681.6,,,,1501.1,1023.2,-477.9,83.3,26.6,-56.7,,,,37.7,33.5,-4.2,36.7,23.3,-13.4,,,,62.5,35.9,-26.6,33,48.9,15.9,,,,71.7,67.9,-3.8,,,,24.2,37.9,13.7,,,,,,,29.9,21.8,-8.1,70.4,54.7,-15.7,,,,,,,,,,,,,,,,,,,,,,,,,,,,,,,82.9,44.7,-38.2,71.1,35.1,-36,,,,,,,,,,,,,,,,144.2,115.7,-28.5,664.7,219.3,-445.4,,,,,,,,,,161.3,44.5,-116.8,78.9,32.1,-46.8,,,,90,43.3,-46.7,631.2,274.2,-357,0.6,6.9,6.3,10.8,4.4,-6.4,114.8,68.2,-46.6,,,,7.8,3.2,-4.6,353.9,111.7,-242.2,,,,134.3,80.7,-53.6,80.3,32.6,-47.7,,,,156.6,56.3,-100.3,1273,836.2,-436.8,77.6,89.4,11.8,375,611.7,236.7,280.4,408.1,127.7,,,,,,,,,,866.6,548.2,-318.4,1988.8,768.4,-1220.4,61.4,32.4,-29,,,,,,,,,,24.8,5.6,-19.2,,,,280.7,130.9,-149.8,,,,,,,,,,21,10.4,-10.6,23,139.2,116.2,,,,,,,,,,,,,,,,,,,,,,,,,,,,,,,,,,,,,274.4,301.3,26.9,45.9,92.3,46.4,,,,,,,,,,,,,960,390.2,-569.8,55,37.6,-17.4,,,,,,,,,,,,,,,,,,,,,,,,,,,,27.8,56.7,28.9,,,,,,,101.5,144.7,43.2,,,,,,,,,,,,,116.8,2.5,-114.3,,,,,,,,,,,,,39.2,58.6,19.4,,,,463,339.6,-123.4,,,,23.6,46.2,22.6,,,,,,,7.9,7.3,-0.600000000000001,,,,167.5,138.9,-28.6,26.9,68.7,41.8,,,,18.4,8.5,-9.9,29.2,10.2,-19,,,,151.7,65.1,-86.6,,,,,,,,,,188.6,106.2,-82.4,412.2,245.5,-166.7,503.4,76.6,-426.8,,,,,,,161.2,87.5,-73.7,28.4,0.1,-28.3,,,,,,,459.5,300,-159.5,,,,,,,928.9,455.6,-473.3,711.5,211.3,-500.2,1514.4,378.3,-1136.1,6901.6,1762.5,-5139.1,236.7,367.5,130.8,,,,,,,,,,,,,,,,73.3,82.9,9.60000000000001,,,,,,,,,,,,,,,,,,,,,,,,,,,,,,,,,,,,,,,,,,,,,,,,,,,,,,,,,,248.3,40.5,-207.8,,,,,,,3.2,139.1,135.9,,,,,,,,,,,,,,,,,,,,,,,,,,,,,,,60.1,4,-56.1,,,,,,,,,,,,,325.2,41.8,-283.4,,,,30.1,3.1,-27,,,,,,,,,,,,,76.1,7,-69.1,79.8,0.8,-79,,,,,,,,,,,,,26.7,4.5,-22.2,,,,,,,,,,,,,,,,,,,,,,,,,,,,,,,,,,,,,,,,,,,,,,,,,,,,,,,236.3,77,-159.3,,,,,,,,,,,,,,,,,,,,,,,,,,,
1986-02-01,1846,802,-1044,,,,,,,,,,,,,,,,3246,1502,-1744,2104.6,1232.4,-872.2,7133.9,4850.8,-2283.1,,,,,,,,,,,,,11359.8,4743.5,-6616.3,,,,257.3,574,316.7,623.4,123.8,-499.6,,,,5659.5,3786,-1873.5,,,,1474.4,1064.8,-409.6,69.3,23.6,-45.7,,,,35,27,-8,31.1,21.5,-9.6,,,,47.3,29.6,-17.7,18.1,52.2,34.1,,,,50.5,62.4,11.9,,,,23,39.2,16.2,,,,,,,24.6,25.9,1.3,71.8,73.8,2,,,,,,,,,,,,,,,,,,,,,,,,,,,,,,,91.4,40.9,-50.5,73.5,25.8,-47.7,,,,,,,,,,,,,,,,133.6,101.4,-32.2,394.1,234.1,-160,,,,,,,,,,130.3,60.3,-70,75.9,47.6,-28.3,,,,97.3,47.1,-50.2,581.6,255.8,-325.8,0.3,7.3,7,73.5,5.6,-67.9,82.4,51.3,-31.1,,,,19.8,4.8,-15,427.2,153.4,-273.8,,,,87.3,65.1,-22.2,89.4,25.5,-63.9,,,,131.3,85,-46.3,1234.4,911.5,-322.9,71.8,107.6,35.8,329.3,724.6,395.3,287.5,437.5,150,,,,,,,,,,733,743,10,1897,927.3,-969.7,54.1,30.3,-23.8,,,,,,,,,,16.3,4.1,-12.2,,,,284.3,231.5,-52.8,,,,,,,,,,15,9.1,-5.9,41.9,271.8,229.9,,,,,,,,,,,,,,,,,,,,,,,,,,,,,,,,,,,,,218.5,211.4,-7.09999999999999,39.4,42.4,3,,,,,,,,,,,,,823.6,405.2,-418.4,47.6,17,-30.6,,,,,,,,,,,,,,,,,,,,,,,,,,,,24,55.4,31.4,,,,,,,54.5,77.6,23.1,,,,,,,,,,,,,34.2,1.2,-33,,,,,,,,,,,,,31.2,39.9,8.7,,,,496.2,245.1,-251.1,,,,10.1,36.2,26.1,,,,,,,4.5,55.4,50.9,,,,202.5,99.4,-103.1,22.7,65.6,42.9,,,,16.2,20.6,4.4,27.2,9.8,-17.4,,,,127.4,67.3,-60.1,,,,,,,,,,173.7,118.3,-55.4,305.7,245.4,-60.3,365.1,59.7,-305.4,,,,,,,142.9,100.1,-42.8,28.1,0.1,-28,,,,,,,376.6,330.6,-46,,,,,,,863,510,-353,689.2,296.6,-392.6,1388.1,450,-938.1,5860.6,1813,-4047.6,190.1,463.5,273.4,,,,,,,,,,,,,,,,67.2,110.5,43.3,,,,,,,,,,,,,,,,,,,,,,,,,,,,,,,,,,,,,,,,,,,,,,,,,,,,,,,,,,147.7,52.6,-95.1,,,,,,,3.2,185.8,182.6,,,,,,,,,,,,,,,,,,,,,,,,,,,,,,,47.4,5.2,-42.2,,,,,,,,,,,,,194.6,24.3,-170.3,,,,17.5,1.5,-16,,,,,,,,,,,,,80.3,4.6,-75.7,59.6,0.4,-59.2,,,,,,,,,,,,,32.1,9.3,-22.8,,,,,,,,,,,,,,,,,,,,,,,,,,,,,,,,,,,,,,,,,,,,,,,,,,,,,,,191.9,78.5,-113.4,,,,,,,,,,,,,,,,,,,,,,,,,,,
1986-03-01,1728,1025,-703,,,,,,,,,,,,,,,,3643.2,1583.4,-2059.8,2100.1,1423.4,-676.7,7410.6,4688.6,-2722,,,,,,,,,,,,,12989.3,5314.4,-7674.9,,,,309,813.1,504.1,627.8,140.2,-487.6,,,,5922.9,3659.2,-2263.7,,,,1487.7,1029.4,-458.3,61.1,43.7,-17.4,,,,44.4,82.1,37.7,35.2,42.7,7.5,,,,53.4,45.8,-7.6,33.1,64.2,31.1,,,,44.4,62.4,18,,,,35.2,27.2,-8,,,,,,,33.3,32.6,-0.699999999999996,101,77.4,-23.6,,,,,,,,,,,,,,,,,,,,,,,,,,,,,,,65.4,43.4,-22,42.6,44.7,2.1,,,,,,,,,,,,,,,,124.2,110,-14.2,504.4,263.2,-241.2,,,,,,,,,,110.6,49,-61.6,72.6,46.6,-26,,,,112.6,52.5,-60.1,517.5,246.9,-270.6,1.2,10.6,9.4,22.8,7,-15.8,85.1,71.4,-13.7,,,,36.5,4.4,-32.1,385.2,158.2,-227,,,,134.6,74.2,-60.4,82.4,32.2,-50.2,,,,151.5,69.5,-82,1288.5,1166.7,-121.8,83.3,122.2,38.9,358.2,744.8,386.6,354.9,489.6,134.7,,,,,,,,,,893.8,614.4,-279.4,2163.8,917.7,-1246.1,68.9,55.7,-13.2,,,,,,,,,,14.2,4.5,-9.7,,,,657.2,279.5,-377.7,,,,,,,,,,19.3,12.9,-6.4,29.1,171.6,142.5,,,,,,,,,,,,,,,,,,,,,,,,,,,,,,,,,,,,,205.5,238.6,33.1,48.4,60.6,12.2,,,,,,,,,,,,,937.8,432.1,-505.7,50.1,44.3,-5.8,,,,,,,,,,,,,,,,,,,,,,,,,,,,37.7,48.8,11.1,,,,,,,51.8,138.7,86.9,,,,,,,,,,,,,69,3.3,-65.7,,,,,,,,,,,,,0.8,61.5,60.7,,,,312,387.2,75.2,,,,6,54.4,48.4,,,,,,,8.1,10.3,2.2,,,,217.3,128.5,-88.8,28.2,123.8,95.6,,,,23.7,18.4,-5.3,31.3,4.2,-27.1,,,,158,100.3,-57.7,,,,,,,,,,226.7,137.3,-89.4,417.8,373.2,-44.6,254.4,66.9,-187.5,,,,,,,192.5,139.8,-52.7,23.8,0.1,-23.7,,,,,,,401.8,289.6,-112.2,,,,,,,1027.8,535.8,-492,645,244.9,-400.1,1552.6,429.5,-1123.1,7185.4,1998.1,-5187.3,220.8,682.5,461.7,,,,,,,,,,,,,,,,88.2,130.6,42.4,,,,,,,,,,,,,,,,,,,,,,,,,,,,,,,,,,,,,,,,,,,,,,,,,,,,,,,,,,174.6,44.7,-129.9,,,,,,,3,151.8,148.8,,,,,,,,,,,,,,,,,,,,,,,,,,,,,,,39.7,4,-35.7,,,,,,,,,,,,,262.8,22.7,-240.1,,,,20.4,1.8,-18.6,,,,,,,,,,,,,73.6,4.3,-69.3,16.8,1.2,-15.6,,,,,,,,,,,,,3.8,7.9,4.1,,,,,,,,,,,,,,,,,,,,,,,,,,,,,,,,,,,,,,,,,,,,,,,,,,,,,,,210.7,98.3,-112.4,,,,,,,,,,,,,,,,,,,,,,,,,,,
1986-04-01,1180,1047,-133,,,,,,,,,,,,,,,,3177.3,1483.2,-1694.1,1909.6,1326.4,-583.2,7198,5158.2,-2039.8,,,,,,,,,,,,,11123.1,5079.6,-6043.5,,,,304.6,416.4,111.8,364.1,169.4,-194.7,,,,5821.1,4057.3,-1763.8,,,,1376.9,1100.9,-276,48.6,33.4,-15.2,,,,41,27.2,-13.8,43.2,27.8,-15.4,,,,47.2,40.2,-7,28.6,58,29.4,,,,25.7,69.8,44.1,,,,21.2,40.1,18.9,,,,,,,28.6,29.7,1.1,88.3,71.8,-16.5,,,,,,,,,,,,,,,,,,,,,,,,,,,,,,,54.4,41.1,-13.3,24.9,27.3,2.4,,,,,,,,,,,,,,,,144.1,115.5,-28.6,382.2,254,-128.2,,,,,,,,,,89.5,50.6,-38.9,53.3,45.1,-8.2,,,,94.4,56,-38.4,596.7,242.1,-354.6,1.2,13.2,12,41.1,6.7,-34.4,55.4,76.8,21.4,,,,12,4.1,-7.9,389.1,130.5,-258.6,,,,90.6,86.3,-4.3,58.8,25.2,-33.6,,,,159.1,54.7,-104.4,1219.9,926.7,-293.2,73.7,120,46.3,297.5,660.2,362.7,296.6,435.7,139.1,,,,,,,,,,921.4,645.8,-275.6,2030.7,919.3,-1111.4,67.8,35.2,-32.6,,,,,,,,,,14.1,4.8,-9.3,,,,683.7,166,-517.7,,,,,,,,,,17.1,13,-4.1,22,184.4,162.4,,,,,,,,,,,,,,,,,,,,,,,,,,,,,,,,,,,,,169.1,225.9,56.8,43,42.7,-0.299999999999997,,,,,,,,,,,,,805.7,392.9,-412.8,42.8,29.7,-13.1,,,,,,,,,,,,,,,,,,,,,,,,,,,,27.6,24,-3.6,,,,,,,26.3,101,74.7,,,,,,,,,,,,,22.4,1.8,-20.6,,,,,,,,,,,,,21.8,212.4,190.6,,,,209.1,272.1,63,,,,18.7,55.7,37,,,,,,,2.7,7.8,5.1,,,,173.3,110.2,-63.1,29.5,53.7,24.2,,,,19,13.7,-5.3,23.1,1.8,-21.3,,,,130.4,87.9,-42.5,,,,,,,,,,174.2,165.3,-8.89999999999998,346.1,301.8,-44.3,182.1,84.6,-97.5,,,,,,,144.5,118.3,-26.2,24.2,0.5,-23.7,,,,,,,264.9,318.9,54,,,,,,,894,490.5,-403.5,559,232.5,-326.5,1378.2,458.4,-919.8,6333.2,1905.8,-4427.4,235.5,366.4,130.9,,,,,,,,,,,,,,,,69.1,50,-19.1,,,,,,,,,,,,,,,,,,,,,,,,,,,,,,,,,,,,,,,,,,,,,,,,,,,,,,,,,,118.4,39.9,-78.5,,,,,,,3.4,132,128.6,,,,,,,,,,,,,,,,,,,,,,,,,,,,,,,28.1,5.4,-22.7,,,,,,,,,,,,,112.7,40.4,-72.3,,,,0.8,1.3,0.5,,,,,,,,,,,,,40.1,11.3,-28.8,13,0.8,-12.2,,,,,,,,,,,,,24,17.9,-6.1,,,,,,,,,,,,,,,,,,,,,,,,,,,,,,,,,,,,,,,,,,,,,,,,,,,,,,,145.4,92.3,-53.1,,,,,,,,,,,,,,,,,,,,,,,,,,,
1986-05-01,1504,904,-600,,,,,,,,,,,,,,,,3502.6,1465.3,-2037.3,2131.7,1548.9,-582.8,7629.7,4901.9,-2727.8,,,,,,,,,,,,,11845.8,4609,-7236.8,,,,253.7,506,252.3,483.1,139.5,-343.6,,,,5922.5,3780.9,-2141.6,,,,1707.2,1121,-586.2,34.7,36.2,1.5,,,,47,83.4,36.4,39.1,25.5,-13.6,,,,52,40.6,-11.4,39.7,58.3,18.6,,,,31.3,66.4,35.1,,,,26.2,41.1,14.9,,,,,,,39.7,38.3,-1.40000000000001,93.4,90.7,-2.7,,,,,,,,,,,,,,,,,,,,,,,,,,,,,,,83.9,64.1,-19.8,36.1,30.9,-5.2,,,,,,,,,,,,,,,,141,126.4,-14.6,391.2,322.4,-68.8,,,,,,,,,,153,50.8,-102.2,73.2,46.7,-26.5,,,,77.3,56.9,-20.4,664.4,263.9,-400.5,9,18.9,9.9,44.8,10.5,-34.3,54.7,76.9,22.2,,,,20.7,4,-16.7,340.4,141.8,-198.6,,,,53.2,92.1,38.9,69.5,33.7,-35.8,,,,128.6,56,-72.6,1232.1,960,-272.1,74.4,117,42.6,333.1,686.7,353.6,334.4,439.6,105.2,,,,,,,,,,902,524.6,-377.4,2131,763.3,-1367.7,71.9,32.3,-39.6,,,,,,,,,,14.2,13.7,-0.5,,,,536.9,349.9,-187,,,,,,,,,,17.7,18.2,0.5,27.1,74.9,47.8,,,,,,,,,,,,,,,,,,,,,,,,,,,,,,,,,,,,,194.7,181.2,-13.5,39.8,66.4,26.6,,,,,,,,,,,,,798.2,414.3,-383.9,58,34.8,-23.2,,,,,,,,,,,,,,,,,,,,,,,,,,,,54.3,37.4,-16.9,,,,,,,28.4,91.3,62.9,,,,,,,,,,,,,6.8,3.3,-3.5,,,,,,,,,,,,,12.1,31.6,19.5,,,,244.6,275,30.4,,,,30,46.4,16.4,,,,,,,3.5,6.4,2.9,,,,185,132,-53,28.2,62.6,34.4,,,,14.4,4.2,-10.2,20.1,3,-17.1,,,,162.9,68.1,-94.8,,,,,,,,,,222.7,148.8,-73.9,382,260.5,-121.5,291.6,85.1,-206.5,,,,,,,157.7,104.3,-53.4,33.4,0.2,-33.2,,,,,,,319,256.8,-62.2,,,,,,,966.1,549.1,-417,630.6,236.1,-394.5,1523.9,419.6,-1104.3,6439.1,1732.2,-4706.9,188.4,457.5,269.1,,,,,,,,,,,,,,,,65.3,48.5,-16.8,,,,,,,,,,,,,,,,,,,,,,,,,,,,,,,,,,,,,,,,,,,,,,,,,,,,,,,,,,141.1,34,-107.1,,,,,,,4.2,141.1,136.9,,,,,,,,,,,,,,,,,,,,,,,,,,,,,,,45.2,4.4,-40.8,,,,,,,,,,,,,185.4,16.9,-168.5,,,,6.9,2.3,-4.6,,,,,,,,,,,,,48.6,11.8,-36.8,5.5,1,-4.5,,,,,,,,,,,,,16.4,7.6,-8.8,,,,,,,,,,,,,,,,,,,,,,,,,,,,,,,,,,,,,,,,,,,,,,,,,,,,,,,175.1,95.5,-79.6,,,,,,,,,,,,,,,,,,,,,,,,,,,
1986-06-01,1637,837,-800,,,,,,,,,,,,,,,,3841.6,1399.8,-2441.8,1936.8,1465.1,-471.7,6949.6,4918.2,-2031.4,,,,,,,,,,,,,13232.7,6636.8,-6595.9,,,,291.5,459.5,168,510.8,136.4,-374.4,,,,5711.7,3857.5,-1854.2,,,,1237.9,1060.7,-177.2,35.5,30,-5.5,,,,38.4,40.1,1.7,44.3,31.7,-12.6,,,,47.9,39.5,-8.4,33.9,52.1,18.2,,,,28.8,49.1,20.3,,,,21.7,35.7,14,,,,,,,33.5,31.3,-2.2,81.8,73.8,-8,,,,,,,,,,,,,,,,,,,,,,,,,,,,,,,50.5,32.2,-18.3,45.9,33.1,-12.8,,,,,,,,,,,,,,,,176.5,114.2,-62.3,416,279.2,-136.8,,,,,,,,,,103.1,62.1,-41,61.4,52.6,-8.8,,,,43.7,107.3,63.6,564.4,301.6,-262.8,1.9,15.9,14,36.4,6.8,-29.6,71.2,76.8,5.59999999999999,,,,20.6,4.1,-16.5,405.1,126.7,-278.4,,,,101.3,87.3,-14,82.4,33.2,-49.2,,,,140.1,49.9,-90.2,1519.1,961.1,-558,91.3,108.5,17.2,380.6,498.4,117.8,423.7,501.2,77.5,,,,,,,,,,926.7,546.1,-380.6,2058.8,777.8,-1281,94.8,35.6,-59.2,,,,,,,,,,20.2,3.1,-17.1,,,,537.4,185.8,-351.6,,,,,,,,,,20.2,12.3,-7.9,198,90.1,-107.9,,,,,,,,,,,,,,,,,,,,,,,,,,,,,,,,,,,,,209,148.1,-60.9,47.5,38,-9.5,,,,,,,,,,,,,902.5,478.9,-423.6,50.9,35.7,-15.2,,,,,,,,,,,,,,,,,,,,,,,,,,,,38.7,27.1,-11.6,,,,,,,44.5,68.9,24.4,,,,,,,,,,,,,55,4,-51,,,,,,,,,,,,,50.4,39.8,-10.6,,,,313.5,226.9,-86.6,,,,43.2,49.3,6.09999999999999,,,,,,,12.8,5.7,-7.1,,,,188.6,119.3,-69.3,29.6,116.5,86.9,,,,16.3,6.2,-10.1,24.2,1.9,-22.3,,,,144,67.5,-76.5,,,,,,,,,,230.4,149.7,-80.7,371.7,247.8,-123.9,245.1,57,-188.1,,,,,,,182.5,112.7,-69.8,36.3,0.5,-35.8,,,,,,,375.7,275.3,-100.4,,,,,,,1139.4,543.3,-596.1,727.1,217.6,-509.5,1603.4,391.1,-1212.3,7240.1,3860.5,-3379.6,176.7,406.4,229.7,,,,,,,,,,,,,,,,114.8,53.1,-61.7,,,,,,,,,,,,,,,,,,,,,,,,,,,,,,,,,,,,,,,,,,,,,,,,,,,,,,,,,,170.8,51.7,-119.1,,,,,,,4.4,163.9,159.5,,,,,,,,,,,,,,,,,,,,,,,,,,,,,,,37,3,-34,,,,,,,,,,,,,162.2,11.3,-150.9,,,,32,1,-31,,,,,,,,,,,,,62.3,7.4,-54.9,24.2,1.1,-23.1,,,,,,,,,,,,,17.2,11.2,-6,,,,,,,,,,,,,,,,,,,,,,,,,,,,,,,,,,,,,,,,,,,,,,,,,,,,,,,175.9,101.4,-74.5,,,,,,,,,,,,,,,,,,,,,,,,,,,
1986-07-01,1620,920,-700,,,,,,,,,,,,,,,,4544.1,1472.2,-3071.9,1957,1582.8,-374.2,7142.6,4211.5,-2931.1,,,,,,,,,,,,,14950.3,5854.3,-9096,,,,375.3,487.6,112.3,583.6,142.3,-441.3,,,,5475.6,3172.4,-2303.2,,,,1667,1039.1,-627.9,44.6,37.6,-7,,,,34.6,43.4,8.8,29,28.6,-0.399999999999999,,,,47.2,37.6,-9.6,31.3,52,20.7,,,,29.9,62.1,32.2,,,,27.5,37.3,9.8,,,,,,,34.1,32.3,-1.8,97.8,88.5,-9.3,,,,,,,,,,,,,,,,,,,,,,,,,,,,,,,52,42.2,-9.8,28.5,28.1,-0.399999999999999,,,,,,,,,,,,,,,,174.9,121.6,-53.3,383.6,298.4,-85.2,,,,,,,,,,109.6,50.3,-59.3,58.1,66,7.9,,,,45.4,113.2,67.8,599.4,336.2,-263.2,4.8,14.7,9.9,46,8.1,-37.9,78.7,84.6,5.89999999999999,,,,15.3,6.2,-9.1,466.6,198.7,-267.9,,,,84.8,51.6,-33.2,81.8,24.5,-57.3,,,,145.9,55.1,-90.8,1289.2,862.7,-426.5,106.5,115.7,9.2,380.3,497,116.7,538.5,363.4,-175.1,,,,,,,,,,944.8,571.6,-373.2,2334.5,710.1,-1624.4,96.4,58.1,-38.3,,,,,,,,,,23.8,4.5,-19.3,,,,431.1,518.9,87.8,,,,,,,,,,23.4,7.8,-15.6,31.6,55.1,23.5,,,,,,,,,,,,,,,,,,,,,,,,,,,,,,,,,,,,,290.3,191.6,-98.7,55.6,42.9,-12.7,,,,,,,,,,,,,1067.5,320.4,-747.1,64.9,30.6,-34.3,,,,,,,,,,,,,,,,,,,,,,,,,,,,29.5,28.6,-0.899999999999999,,,,,,,44.1,82.6,38.5,,,,,,,,,,,,,86.3,5.2,-81.1,,,,,,,,,,,,,26,25.2,-0.800000000000001,,,,271.3,299.7,28.4,,,,28.6,40.2,11.6,,,,,,,4.9,6.7,1.8,,,,210,138.5,-71.5,29.3,26.2,-3.1,,,,21.2,9.9,-11.3,32.4,6.4,-26,,,,159,63.2,-95.8,,,,,,,,,,232.7,257.8,25.1,447.2,247.6,-199.6,308.9,60.6,-248.3,,,,,,,178.4,105.9,-72.5,44.1,0.5,-43.6,,,,,,,450.2,198.6,-251.6,,,,,,,1301.5,538.5,-763,842.2,249.7,-592.5,1953.2,436.4,-1516.8,8101.9,2941,-5160.9,266.1,418.8,152.7,,,,,,,,,,,,,,,,109.2,68.8,-40.4,,,,,,,,,,,,,,,,,,,,,,,,,,,,,,,,,,,,,,,,,,,,,,,,,,,,,,,,,,127.1,42.9,-84.2,,,,,,,19.8,133,113.2,,,,,,,,,,,,,,,,,,,,,,,,,,,,,,,38.8,2.6,-36.2,,,,,,,,,,,,,207.7,33.9,-173.8,,,,13.3,0.8,-12.5,,,,,,,,,,,,,49.1,5.9,-43.2,36.6,0.4,-36.2,,,,,,,,,,,,,9.9,6.5,-3.4,,,,,,,,,,,,,,,,,,,,,,,,,,,,,,,,,,,,,,,,,,,,,,,,,,,,,,,228.2,92.2,-136,,,,,,,,,,,,,,,,,,,,,,,,,,,
1986-08-01,1441,928,-513,,,,,,,,,,,,,,,,4143.8,1689.6,-2454.2,1830.4,1579.1,-251.3,6474.5,4104.3,-2370.2,,,,,,,,,,,,,12863.1,5549.8,-7313.3,,,,266.8,520.7,253.9,480.6,203.9,-276.7,,,,5224.8,3094.7,-2130.1,,,,1249.7,1009.6,-240.1,29.2,38.2,9,,,,38.3,36.5,-1.8,41.1,28.3,-12.8,,,,48.8,40.9,-7.9,27,65,38,,,,35.3,47.6,12.3,,,,27.1,37.8,10.7,,,,,,,33.7,38.3,4.59999999999999,108.8,84,-24.8,,,,,,,,,,,,,,,,,,,,,,,,,,,,,,,57.4,32.5,-24.9,36.2,28.8,-7.4,,,,,,,,,,,,,,,,146,100.6,-45.4,360.9,244.3,-116.6,,,,,,,,,,93.3,52.6,-40.7,62.8,64.9,2.10000000000001,,,,46.2,81.1,34.9,530.1,441,-89.1,1,17.7,16.7,45.6,12.3,-33.3,61.6,86.7,25.1,,,,20.4,6.7,-13.7,200,146.6,-53.4,,,,77.2,86.7,9.5,63.4,37.4,-26,,,,108.2,64.6,-43.6,1127.3,933.7,-193.6,103.9,127.5,23.6,324.2,561.1,236.9,279.5,424.1,144.6,,,,,,,,,,802.4,600.6,-201.8,2064.5,859,-1205.5,74.9,35.3,-39.6,,,,,,,,,,18.2,4.6,-13.6,,,,302,248.5,-53.5,,,,,,,,,,17.7,18.5,0.800000000000001,42.1,66.5,24.4,,,,,,,,,,,,,,,,,,,,,,,,,,,,,,,,,,,,,249.9,173.3,-76.6,53.9,34.6,-19.3,,,,,,,,,,,,,989.1,343.2,-645.9,53.6,34.2,-19.4,,,,,,,,,,,,,,,,,,,,,,,,,,,,27.4,23.7,-3.7,,,,,,,41.4,123.2,81.8,,,,,,,,,,,,,52.2,2.1,-50.1,,,,,,,,,,,,,22.9,35,12.1,,,,219.3,324.9,105.6,,,,44.7,34.8,-9.90000000000001,,,,,,,7.7,7.2,-0.5,,,,204.3,153.8,-50.5,24.3,85.4,61.1,,,,20.7,32.1,11.4,28,2.3,-25.7,,,,144.1,98.7,-45.4,,,,,,,,,,196.2,144.1,-52.1,376.5,366.9,-9.60000000000002,238.5,92.6,-145.9,,,,,,,167.3,138.5,-28.8,41.7,0.4,-41.3,,,,,,,434.7,235.6,-199.1,,,,,,,1160.3,567.8,-592.5,791.3,279.1,-512.2,1815.7,475.8,-1339.9,6694.4,2272.4,-4422,183,458.9,275.9,,,,,,,,,,,,,,,,83.8,61.8,-22,,,,,,,,,,,,,,,,,,,,,,,,,,,,,,,,,,,,,,,,,,,,,,,,,,,,,,,,,,160.3,52.4,-107.9,,,,,,,5,149.8,144.8,,,,,,,,,,,,,,,,,,,,,,,,,,,,,,,18.2,4,-14.2,,,,,,,,,,,,,207.6,49.5,-158.1,,,,10.8,1.1,-9.7,,,,,,,,,,,,,27.9,7.6,-20.3,40.7,0.7,-40,,,,,,,,,,,,,19,10,-9,,,,,,,,,,,,,,,,,,,,,,,,,,,,,,,,,,,,,,,,,,,,,,,,,,,,,,,156.4,131,-25.4,,,,,,,,,,,,,,,,,,,,,,,,,,,
1986-09-01,1644,721,-923,,,,,,,,,,,,,,,,4032.2,1391.8,-2640.4,1957.3,1497.6,-459.7,6952.9,5084.3,-1868.6,,,,,,,,,,,,,11982,4729.7,-7252.3,,,,270,548.8,278.8,549,160.8,-388.2,,,,5571.6,4119.4,-1452.2,,,,1381.3,964.9,-416.4,42.4,30.9,-11.5,,,,30.3,41.2,10.9,32.9,27.6,-5.3,,,,49.2,44.4,-4.8,26.2,66.3,40.1,,,,28.2,55.3,27.1,,,,18.2,37.7,19.5,,,,,,,29.2,34.6,5.4,90.8,70.1,-20.7,,,,,,,,,,,,,,,,,,,,,,,,,,,,,,,71.8,34.1,-37.7,25.4,29.4,4,,,,,,,,,,,,,,,,167.5,96.6,-70.9,466.8,234.5,-232.3,,,,,,,,,,148,47.3,-100.7,60.5,65.4,4.90000000000001,,,,47,64.9,17.9,518.6,412.5,-106.1,2.3,10.6,8.3,43.2,12,-31.2,58.8,82.2,23.4,,,,25.1,3.6,-21.5,267.5,242.6,-24.9,,,,85.5,82.1,-3.40000000000001,66.2,37.5,-28.7,,,,125.2,60.5,-64.7,1241.6,878,-363.6,74.7,127.3,52.6,284.7,574.4,289.7,282.6,475.3,192.7,,,,,,,,,,682,638,-44,1827,821.3,-1005.7,59.5,38.7,-20.8,,,,,,,,,,15.1,3.9,-11.2,,,,300.7,188.5,-112.2,,,,,,,,,,17.1,10.9,-6.2,47.9,40.8,-7.1,,,,,,,,,,,,,,,,,,,,,,,,,,,,,,,,,,,,,191.7,198.1,6.40000000000001,42.4,39.2,-3.2,,,,,,,,,,,,,706.5,361,-345.5,50.3,36.6,-13.7,,,,,,,,,,,,,,,,,,,,,,,,,,,,29.6,36.9,7.3,,,,,,,33.3,83.3,50,,,,,,,,,,,,,49.6,6.9,-42.7,,,,,,,,,,,,,24.1,24.1,0,,,,256.6,224,-32.6,,,,16.1,30.8,14.7,,,,,,,6.1,7,0.9,,,,220.8,137.1,-83.7,26,94.6,68.6,,,,20,19.1,-0.899999999999999,27.1,11.8,-15.3,,,,136.1,68.1,-68,,,,,,,,,,203.4,132.5,-70.9,418.3,267.9,-150.4,227.7,56.2,-171.5,,,,,,,173.4,110.2,-63.2,44.4,0.1,-44.3,,,,,,,413.4,216.4,-197,,,,,,,1103,489,-614,778.9,232.1,-546.8,1732,402.8,-1329.2,5884.2,2015.2,-3869,180.8,438.1,257.3,,,,,,,,,,,,,,,,89.2,110.7,21.5,,,,,,,,,,,,,,,,,,,,,,,,,,,,,,,,,,,,,,,,,,,,,,,,,,,,,,,,,,133.7,25.6,-108.1,,,,,,,27,106.9,79.9,,,,,,,,,,,,,,,,,,,,,,,,,,,,,,,31.7,4.6,-27.1,,,,,,,,,,,,,216,44.2,-171.8,,,,17.4,1.1,-16.3,,,,,,,,,,,,,43.2,5.8,-37.4,10.8,0.5,-10.3,,,,,,,,,,,,,13.3,7.4,-5.9,,,,,,,,,,,,,,,,,,,,,,,,,,,,,,,,,,,,,,,,,,,,,,,,,,,,,,,216.6,97.2,-119.4,,,,,,,,,,,,,,,,,,,,,,,,,,,
1986-10-01,1566,939,-627,,,,,,,,,,,,,,,,4084,1713.1,-2370.9,1840.8,1585.9,-254.9,7030.3,5263,-1767.3,,,,,,,,,,,,,13129.8,5461.3,-7668.5,,,,290.8,559.2,268.4,555,152.2,-402.8,,,,5719,4175.9,-1543.1,,,,1311.3,1087.1,-224.2,35.8,34.6,-1.2,,,,15.6,36,20.4,35.8,37.5,1.7,,,,49.3,42.7,-6.59999999999999,31.7,63.7,32,,,,31.3,59.8,28.5,,,,23,34.8,11.8,,,,,,,27.2,36.9,9.7,81.9,72.2,-9.7,,,,,,,,,,,,,,,,,,,,,,,,,,,,,,,44.6,62,17.4,24.4,27.9,3.5,,,,,,,,,,,,,,,,164.4,116.9,-47.5,364.8,248.2,-116.6,,,,,,,,,,140.3,43.9,-96.4,76.5,81.9,5.40000000000001,,,,45,74,29,539.9,388.1,-151.8,1.2,19.7,18.5,52.6,10.1,-42.5,55.5,95,39.5,,,,15.3,6.9,-8.4,361.9,156.2,-205.7,,,,53.9,72.1,18.2,70.7,34.2,-36.5,,,,148.5,82,-66.5,1098.6,988.2,-110.4,83.5,148.7,65.2,300.2,862.9,562.7,314.4,481.8,167.4,,,,,,,,,,730.6,644.9,-85.7,1944.2,1051.8,-892.4,64.5,37.7,-26.8,,,,,,,,,,19.2,6.7,-12.5,,,,331.4,227,-104.4,,,,,,,,,,20.2,14.2,-6,25.4,62,36.6,,,,,,,,,,,,,,,,,,,,,,,,,,,,,,,,,,,,,186.3,210,23.7,41.2,49.6,8.4,,,,,,,,,,,,,796.9,425.8,-371.1,53.9,57.3,3.4,,,,,,,,,,,,,,,,,,,,,,,,,,,,25.3,32.7,7.4,,,,,,,39.9,67.7,27.8,,,,,,,,,,,,,44.4,1.2,-43.2,,,,,,,,,,,,,26.3,56.9,30.6,,,,259.7,282.8,23.1,,,,81.1,33.2,-47.9,,,,,,,10,29.7,19.7,,,,181.9,126.5,-55.4,29.4,42.7,13.3,,,,20.4,22.8,2.4,26.8,2.6,-24.2,,,,166.6,83.2,-83.4,,,,,,,,,,187.6,133.3,-54.3,390,277.2,-112.8,240,144.2,-95.8,,,,,,,148.6,116.3,-32.3,39,0,-39,,,,,,,398.5,198.8,-199.7,,,,,,,1107.4,527.6,-579.8,853,340.5,-512.5,1733.6,567.8,-1165.8,6995.6,2285.9,-4709.7,218.2,502,283.8,,,,,,,,,,,,,,,,72.6,57.2,-15.4,,,,,,,,,,,,,,,,,,,,,,,,,,,,,,,,,,,,,,,,,,,,,,,,,,,,,,,,,,138.1,34.2,-103.9,,,,,,,12.5,158,145.5,,,,,,,,,,,,,,,,,,,,,,,,,,,,,,,23.2,2.8,-20.4,,,,,,,,,,,,,206.5,36.7,-169.8,,,,18.6,3.6,-15,,,,,,,,,,,,,62.7,5.5,-57.2,33.4,0.9,-32.5,,,,,,,,,,,,,10.8,7.9,-2.9,,,,,,,,,,,,,,,,,,,,,,,,,,,,,,,,,,,,,,,,,,,,,,,,,,,,,,,199.8,94.8,-105,,,,,,,,,,,,,,,,,,,,,,,,,,,
1986-11-01,1627,961,-666,,,,,,,,,,,,,,,,4893.1,1584,-3309.1,2014.2,1610.9,-403.3,8206.5,4856.9,-3349.6,,,,,,,,,,,,,15569.3,5025.5,-10543.8,,,,357.8,605.6,247.8,577.4,162.7,-414.7,,,,6681.4,3911.1,-2770.3,,,,1525.1,945.8,-579.3,59.8,28.8,-31,,,,13.5,34.3,20.8,33.8,37.1,3.3,,,,66.9,49.6,-17.3,32,71.1,39.1,,,,24.8,79.9,55.1,,,,25.4,45.4,20,,,,,,,34.6,36.1,1.5,109.4,86.5,-22.9,,,,,,,,,,,,,,,,,,,,,,,,,,,,,,,76.9,49.5,-27.4,38.7,40,1.3,,,,,,,,,,,,,,,,195.9,96.6,-99.3,414.4,279.4,-135,,,,,,,,,,129.1,46.9,-82.2,70.4,72.1,1.69999999999999,,,,60.4,61.7,1.3,513.7,370.4,-143.3,4.1,23,18.9,37.5,8.9,-28.6,72.9,93.6,20.7,,,,22,5.9,-16.1,439.9,164.6,-275.3,,,,93.4,81.5,-11.9,96.4,36,-60.4,,,,202.9,66,-136.9,1511,1016.8,-494.2,90.8,110.5,19.7,353.8,662.4,308.6,363.1,487.3,124.2,,,,,,,,,,992.8,601.1,-391.7,2575.9,1068.8,-1507.1,85.9,39.4,-46.5,,,,,,,,,,22.3,20,-2.3,,,,567.2,226.6,-340.6,,,,,,,,,,22.7,13.3,-9.4,50.5,44.2,-6.3,,,,,,,,,,,,,,,,,,,,,,,,,,,,,,,,,,,,,271.6,278,6.39999999999998,53.5,40.1,-13.4,,,,,,,,,,,,,1022.9,461.4,-561.5,61.3,93.4,32.1,,,,,,,,,,,,,,,,,,,,,,,,,,,,41.4,28.1,-13.3,,,,,,,62.6,73.7,11.1,,,,,,,,,,,,,22.6,1.1,-21.5,,,,,,,,,,,,,8.4,41.7,33.3,,,,310.7,338.4,27.7,,,,35.3,34.5,-0.799999999999997,,,,,,,6.4,37.7,31.3,,,,198.3,117.2,-81.1,28.3,53.9,25.6,,,,20,4.9,-15.1,37.7,3.6,-34.1,,,,151.3,89.4,-61.9,,,,,,,,,,237.4,123.4,-114,491.6,276.1,-215.5,266.6,96.2,-170.4,,,,,,,190.2,117.7,-72.5,39.9,0,-39.9,,,,,,,486,226.7,-259.3,,,,,,,1303.2,558.1,-745.1,998.7,248.8,-749.9,2099.6,501,-1598.6,8392.1,1990.1,-6402,273.2,548.3,275.1,,,,,,,,,,,,,,,,84.6,57.3,-27.3,,,,,,,,,,,,,,,,,,,,,,,,,,,,,,,,,,,,,,,,,,,,,,,,,,,,,,,,,,118.5,17.5,-101,,,,,,,11.5,272.7,261.2,,,,,,,,,,,,,,,,,,,,,,,,,,,,,,,31.2,6.2,-25,,,,,,,,,,,,,254.1,35.9,-218.2,,,,8.7,4.5,-4.2,,,,,,,,,,,,,47.7,4.9,-42.8,31.8,1.5,-30.3,,,,,,,,,,,,,26.9,10.4,-16.5,,,,,,,,,,,,,,,,,,,,,,,,,,,,,,,,,,,,,,,,,,,,,,,,,,,,,,,177,99.3,-77.7,,,,,,,,,,,,,,,,,,,,,,,,,,,
1986-12-01,1327,813,-514,,,,,,,,,,,,,,,,3460.7,1714.5,-1746.2,1836.4,1516.5,-319.9,6244,4664.2,-1579.8,,,,,,,,,,,,,11024.6,5323.5,-5701.1,,,,316.3,490.4,174.1,600.6,184.8,-415.8,,,,4861.9,3719,-1142.9,,,,1382.1,945.2,-436.9,56.7,36.1,-20.6,,,,9.5,33.3,23.8,30.5,31.7,1.2,,,,69,36.4,-32.6,31,59.7,28.7,,,,40.4,78.6,38.2,,,,26.6,42.9,16.3,,,,,,,26.9,29.5,2.6,89.8,77.2,-12.6,,,,,,,,,,,,,,,,,,,,,,,,,,,,,,,61.5,45.1,-16.4,22.4,46.8,24.4,,,,,,,,,,,,,,,,162,103.1,-58.9,353.6,264,-89.6,,,,,,,,,,96.5,42.4,-54.1,59.3,71.8,12.5,,,,60.8,65.5,4.7,555.4,352.7,-202.7,2,12.5,10.5,18.1,7.4,-10.7,64.4,79.8,15.4,,,,22.4,6.4,-16,382.7,139.7,-243,,,,82.8,77.7,-5.09999999999999,66.2,29,-37.2,,,,159.3,58.3,-101,1361.2,976.7,-384.5,71.5,139.5,68,349,763.3,414.3,282.9,455.5,172.6,,,,,,,,,,732.5,537.6,-194.9,2107.6,975.8,-1131.8,64.1,33.2,-30.9,,,,,,,,,,22.7,22.6,-0.0999999999999979,,,,340.2,223.4,-116.8,,,,,,,,,,21.1,10.4,-10.7,19.6,47,27.4,,,,,,,,,,,,,,,,,,,,,,,,,,,,,,,,,,,,,241,257.3,16.3,41.3,89.2,47.9,,,,,,,,,,,,,796.7,412.9,-383.8,57.1,76.8,19.7,,,,,,,,,,,,,,,,,,,,,,,,,,,,31.1,30.8,-0.300000000000001,,,,,,,105,106.8,1.8,,,,,,,,,,,,,9.6,1.5,-8.1,,,,,,,,,,,,,3.6,30,26.4,,,,255.6,233.1,-22.5,,,,18.4,31.6,13.2,,,,,,,2.8,13.1,10.3,,,,133.7,134.8,1.10000000000002,22.7,36.3,13.6,,,,19.7,4.5,-15.2,30.2,8.6,-21.6,,,,115.8,77.1,-38.7,,,,,,,,,,146.8,112.9,-33.9,366,270.4,-95.6,188.2,66.4,-121.8,,,,,,,133,112,-21,27.8,0.1,-27.7,,,,,,,390.7,259,-131.7,,,,,,,934.6,589.7,-344.9,664.1,240.8,-423.3,1496,613.6,-882.4,5882.8,2304.9,-3577.9,258.2,441.2,183,,,,,,,,,,,,,,,,58.1,49.2,-8.9,,,,,,,,,,,,,,,,,,,,,,,,,,,,,,,,,,,,,,,,,,,,,,,,,,,,,,,,,,152.8,16.9,-135.9,,,,,,,14.2,247.6,233.4,,,,,,,,,,,,,,,,,,,,,,,,,,,,,,,24.7,13.2,-11.5,,,,,,,,,,,,,195.5,51.2,-144.3,,,,30.8,3.4,-27.4,,,,,,,,,,,,,66,10.4,-55.6,11.7,0.9,-10.8,,,,,,,,,,,,,20.9,4.8,-16.1,,,,,,,,,,,,,,,,,,,,,,,,,,,,,,,,,,,,,,,,,,,,,,,,,,,,,,,251,100.9,-150.1,,,,,,,,,,,,,,,,,,,,,,,,,,,
1987-01-01,1344,739,-605,,,,,,,,,,,,,,,,3960,1440.6,-2519.4,1664,1241.4,-422.6,6585.8,5169,-1416.8,,,,,,,,,,30798.5,17345.9,-13452.6,11958,4462.6,-7495.4,,,,314.7,518.7,204,396.1,142,-254.1,,,,5429.9,4152.3,-1277.6,,,,1155.9,1016.7,-139.2,42.8,30.5,-12.3,,,,12.7,26.5,13.8,30.1,34.4,4.3,,,,47.6,38,-9.6,22.1,52.1,30,,,,26.3,67,40.7,,,,22.7,41.3,18.6,,,,,,,23.4,28.8,5.4,56.6,83.7,27.1,,,,,,,,,,,,,,,,,,,,,,,,,,,,,,,56.6,34.7,-21.9,21.2,35,13.8,,,,,,,,,,,,,,,,142.9,82.6,-60.3,366.6,201.7,-164.9,,,,,,,,,,103.6,45.1,-58.5,47.7,53.8,6.09999999999999,,,,65.8,61.4,-4.4,492.9,227.5,-265.4,4.1,13.4,9.3,17.7,5.9,-11.8,60.6,78,17.4,,,,14,4.9,-9.1,303.9,108.3,-195.6,,,,74.5,53.9,-20.6,57.2,34.5,-22.7,,,,134.1,71.8,-62.3,1092.6,819.4,-273.2,57.5,111.3,53.8,263.9,657.8,393.9,238.3,426,187.7,,,,,,,,,,663.6,519.5,-144.1,1793.5,863.2,-930.3,55.2,28.1,-27.1,,,,,,,,,,19.1,6.9,-12.2,,,,265.3,172.3,-93,,,,,,,,,,21,10.5,-10.5,29.7,31.4,1.7,,,,,,,,,,,,,,,,,,,,,,,,,,,,,,,,,,,,,187.4,213.4,26,49.5,39.5,-10,,,,,,,,,,,,,737.8,433.8,-304,49.7,25.6,-24.1,,,,,,,,,,,,,,,,,,,,,,,,,,,,32.5,18.6,-13.9,,,,,,,98.5,76.7,-21.8,,,,,,,,,,,,,10.5,0.4,-10.1,,,,,,,,,,,,,5.1,36.6,31.5,,,,386.4,272.5,-113.9,,,,12.1,30.2,18.1,,,,,,,2.9,31.6,28.7,,,,175,114.5,-60.5,26.4,36.1,9.7,,,,33.3,4.3,-29,33.8,9.4,-24.4,,,,146.5,74.3,-72.2,,,,,,,,,,180.5,115.6,-64.9,384.5,262.8,-121.7,196.8,64.6,-132.2,,,,,,,140.1,98,-42.1,33.2,0.2,-33,,,,,,,520.6,213.3,-307.3,,,,,,,1121.1,522.1,-599,722.4,232.8,-489.6,1732,422.9,-1309.1,5900.5,1785.4,-4115.1,237.4,454.6,217.2,,,,,,,,,,,,,,,,77.3,64.1,-13.2,,,,,,,,,,,,,,,,,,,,,,,,,,,,,,,,,,,,,,,,,,,,,,,,,,,,,,,,,,65.2,27.5,-37.7,,,,,,,7.6,169.3,161.7,,,,,,,,,,,,,,,,,,,,,,,,,,,,,,,44.2,5.5,-38.7,,,,,,,,,,,,,146.2,25.3,-120.9,,,,11.4,6.2,-5.2,,,,,,,,,,,,,23.8,20.4,-3.4,0.3,1.2,0.9,,,,,,,,,,,,,43,3.7,-39.3,,,,,,,,,,,,,,,,,,,,,,,,,,,,,,,,,,,,,,,,,,,,,,,,,,,,,,,127.2,79.7,-47.5,,,,,,,,,,,,,,,,,,,,,,,,,,,
1987-02-01,1799,726,-1073,,,,,,,,,,,,,,,,4196.7,1667.9,-2528.8,2203.7,1351.9,-851.8,7756.6,5793.7,-1962.9,,,,,,,,,,29810.3,18853.9,-10956.4,13461,5039.8,-8421.2,,,,331.7,412.4,80.6999999999999,445.9,141.8,-304.1,,,,5929.3,4762.8,-1166.5,,,,1827.3,1030.9,-796.4,38.2,32.5,-5.7,,,,19.1,35.9,16.8,36.5,28.8,-7.7,,,,55.5,42,-13.5,30.1,62.2,32.1,,,,48.1,64.8,16.7,,,,26.9,46.6,19.7,,,,,,,36.7,34.5,-2.2,96.1,75.1,-21,,,,,,,,,,,,,,,,,,,,,,,,,,,,,,,77.9,25.9,-52,58.5,45.9,-12.6,,,,,,,,,,,,,,,,166.8,100.5,-66.3,518.9,227.7,-291.2,,,,,,,,,,121.9,45.7,-76.2,81.7,68.4,-13.3,,,,119.6,64.1,-55.5,555.1,245.5,-309.6,1.2,17.4,16.2,34.6,6.8,-27.8,80.3,81.6,1.3,,,,12.2,6.5,-5.7,406.7,178.4,-228.3,,,,91.9,78.4,-13.5,83.9,36.8,-47.1,,,,141,66.3,-74.7,1431.1,1149.2,-281.9,71.7,161.1,89.4,302.7,815.1,512.4,301.9,525.4,223.5,,,,,,,,,,845.2,601,-244.2,2088.2,1084.7,-1003.5,70.4,35.5,-34.9,,,,,,,,,,15.6,5.2,-10.4,,,,335.5,264.1,-71.4,,,,,,,,,,21.4,9.6,-11.8,30.8,51.2,20.4,,,,,,,,,,,,,,,,,,,,,,,,,,,,,,,,,,,,,207.3,270.1,62.8,43.7,44.3,0.599999999999994,,,,,,,,,,,,,888.4,483,-405.4,57.6,28.6,-29,,,,,,,,,,,,,,,,,,,,,,,,,,,,38.6,26.6,-12,,,,,,,78.4,81.7,3.3,,,,,,,,,,,,,79.9,2.2,-77.7,,,,,,,,,,,,,6.1,45.9,39.8,,,,325.3,214.9,-110.4,,,,38.5,48.7,10.2,,,,,,,6.3,36,29.7,,,,216.1,143.2,-72.9,32.5,80.7,48.2,,,,39,11.6,-27.4,36.4,8.1,-28.3,,,,169.6,84.3,-85.3,,,,,,,,,,215,123,-92,455.2,288.4,-166.8,292.3,46.9,-245.4,,,,,,,163.8,120.7,-43.1,38.2,0.2,-38,,,,,,,565.3,212.7,-352.6,,,,,,,1185.8,535.8,-650,693.6,364.8,-328.8,1862.1,478.9,-1383.2,6824.5,2034.6,-4789.9,250.3,354.6,104.3,,,,,,,,,,,,,,,,81.4,57.8,-23.6,,,,,,,,,,,,,,,,,,,,,,,,,,,,,,,,,,,,,,,,,,,,,,,,,,,,,,,,,,218.7,26.8,-191.9,,,,,,,7.6,191.5,183.9,,,,,,,,,,,,,,,,,,,,,,,,,,,,,,,56.8,4.2,-52.6,,,,,,,,,,,,,166.9,23.6,-143.3,,,,10.2,6.6,-3.6,,,,,,,,,,,,,63.1,7.4,-55.7,30.8,1.1,-29.7,,,,,,,,,,,,,28.9,6.2,-22.7,,,,,,,,,,,,,,,,,,,,,,,,,,,,,,,,,,,,,,,,,,,,,,,,,,,,,,,89.2,92.7,3.5,,,,,,,,,,,,,,,,,,,,,,,,,,,
1987-03-01,1550,885,-665,,,,,,,,,,,,,,,,4227.6,1995.5,-2232.1,2135.6,1386.6,-749,7698.9,6535.7,-1163.2,,,,,,,,,,32464.3,21835.5,-10628.8,13427.8,5644.3,-7783.5,,,,299.7,496.3,196.6,456,152.6,-303.4,,,,5986,5258.9,-727.1,,,,1712.9,1276.8,-436.1,59.3,42.7,-16.6,,,,35.7,26.9,-8.8,43.5,30.7,-12.8,,,,60.2,48.2,-12,23.4,64.3,40.9,,,,40.8,65.6,24.8,,,,36.7,41.2,4.5,,,,,,,36.5,42.5,6,88.8,86.2,-2.59999999999999,,,,,,,,,,,,,,,,,,,,,,,,,,,,,,,57.3,24.1,-33.2,26.8,37.5,10.7,,,,,,,,,,,,,,,,192.5,131.3,-61.2,425.9,236.2,-189.7,,,,,,,,,,101.6,44.9,-56.7,45.5,40.5,-5,,,,161.4,54,-107.4,596.6,251.9,-344.7,1.1,14.7,13.6,22.5,7.8,-14.7,79.5,95.4,15.9,,,,25.8,6.8,-19,446.3,169.2,-277.1,,,,174.2,68.3,-105.9,95.4,42.7,-52.7,,,,180.4,109.2,-71.2,1505.4,1371.8,-133.6,115.7,180,64.3,360.6,833.1,472.5,342.1,542.2,200.1,,,,,,,,,,850.3,729.3,-121,2582.3,1046.3,-1536,81,39.9,-41.1,,,,,,,,,,21.8,16.1,-5.7,,,,365.6,321,-44.6,,,,,,,,,,24.4,32.6,8.2,26.5,67.9,41.4,,,,,,,,,,,,,,,,,,,,,,,,,,,,,,,,,,,,,242.5,236.3,-6.19999999999999,49.6,52.5,2.9,,,,,,,,,,,,,956.9,501.8,-455.1,74.9,44.7,-30.2,,,,,,,,,,,,,,,,,,,,,,,,,,,,39.8,34.3,-5.5,,,,,,,105.7,116.2,10.5,,,,,,,,,,,,,53.2,5.1,-48.1,,,,,,,,,,,,,13.1,43.9,30.8,,,,281.6,318.9,37.3,,,,3.7,45.9,42.2,,,,,,,3.2,10.6,7.4,,,,229.9,107.7,-122.2,31.1,60.2,29.1,,,,37.4,7.7,-29.7,36.4,9.6,-26.8,,,,171.9,108.2,-63.7,,,,,,,,,,251.8,134.3,-117.5,502.2,407.6,-94.6,352.3,56.9,-295.4,,,,,,,175.7,129.7,-46,31.5,0.4,-31.1,,,,,,,482.5,207.6,-274.9,,,,,,,1179.9,688,-491.9,660.4,310.6,-349.8,1885.1,589.3,-1295.8,6804.2,2138.6,-4665.6,212.9,437,224.1,,,,,,,,,,,,,,,,86.8,59.3,-27.5,,,,,,,,,,,,,,,,,,,,,,,,,,,,,,,,,,,,,,,,,,,,,,,,,,,,,,,,,,161.8,39.8,-122,,,,,,,9,217.4,208.4,,,,,,,,,,,,,,,,,,,,,,,,,,,,,,,29.9,7.3,-22.6,,,,,,,,,,,,,128.4,26.1,-102.3,,,,8.8,5.8,-3,,,,,,,,,,,,,131.3,6.4,-124.9,0.2,0.4,0.2,,,,,,,,,,,,,41.9,9.9,-32,,,,,,,,,,,,,,,,,,,,,,,,,,,,,,,,,,,,,,,,,,,,,,,,,,,,,,,115.5,96.7,-18.8,,,,,,,,,,,,,,,,,,,,,,,,,,,
1987-04-01,1518,841,-677,,,,,,,,,,,,,,,,4394.1,1837.3,-2556.8,1992.5,1394.1,-598.4,7416,6049.2,-1366.8,,,,,,,,,,32291.1,20677.7,-11613.4,13352.8,5885.3,-7467.5,,,,311.8,497.5,185.7,554.5,160.9,-393.6,,,,5814.4,4928.3,-886.099999999999,,,,1601.6,1120.9,-480.7,53.4,35.3,-18.1,,,,29.3,35.2,5.9,42.6,39.3,-3.3,,,,54.3,46.7,-7.59999999999999,27.1,66.4,39.3,,,,27.8,65.7,37.9,,,,30.2,48.2,18,,,,,,,31.8,38.9,7.1,81.9,94.9,13,,,,,,,,,,,,,,,,,,,,,,,,,,,,,,,76.1,28,-48.1,30.6,43.6,13,,,,,,,,,,,,,,,,195.6,108.4,-87.2,390.6,215.4,-175.2,,,,,,,,,,84.9,49,-35.9,54.3,54.7,0.400000000000006,,,,100.6,63.9,-36.7,573.1,264.6,-308.5,1.3,10.9,9.6,29.5,6.5,-23,77.5,78.5,1,,,,24.4,7.3,-17.1,465.3,167.5,-297.8,,,,93.8,67.5,-26.3,75.4,42.4,-33,,,,139.3,84.9,-54.4,1345.8,1389.2,43.4000000000001,77.5,150,72.5,360.3,669.4,309.1,320.2,466.8,146.6,,,,,,,,,,839.6,633.5,-206.1,2341.2,913.7,-1427.5,80.5,32.7,-47.8,,,,,,,,,,23.4,5.1,-18.3,,,,350.4,256.8,-93.6,,,,,,,,,,20.1,20.7,0.599999999999998,29.3,168.7,139.4,,,,,,,,,,,,,,,,,,,,,,,,,,,,,,,,,,,,,213.1,302.4,89.3,50.5,43.8,-6.7,,,,,,,,,,,,,868.1,458.6,-409.5,66.2,65.3,-0.900000000000006,,,,,,,,,,,,,,,,,,,,,,,,,,,,39,29.4,-9.6,,,,,,,53.5,135.9,82.4,,,,,,,,,,,,,76.8,2.8,-74,,,,,,,,,,,,,6.6,52.1,45.5,,,,216.9,282.2,65.3,,,,20.3,47.3,27,,,,,,,3.1,51.8,48.7,,,,221.6,120.8,-100.8,32.8,55.7,22.9,,,,30.3,4.3,-26,34,5.9,-28.1,,,,175.8,86.1,-89.7,,,,,,,,,,240.4,147.2,-93.2,454.5,316,-138.5,217.3,59.9,-157.4,,,,,,,168.3,144,-24.3,36,0.3,-35.7,,,,,,,468.3,439.6,-28.7,,,,,,,1293.3,717.7,-575.6,675.6,291.7,-383.9,1970.7,511.9,-1458.8,6832.3,2170.6,-4661.7,221,435.4,214.4,,,,,,,,,,,,,,,,90.8,62.1,-28.7,,,,,,,,,,,,,,,,,,,,,,,,,,,,,,,,,,,,,,,,,,,,,,,,,,,,,,,,,,169,37.7,-131.3,,,,,,,24.1,196.2,172.1,,,,,,,,,,,,,,,,,,,,,,,,,,,,,,,30,7.9,-22.1,,,,,,,,,,,,,273,33.4,-239.6,,,,40.8,1,-39.8,,,,,,,,,,,,,92.1,8.3,-83.8,15.3,0.5,-14.8,,,,,,,,,,,,,15.2,3.9,-11.3,,,,,,,,,,,,,,,,,,,,,,,,,,,,,,,,,,,,,,,,,,,,,,,,,,,,,,,88.1,105.9,17.8,,,,,,,,,,,,,,,,,,,,,,,,,,,
1987-05-01,1827,948,-879,,,,,,,,,,,,,,,,4731.4,1906.7,-2824.7,2112.9,1573.5,-539.4,7680.1,6247.6,-1432.5,,,,,,,,,,33170,20759.5,-12410.5,14088.5,5450.4,-8638.1,,,,366.6,588.2,221.6,553.9,159,-394.9,,,,5916,5055.1,-860.9,,,,1764.1,1192.5,-571.6,32.9,40.6,7.7,,,,23.8,26.1,2.3,48,36.8,-11.2,,,,46.5,45,-1.5,35.9,69.5,33.6,,,,33.7,52.6,18.9,,,,29.9,49.7,19.8,,,,,,,33.7,48.8,15.1,113.4,95.2,-18.2,,,,,,,,,,,,,,,,,,,,,,,,,,,,,,,73,25.6,-47.4,46.9,31,-15.9,,,,,,,,,,,,,,,,166.5,108.5,-58,491.2,341.6,-149.6,,,,,,,,,,79.4,63.4,-16,74.7,66.4,-8.3,,,,76.3,64.6,-11.7,581.4,279.7,-301.7,2.5,12.5,10,26.6,8,-18.6,96.6,107.9,11.3,,,,19,8.8,-10.2,407.4,147.8,-259.6,,,,146.4,77,-69.4,88.4,34.8,-53.6,,,,144,74.2,-69.8,1533,1141.9,-391.1,80.6,164.8,84.2,310.2,685.6,375.4,307.3,512.8,205.5,,,,,,,,,,843.5,645.4,-198.1,2353.1,957.2,-1395.9,77.3,40.3,-37,,,,,,,,,,21.6,5.4,-16.2,,,,359.1,267.6,-91.5,,,,,,,,,,23.3,20.6,-2.7,20.5,196.6,176.1,,,,,,,,,,,,,,,,,,,,,,,,,,,,,,,,,,,,,233.2,280.1,46.9,51.5,38.3,-13.2,,,,,,,,,,,,,858.3,479.9,-378.4,61.9,36.7,-25.2,,,,,,,,,,,,,,,,,,,,,,,,,,,,23.9,34.7,10.8,,,,,,,58.4,89,30.6,,,,,,,,,,,,,178.6,2.4,-176.2,,,,,,,,,,,,,14,39.7,25.7,,,,282.5,226.7,-55.8,,,,21.5,47.7,26.2,,,,,,,4.4,7.7,3.3,,,,206.4,93.5,-112.9,34.9,51,16.1,,,,27,4.2,-22.8,25.2,2.4,-22.8,,,,164.1,98.5,-65.6,,,,,,,,,,242.1,157.7,-84.4,495.2,346.2,-149,311.6,69,-242.6,,,,,,,154.4,134.9,-19.5,47.7,0.8,-46.9,,,,,,,514.7,228.7,-286,,,,,,,1454.5,673.8,-780.7,734.5,312.5,-422,2047.2,574.2,-1473,6933.8,2151.5,-4782.3,275.3,519.7,244.4,,,,,,,,,,,,,,,,91.3,68.5,-22.8,,,,,,,,,,,,,,,,,,,,,,,,,,,,,,,,,,,,,,,,,,,,,,,,,,,,,,,,,,122.7,24.1,-98.6,,,,,,,27.5,332.4,304.9,,,,,,,,,,,,,,,,,,,,,,,,,,,,,,,16.6,3.7,-12.9,,,,,,,,,,,,,295.3,21,-274.3,,,,10.4,5.4,-5,,,,,,,,,,,,,75.9,7.7,-68.2,26.2,0.4,-25.8,,,,,,,,,,,,,22.5,11.9,-10.6,,,,,,,,,,,,,,,,,,,,,,,,,,,,,,,,,,,,,,,,,,,,,,,,,,,,,,,107,108.9,1.90000000000001,,,,,,,,,,,,,,,,,,,,,,,,,,,
1987-06-01,2044,860,-1184,,,,,,,,,,,,,,,,5181,1809.2,-3371.8,2269.4,1553,-716.4,7939.1,6849.3,-1089.8,,,,,,,,,,35358,21636.7,-13721.3,15081.6,5589,-9492.6,,,,387.5,536.2,148.7,692,161.8,-530.2,,,,6100.8,5605.7,-495.1,,,,1838.3,1243.6,-594.7,44.5,47.8,3.3,,,,29.8,31.8,2,57.6,30.7,-26.9,,,,56.3,45.6,-10.7,33.8,70.4,36.6,,,,27.5,58.8,31.3,,,,37.8,54.7,16.9,,,,,,,32.9,39.8,6.9,112.9,98.2,-14.7,,,,,,,,,,,,,,,,,,,,,,,,,,,,,,,80.7,21.7,-59,43.7,39.6,-4.1,,,,,,,,,,,,,,,,211.2,110.2,-101,490.8,295.1,-195.7,,,,,,,,,,75.1,64.5,-10.6,70,64.3,-5.7,,,,59.3,79,19.7,689.6,288.3,-401.3,1.2,14.9,13.7,25.8,11.7,-14.1,88.9,85.9,-3,,,,23.9,8.1,-15.8,442.4,133.8,-308.6,,,,162.6,59.8,-102.8,81.8,37.2,-44.6,,,,144,87.1,-56.9,1386.7,1153,-233.7,95.6,135.2,39.6,310.8,566.9,256.1,340.5,488.8,148.3,,,,,,,,,,942.6,682.5,-260.1,2331.7,894.8,-1436.9,81.8,45.7,-36.1,,,,,,,,,,25.5,5.3,-20.2,,,,355.7,286.1,-69.6,,,,,,,,,,28.5,10.6,-17.9,43,135.5,92.5,,,,,,,,,,,,,,,,,,,,,,,,,,,,,,,,,,,,,253.7,211.3,-42.4,58.8,47.4,-11.4,,,,,,,,,,,,,950,517.4,-432.6,76.7,48.6,-28.1,,,,,,,,,,,,,,,,,,,,,,,,,,,,38.8,33.6,-5.2,,,,,,,53.7,149.6,95.9,,,,,,,,,,,,,142.2,2.4,-139.8,,,,,,,,,,,,,24.6,34.4,9.8,,,,381,212.3,-168.7,,,,41.6,72,30.4,,,,,,,5.2,7.8,2.6,,,,200,125.6,-74.4,33.8,61.8,28,,,,23.3,23.4,0.0999999999999979,39.1,7.5,-31.6,,,,211.1,98.9,-112.2,,,,,,,,,,224.2,154.5,-69.7,510.2,306.7,-203.5,245.3,45.2,-200.1,,,,,,,179.7,129.4,-50.3,57.5,0.4,-57.1,,,,,,,536.3,261.8,-274.5,,,,,,,1598.2,676.2,-922,877.8,304.3,-573.5,2194.8,522,-1672.8,7332.6,2293,-5039.6,261.2,466.2,205,,,,,,,,,,,,,,,,126.3,70,-56.3,,,,,,,,,,,,,,,,,,,,,,,,,,,,,,,,,,,,,,,,,,,,,,,,,,,,,,,,,,159.5,46.7,-112.8,,,,,,,63.5,217.1,153.6,,,,,,,,,,,,,,,,,,,,,,,,,,,,,,,17,4.5,-12.5,,,,,,,,,,,,,329.9,23.7,-306.2,,,,56.5,12.9,-43.6,,,,,,,,,,,,,100.5,5.2,-95.3,57.9,0.7,-57.2,,,,,,,,,,,,,26.9,11.7,-15.2,,,,,,,,,,,,,,,,,,,,,,,,,,,,,,,,,,,,,,,,,,,,,,,,,,,,,,,103.3,103.1,-0.200000000000003,,,,,,,,,,,,,,,,,,,,,,,,,,,
1987-07-01,2533,966,-1567,,,,,,,,,,,,,,,,5505.9,1970,-3535.9,2260.3,1990,-270.3,6975.2,5940.5,-1034.7,,,,,,,,,,35809.9,21379,-14430.9,15947.3,6113.9,-9833.4,,,,368.9,539.6,170.7,875.4,134.6,-740.8,,,,5321.9,4715,-606.9,,,,1653.3,1225.5,-427.8,36.6,40.5,3.9,,,,30.1,39.3,9.2,44.8,36.8,-8,,,,52.7,55.4,2.7,45.7,65.2,19.5,,,,32.7,69.7,37,,,,33.2,57.3,24.1,,,,,,,28.5,32.2,3.7,107.5,100,-7.5,,,,,,,,,,,,,,,,,,,,,,,,,,,,,,,59.3,57.7,-1.59999999999999,61.4,40.6,-20.8,,,,,,,,,,,,,,,,196,125.1,-70.9,524.4,344.5,-179.9,,,,,,,,,,65,55.1,-9.9,63.1,67.2,4.1,,,,58.4,70.6,12.2,658,618.5,-39.5,1.5,12.6,11.1,60.2,8.8,-51.4,101.2,92.9,-8.3,,,,29.1,7.9,-21.2,401.9,123.2,-278.7,,,,124,63.1,-60.9,73.1,39.9,-33.2,,,,146.9,59.5,-87.4,1564.5,1044.2,-520.3,101.2,111.2,10,366.8,591.2,224.4,391.3,511.2,119.9,,,,,,,,,,1067.4,583.9,-483.5,2244.9,839.3,-1405.6,82.5,47.4,-35.1,,,,,,,,,,31.5,12.9,-18.6,,,,355.5,229.7,-125.8,,,,,,,,,,32,24.5,-7.5,40.3,200.8,160.5,,,,,,,,,,,,,,,,,,,,,,,,,,,,,,,,,,,,,282.9,187.3,-95.6,64.3,44.4,-19.9,,,,,,,,,,,,,1111.1,369.7,-741.4,75.8,47.3,-28.5,,,,,,,,,,,,,,,,,,,,,,,,,,,,32.5,35.5,3,,,,,,,69.8,115.8,46,,,,,,,,,,,,,353.6,3.1,-350.5,,,,,,,,,,,,,39.8,41.7,1.90000000000001,,,,380.3,253.9,-126.4,,,,21.7,62.7,41,,,,,,,9.3,9.1,-0.200000000000001,,,,221.1,110.7,-110.4,29.7,64.7,35,,,,27.8,27.9,0.0999999999999979,37.5,3.3,-34.2,,,,203.9,123.7,-80.2,,,,,,,,,,267.1,152.2,-114.9,510.8,343.2,-167.6,393.8,75.5,-318.3,,,,,,,230.5,134.8,-95.7,54.7,0.1,-54.6,,,,,,,560,227.4,-332.6,,,,,,,1752.7,713.8,-1038.9,985.5,323.3,-662.2,2256.9,589.7,-1667.2,7340.5,2561.3,-4779.2,264.4,467,202.6,,,,,,,,,,,,,,,,104.5,72.6,-31.9,,,,,,,,,,,,,,,,,,,,,,,,,,,,,,,,,,,,,,,,,,,,,,,,,,,,,,,,,,228.1,37.9,-190.2,,,,,,,84.6,266.7,182.1,,,,,,,,,,,,,,,,,,,,,,,,,,,,,,,15.4,6.6,-8.8,,,,,,,,,,,,,447.8,17.5,-430.3,,,,52.4,1.9,-50.5,,,,,,,,,,,,,155.8,8.7,-147.1,56.3,0.3,-56,,,,,,,,,,,,,26.4,10.3,-16.1,,,,,,,,,,,,,,,,,,,,,,,,,,,,,,,,,,,,,,,,,,,,,,,,,,,,,,,121.3,89.3,-32,,,,,,,,,,,,,,,,,,,,,,,,,,,
1987-08-01,2583,960,-1623,,,,,,,,,,,,,,,,5389.2,2067,-3322.2,2455,1592.4,-862.6,6699.9,5358.6,-1341.3,,,,,,,,,,33826.2,20079.1,-13747.1,15653.7,6361.5,-9292.2,,,,398.9,608.4,209.5,901.6,168.4,-733.2,,,,5069,4165.8,-903.2,,,,1630.9,1192.8,-438.1,29.4,42.5,13.1,,,,20.8,37.8,17,38.4,37.5,-0.899999999999999,,,,57.5,57.4,-0.100000000000001,28.6,55.8,27.2,,,,52.7,60.7,8,,,,41,48.3,7.3,,,,,,,35.7,38,2.3,94.5,81,-13.5,,,,,,,,,,,,,,,,,,,,,,,,,,,,,,,71,23.9,-47.1,50,30.2,-19.8,,,,,,,,,,,,,,,,211.9,128.1,-83.8,575.2,333.2,-242,,,,,,,,,,81.6,50.6,-31,65.4,64.2,-1.2,,,,84.2,75.2,-9,777,306.2,-470.8,1.4,14.8,13.4,38.6,6.8,-31.8,100.1,100.2,0.100000000000009,,,,44.7,7.7,-37,244.2,152.8,-91.4,,,,98,69.2,-28.8,78.4,38.4,-40,,,,114,59.7,-54.3,1352.6,1123.4,-229.2,71.2,153.5,82.3,299.6,620.7,321.1,309,495.1,186.1,,,,,,,,,,871.9,610.6,-261.3,2109.7,886.9,-1222.8,75.1,42.3,-32.8,,,,,,,,,,21.9,5,-16.9,,,,311,207.8,-103.2,,,,,,,,,,27.6,10.4,-17.2,36.4,144,107.6,,,,,,,,,,,,,,,,,,,,,,,,,,,,,,,,,,,,,261.1,247.2,-13.9,61,57.8,-3.2,,,,,,,,,,,,,1000.4,387.4,-613,64.9,24.6,-40.3,,,,,,,,,,,,,,,,,,,,,,,,,,,,40.4,32.5,-7.9,,,,,,,42.9,111.4,68.5,,,,,,,,,,,,,209.9,1.5,-208.4,,,,,,,,,,,,,112.2,35.3,-76.9,,,,489.3,281.2,-208.1,,,,66.7,54.8,-11.9,,,,,,,4.6,6.1,1.5,,,,228.7,119.7,-109,33.7,70.9,37.2,,,,33.5,16.7,-16.8,34.7,4.6,-30.1,,,,186.4,107.1,-79.3,,,,,,,,,,249.4,171.2,-78.2,556.5,335.7,-220.8,311.5,57,-254.5,,,,,,,213.8,150.4,-63.4,54,0.5,-53.5,,,,,,,598.1,278.2,-319.9,,,,,,,1582.3,773.2,-809.1,987.4,331.1,-656.3,2263,627,-1636,7242.4,2657.9,-4584.5,299,515.6,216.6,,,,,,,,,,,,,,,,99.9,92.8,-7.10000000000001,,,,,,,,,,,,,,,,,,,,,,,,,,,,,,,,,,,,,,,,,,,,,,,,,,,,,,,,,,170.1,35.5,-134.6,,,,,,,64,126.1,62.1,,,,,,,,,,,,,,,,,,,,,,,,,,,,,,,20,4.5,-15.5,,,,,,,,,,,,,426.7,27.3,-399.4,,,,63.7,2.4,-61.3,,,,,,,,,,,,,182.4,5.3,-177.1,54,0.6,-53.4,,,,,,,,,,,,,19.9,6.5,-13.4,,,,,,,,,,,,,,,,,,,,,,,,,,,,,,,,,,,,,,,,,,,,,,,,,,,,,,,134.9,121.8,-13.1,,,,,,,,,,,,,,,,,,,,,,,,,,,
1987-09-01,2264,880,-1384,,,,,,,,,,,,,,,,5122.6,1895.3,-3227.3,2133.5,1684.7,-448.8,7819.1,6172.4,-1646.7,,,,,,,,,,33667.5,21183.7,-12483.8,14801.4,5989.6,-8811.8,,,,378.9,503,124.1,649.1,155.1,-494,,,,6094.7,4844.7,-1250,,,,1724.4,1327.7,-396.7,29.7,39.5,9.8,,,,22.2,39.9,17.7,36.9,36,-0.899999999999999,,,,51.2,52.6,1.4,26.4,58,31.6,,,,34.8,75.8,41,,,,34.7,49.5,14.8,,,,,,,36.6,41.6,5,104.8,102.8,-2,,,,,,,,,,,,,,,,,,,,,,,,,,,,,,,68.7,24.2,-44.5,53.3,35.2,-18.1,,,,,,,,,,,,,,,,169.3,128.5,-40.8,428.8,318.5,-110.3,,,,,,,,,,135.9,46.5,-89.4,56.6,69.4,12.8,,,,44.6,57.5,12.9,682.8,398.3,-284.5,1.5,10.1,8.6,27.6,6.2,-21.4,87.1,94.6,7.5,,,,19.2,5.1,-14.1,321.1,208.4,-112.7,,,,82.3,69.8,-12.5,78.6,46.1,-32.5,,,,152.4,65.1,-87.3,1441,1171.6,-269.4,117.5,177.6,60.1,302.7,613.6,310.9,414.3,582.4,168.1,,,,,,,,,,792.9,649.2,-143.7,1889.8,977.2,-912.6,78.1,47.9,-30.2,,,,,,,,,,24.2,4.3,-19.9,,,,340.2,248.1,-92.1,,,,,,,,,,21.1,10.6,-10.5,36.2,64.2,28,,,,,,,,,,,,,,,,,,,,,,,,,,,,,,,,,,,,,209.8,269.8,60,50.1,30.3,-19.8,,,,,,,,,,,,,723.6,423.6,-300,61.2,44.4,-16.8,,,,,,,,,,,,,,,,,,,,,,,,,,,,29.6,39.8,10.2,,,,,,,62.9,114.7,51.8,,,,,,,,,,,,,233.8,6.5,-227.3,,,,,,,,,,,,,101.7,32,-69.7,,,,417.7,277.2,-140.5,,,,85.5,36.6,-48.9,,,,,,,5.6,12.6,7,,,,212.9,126,-86.9,28.6,56.3,27.7,,,,28.1,24.4,-3.7,30.1,10.7,-19.4,,,,188.2,96.3,-91.9,,,,,,,,,,254.7,185.8,-68.9,595.2,311.7,-283.5,269.5,64.9,-204.6,,,,,,,206.2,140.1,-66.1,52,0.2,-51.8,,,,,,,549.6,304.1,-245.5,,,,,,,1384.6,651.3,-733.3,945.9,373.7,-572.2,2196.9,558.6,-1638.3,6780.9,2424.3,-4356.6,292.5,432.8,140.3,,,,,,,,,,,,,,,,86.4,70.2,-16.2,,,,,,,,,,,,,,,,,,,,,,,,,,,,,,,,,,,,,,,,,,,,,,,,,,,,,,,,,,186.4,21.9,-164.5,,,,,,,47.1,83.6,36.5,,,,,,,,,,,,,,,,,,,,,,,,,,,,,,,11.2,4.4,-6.8,,,,,,,,,,,,,344.9,19.5,-325.4,,,,24.7,3.6,-21.1,,,,,,,,,,,,,126,5.2,-120.8,31.7,1.3,-30.4,,,,,,,,,,,,,22.8,9.7,-13.1,,,,,,,,,,,,,,,,,,,,,,,,,,,,,,,,,,,,,,,,,,,,,,,,,,,,,,,87.8,111.4,23.6,,,,,,,,,,,,,,,,,,,,,,,,,,,
1987-10-01,2547,1014,-1533,,,,,,,,,,,,,,,,5326,1877.2,-3448.8,2577.2,1695.9,-881.3,8444.4,6531.3,-1913.1,,,,,,,,,,38075.6,22777.8,-15297.8,16392.4,6124.8,-10267.6,,,,315,515.6,200.6,651.6,151.7,-499.9,,,,6573,5273.1,-1299.9,,,,1871.4,1258.2,-613.2,38.9,44,5.1,,,,30,30,0,39,30.3,-8.7,,,,73.8,47.8,-26,24.1,58.4,34.3,,,,33,57.8,24.8,,,,33.1,49.9,16.8,,,,,,,37.3,40.8,3.5,109.9,103.5,-6.40000000000001,,,,,,,,,,,,,,,,,,,,,,,,,,,,,,,76.7,25.4,-51.3,42.6,51.7,9.1,,,,,,,,,,,,,,,,230.9,131.6,-99.3,532,317.3,-214.7,,,,,,,,,,176.2,51.6,-124.6,85.9,81.3,-4.60000000000001,,,,74,63.4,-10.6,821.4,387.7,-433.7,1.7,18,16.3,21.3,7.7,-13.6,95.4,97.7,2.3,,,,21.2,5.3,-15.9,435.6,167.3,-268.3,,,,120.9,75.4,-45.5,108.2,40.7,-67.5,,,,171.6,59.8,-111.8,1551.1,1213.5,-337.6,109.7,159.5,49.8,343.4,700.6,357.2,418.7,560.2,141.5,,,,,,,,,,1036.3,728.1,-308.2,2306.7,1064.7,-1242,79.7,47.1,-32.6,,,,,,,,,,26.9,7.6,-19.3,,,,430.3,230.8,-199.5,,,,,,,,,,26.8,23.4,-3.4,34.6,54.3,19.7,,,,,,,,,,,,,,,,,,,,,,,,,,,,,,,,,,,,,240.3,294.7,54.4,56.6,51.6,-5,,,,,,,,,,,,,1019.5,441.4,-578.1,76.7,35.8,-40.9,,,,,,,,,,,,,,,,,,,,,,,,,,,,49.4,39.5,-9.9,,,,,,,60.5,103.1,42.6,,,,,,,,,,,,,216.1,8.9,-207.2,,,,,,,,,,,,,52.7,44.4,-8.3,,,,570.5,409.3,-161.2,,,,127.9,40.5,-87.4,,,,,,,5.1,11,5.9,,,,226.3,110.3,-116,40,57,17,,,,33.1,34.6,1.5,41.6,4.8,-36.8,,,,214.7,108.2,-106.5,,,,,,,,,,276.8,193.9,-82.9,584.4,353.3,-231.1,270,72.7,-197.3,,,,,,,220.9,128.1,-92.8,45.3,0.5,-44.8,,,,,,,567.9,376.9,-191,,,,,,,1540,612.6,-927.4,994.7,334.1,-660.6,2206.9,577.2,-1629.7,7932,2392.4,-5539.6,242.7,446.7,204,,,,,,,,,,,,,,,,72.3,68.9,-3.39999999999999,,,,,,,,,,,,,,,,,,,,,,,,,,,,,,,,,,,,,,,,,,,,,,,,,,,,,,,,,,156.8,16.4,-140.4,,,,,,,32.4,129.6,97.2,,,,,,,,,,,,,,,,,,,,,,,,,,,,,,,20.4,4.6,-15.8,,,,,,,,,,,,,323.8,19.7,-304.1,,,,36.3,1.6,-34.7,,,,,,,,,,,,,90.7,5.9,-84.8,45.8,0.9,-44.9,,,,,,,,,,,,,21.5,9.3,-12.2,,,,,,,,,,,,,,,,,,,,,,,,,,,,,,,,,,,,,,,,,,,,,,,,,,,,,,,113.1,109.7,-3.39999999999999,,,,,,,,,,,,,,,,,,,,,,,,,,,
1987-11-01,2060,1092,-968,,,,,,,,,,,,,,,,4732.9,2383,-2349.9,2203.8,1784.9,-418.9,8506.4,6926.4,-1580,,,,,,,,,,35210.9,23278.7,-11932.2,14500.4,6976.6,-7523.8,,,,282.2,574.8,292.6,751.9,185,-566.9,,,,6723.1,5511.8,-1211.3,,,,1783.3,1414.6,-368.7,46.4,45.5,-0.899999999999999,,,,13.2,33.5,20.3,34.2,34.2,0,,,,52.6,55.7,3.1,30,58.3,28.3,,,,31.5,67.5,36,,,,29.3,60,30.7,,,,,,,30.4,42.5,12.1,97.3,115.7,18.4,,,,,,,,,,,,,,,,,,,,,,,,,,,,,,,51,34.3,-16.7,52.4,53.9,1.5,,,,,,,,,,,,,,,,184.7,121.7,-63,426.4,342.9,-83.5,,,,,,,,,,134.5,45.9,-88.6,61.3,82.6,21.3,,,,57.2,59.8,2.59999999999999,722,400.3,-321.7,2.9,25.5,22.6,24.9,8.2,-16.7,121.6,96.9,-24.7,,,,28.2,8.1,-20.1,412.3,159,-253.3,,,,114.6,79.5,-35.1,94,62.5,-31.5,,,,162.8,76.2,-86.6,1479.9,1266.1,-213.8,106,171,65,372.5,711.1,338.6,386.3,523.5,137.2,,,,,,,,,,969,735.8,-233.2,2482.1,1091.2,-1390.9,82.4,73.3,-9.10000000000001,,,,,,,,,,19.7,12.3,-7.4,,,,375.3,268.4,-106.9,,,,,,,,,,24.6,23.7,-0.900000000000002,51.7,104.8,53.1,,,,,,,,,,,,,,,,,,,,,,,,,,,,,,,,,,,,,253.2,379.7,126.5,50.1,87.1,37,,,,,,,,,,,,,964.5,491.8,-472.7,60.2,28.8,-31.4,,,,,,,,,,,,,,,,,,,,,,,,,,,,51.3,38.4,-12.9,,,,,,,60.9,229.9,169,,,,,,,,,,,,,91.6,3,-88.6,,,,,,,,,,,,,90.4,54.7,-35.7,,,,346.2,339.8,-6.39999999999998,,,,96.2,66.4,-29.8,,,,,,,4.3,9.9,5.6,,,,202.9,126,-76.9,40.1,62.3,22.2,,,,29.4,26.7,-2.7,31.6,6.5,-25.1,,,,197.9,176.8,-21.1,,,,,,,,,,243.8,200.8,-43,556.7,374.6,-182.1,254.4,79.4,-175,,,,,,,220.5,138.4,-82.1,30.1,0.8,-29.3,,,,,,,489.8,350.5,-139.3,,,,,,,1360.9,678.6,-682.3,844.5,433,-411.5,1970.8,896.8,-1074,7179,2637.7,-4541.3,228,505.2,277.2,,,,,,,,,,,,,,,,54.2,69.6,15.4,,,,,,,,,,,,,,,,,,,,,,,,,,,,,,,,,,,,,,,,,,,,,,,,,,,,,,,,,,195.7,56.2,-139.5,,,,,,,42,163,121,,,,,,,,,,,,,,,,,,,,,,,,,,,,,,,39.7,3.1,-36.6,,,,,,,,,,,,,348.2,27.8,-320.4,,,,23,2.7,-20.3,,,,,,,,,,,,,125.3,6.6,-118.7,62.8,1.2,-61.6,,,,,,,,,,,,,25.4,13.6,-11.8,,,,,,,,,,,,,,,,,,,,,,,,,,,,,,,,,,,,,,,,,,,,,,,,,,,,,,,127.5,130,2.5,,,,,,,,,,,,,,,,,,,,,,,,,,,
1987-12-01,1883,1146,-737,,,,,,,,,,,,,,,,4896,2697.6,-2198.4,2126.1,1850.2,-275.9,7834.2,6822.9,-1011.3,,,,,,,,,,35758.7,24314.4,-11444.3,14883.5,7821.1,-7062.4,,,,295.4,522.6,227.2,753.8,205.4,-548.4,,,,6126.8,5540.8,-586,,,,1707.4,1282.1,-425.3,43.1,38.9,-4.2,,,,17,27,10,37.4,42.2,4.8,,,,61.4,47.4,-14,28.4,61.8,33.4,,,,27,75.9,48.9,,,,39.5,54.8,15.3,,,,,,,31.2,30.5,-0.699999999999999,99.1,106,6.90000000000001,,,,,,,,,,,,,,,,,,,,,,,,,,,,,,,66.7,35.7,-31,32.9,63,30.1,,,,,,,,,,,,,,,,164.1,135,-29.1,408.1,411.9,3.79999999999995,,,,,,,,,,106,58.4,-47.6,62.3,101.3,39,,,,79.5,82.7,3.2,715.5,371.4,-344.1,1.5,18.4,16.9,14.5,7.1,-7.4,90.9,80.8,-10.1,,,,24.2,7.2,-17,471.3,177.8,-293.5,,,,121,79.7,-41.3,85.1,58.4,-26.7,,,,147.9,78.9,-69,1657.5,1270.5,-387,107.5,135.3,27.8,370,751.7,381.7,397.9,555,157.1,,,,,,,,,,1008,824.5,-183.5,2546.2,1128.5,-1417.7,85,68.5,-16.5,,,,,,,,,,27.7,9.1,-18.6,,,,405.6,398,-7.60000000000002,,,,,,,,,,25.3,41.6,16.3,45.7,260.3,214.6,,,,,,,,,,,,,,,,,,,,,,,,,,,,,,,,,,,,,254.1,256.1,2.00000000000003,78.6,44.4,-34.2,,,,,,,,,,,,,960.9,541.4,-419.5,71.4,30.8,-40.6,,,,,,,,,,,,,,,,,,,,,,,,,,,,64.3,38.9,-25.4,,,,,,,76,158.4,82.4,,,,,,,,,,,,,21.3,15.7,-5.6,,,,,,,,,,,,,55.2,43.8,-11.4,,,,355.3,284.7,-70.6,,,,128.6,66.2,-62.4,,,,,,,8.4,10.5,2.1,,,,187.5,165.6,-21.9,40.9,76.5,35.6,,,,27.6,7.3,-20.3,36.7,4.4,-32.3,,,,190.1,381.7,191.6,,,,,,,,,,275.2,160.4,-114.8,595.6,406.5,-189.1,279,75.3,-203.7,,,,,,,189.9,150.7,-39.2,29.7,1,-28.7,,,,,,,440.5,396.5,-44,,,,,,,1533.5,855.6,-677.9,731.6,371.2,-360.4,2035.3,1064.3,-971,7472.2,3001.3,-4470.9,220.8,460,239.2,,,,,,,,,,,,,,,,74.6,62.6,-12,,,,,,,,,,,,,,,,,,,,,,,,,,,,,,,,,,,,,,,,,,,,,,,,,,,,,,,,,,164.8,55.9,-108.9,,,,,,,55.5,117.6,62.1,,,,,,,,,,,,,,,,,,,,,,,,,,,,,,,71.7,26,-45.7,,,,,,,,,,,,,342.4,30.3,-312.1,,,,19.7,2.3,-17.4,,,,,,,,,,,,,126.8,7.3,-119.5,49.1,0.7,-48.4,,,,,,,,,,,,,13.6,6.9,-6.7,,,,,,,,,,,,,,,,,,,,,,,,,,,,,,,,,,,,,,,,,,,,,,,,,,,,,,,130.5,131.9,1.40000000000001,,,,,,,,,,,,,,,,,,,,,,,,,,,
1988-01-01,1869,1101.7,-767.3,,,,,,,,,,,,,,,,4977.5,2361.2,-2616.3,2208.1,1612.7,-595.4,7715.8,6597.4,-1118.4,,,,,,,,,,33035.4,23161.6,-9873.8,14174.6,6791.1,-7383.5,,,,452.7,469.6,16.9,595.1,158.3,-436.8,,,,5973.5,5311.4,-662.1,,,,1742.3,1286,-456.3,34.6,38.6,4,,,,18.7,26.7,8,34.6,27.4,-7.2,,,,46.1,48.2,2.1,30.7,61.4,30.7,,,,46.7,72.1,25.4,,,,28,52,24,,,,,,,25.8,29.5,3.7,64,115,51,,,,,,,,,,,,,,,,,,,,,,,,,,,,,,,64.5,18.8,-45.7,45.4,24.4,-21,,,,,,,,,,,,,,,,159.7,114.7,-45,406.9,332.6,-74.3,,,,,,,,,,104.9,46.1,-58.8,53,89.6,36.6,,,,128.8,71.7,-57.1,784.1,344.3,-439.8,1.9,16.1,14.2,18.6,7.1,-11.5,111.1,76.4,-34.7,,,,10.5,7.5,-3,363.2,174.3,-188.9,,,,90.3,103.3,13,73.6,74.8,1.2,,,,124.5,64.2,-60.3,1163.7,1314.2,150.5,99.1,179.3,80.2,325.2,703.1,377.9,352.2,555.2,203,,,,,,,,,,861.9,821.2,-40.6999999999999,2067.5,1154.1,-913.4,71.1,39,-32.1,,,,,,,,,,28.5,6.1,-22.4,,,,331.6,256.4,-75.2,,,,,,,,,,25.2,32,6.8,51.1,274.4,223.3,,,,,,,,,,,,,,,,,,,,,,,,,,,,,,,,,,,,,219.6,296.6,77,54.2,43.1,-11.1,,,,,,,,,,,,,861,515.6,-345.4,59.4,25.2,-34.2,,,,,,,,,,,,,,,,,,,,,,,,,,,,35.3,47.2,11.9,,,,,,,64.5,126,61.5,,,,,,,,,,,,,2.5,4.8,2.3,,,,,,,,,,,,,73.2,53.4,-19.8,,,,403.9,304.6,-99.3,,,,83.9,79.9,-4,,,,,,,10.2,6.7,-3.5,,,,210,110.9,-99.1,44.9,48.3,3.4,,,,39.4,11.4,-28,45.1,11,-34.1,,,,222.4,124.2,-98.2,,,,,,,,,,281.5,159.2,-122.3,591.8,399.9,-191.9,285.2,119.2,-166,,,,,,,200.3,126.5,-73.8,39.3,0.5,-38.8,,,,,,,652.8,289.5,-363.3,,,,,,,1573.4,740.3,-833.1,764.5,334.2,-430.3,2047.8,886.8,-1161,6356.7,2714.8,-3641.9,358.5,405.9,47.4,,,,,,,,,,,,,,,,94.2,63.7,-30.5,,,,,,,,,,,,,,,,,,,,,,,,,,,,,,,,,,,,,,,,,,,,,,,,,,,,,,,,,,192.9,37.5,-155.4,,,,,,,9.4,183.8,174.4,,,,,,,,,,,,,,,,,,,,,,,,,,,,,,,43,3.7,-39.3,,,,,,,,,,,,,232.7,19.4,-213.3,,,,21,1.2,-19.8,,,,,,,,,,,,,118.4,6.5,-111.9,32.4,1.6,-30.8,,,,,,,,,,,,,37.4,7.1,-30.3,,,,,,,,,,,,,,,,,,,,,,,,,,,,,,,,,,,,,,,,,,,,,,,,,,,,,,,110.2,118.8,8.59999999999999,,,,,,,,,,,,,,,,,,,,,,,,,,,
1988-02-01,2095.5,997.9,-1097.6,,,,,,,,,,,,,,,,4904.3,2448.7,-2455.6,2235.9,1536.6,-699.3,8564.8,7093.2,-1471.6,,,,,,,,,,35494.1,24315.6,-11178.5,15193.1,7136.9,-8056.2,,,,426.9,517.2,90.3000000000001,571.5,162.5,-409,,,,6603.4,5710.4,-893,,,,1961.4,1382.8,-578.6,33.3,39.4,6.1,,,,32.5,34.2,1.7,37.9,35.1,-2.8,,,,64.2,53.1,-11.1,20.7,62,41.3,,,,51.7,56.4,4.7,,,,34.6,54.5,19.9,,,,,,,30.1,33.3,3.2,111.5,93.2,-18.3,,,,,,,,,,,,,,,,,,,,,,,,,,,,,,,68.7,27.1,-41.6,29.4,38.3,8.9,,,,,,,,,,,,,,,,152.4,128.5,-23.9,388.9,312.9,-76,,,,,,,,,,90.2,42.2,-48,57.9,63.6,5.7,,,,171.2,70.8,-100.4,730.3,283.4,-446.9,1.7,21,19.3,9.7,5.7,-4,119,81.9,-37.1,,,,16.6,7.7,-8.9,367.7,203.6,-164.1,,,,87.4,85.1,-2.30000000000001,103.6,58,-45.6,,,,140.5,69,-71.5,1450.7,1457.6,6.89999999999986,107.7,162.1,54.4,335.7,784.4,448.7,368.6,590.9,222.3,,,,,,,,,,943.7,816.5,-127.2,2110.4,1144.5,-965.9,76.7,45.1,-31.6,,,,,,,,,,20.8,6.1,-14.7,,,,359.9,268.5,-91.4,,,,,,,,,,28.9,32.4,3.5,44,322.1,278.1,,,,,,,,,,,,,,,,,,,,,,,,,,,,,,,,,,,,,236.1,295.4,59.3,49.5,78.4,28.9,,,,,,,,,,,,,946.9,503.8,-443.1,67.1,16.1,-51,,,,,,,,,,,,,,,,,,,,,,,,,,,,44.5,40.1,-4.4,,,,,,,68.3,219.1,150.8,,,,,,,,,,,,,0.7,1,0.3,,,,,,,,,,,,,93.4,45.6,-47.8,,,,747.4,301.6,-445.8,,,,81.7,46.1,-35.6,,,,,,,8.3,8.3,0,,,,262.8,161.1,-101.7,45.4,72.6,27.2,,,,42.9,10.1,-32.8,38.7,9.4,-29.3,,,,229.7,145.7,-84,,,,,,,,,,260.9,163.1,-97.8,543,399.1,-143.9,239.6,67.2,-172.4,,,,,,,207.8,151.5,-56.3,45.5,0.2,-45.3,,,,,,,650.6,360.3,-290.3,,,,,,,1523.1,747.6,-775.5,793,378.7,-414.3,2045.2,923.3,-1121.9,7098.4,2957.5,-4140.9,334.6,451.3,116.7,,,,,,,,,,,,,,,,92.3,65.9,-26.4,,,,,,,,,,,,,,,,,,,,,,,,,,,,,,,,,,,,,,,,,,,,,,,,,,,,,,,,,,168.2,92.2,-76,,,,,,,28.9,122.7,93.8,,,,,,,,,,,,,,,,,,,,,,,,,,,,,,,43.7,7.2,-36.5,,,,,,,,,,,,,241.4,29.7,-211.7,,,,21.5,1.8,-19.7,,,,,,,,,,,,,62.5,9.7,-52.8,53.9,1.5,-52.4,,,,,,,,,,,,,27.5,3.8,-23.7,,,,,,,,,,,,,,,,,,,,,,,,,,,,,,,,,,,,,,,,,,,,,,,,,,,,,,,121,108.8,-12.2,,,,,,,,,,,,,,,,,,,,,,,,,,,
1988-03-01,1794.7,1223.7,-571,,,,,,,,,,,,,,,,4496.4,3427.5,-1068.9,2340.5,1800.6,-539.9,9317.7,8364,-953.700000000001,,,,,,,,,,36998.7,29342.8,-7655.90000000001,14583.4,8662,-5921.4,,,,407.2,579,171.8,616,223.2,-392.8,,,,7296.5,6696.4,-600.1,,,,2021.2,1667.6,-353.6,42,50.2,8.2,,,,37.3,35.1,-2.2,38.2,38.1,-0.100000000000001,,,,64,57.9,-6.1,22.6,46.2,23.6,,,,37.8,65.2,27.4,,,,44.5,67,22.5,,,,,,,39.5,42.6,3.1,112.6,116.8,4.2,,,,,,,,,,,,,,,,,,,,,,,,,,,,,,,54.4,24.5,-29.9,32.3,37.5,5.2,,,,,,,,,,,,,,,,214.2,149.6,-64.6,448.4,368,-80.4,,,,,,,,,,110.2,67.1,-43.1,47.4,89,41.6,,,,149.4,96.3,-53.1,717.3,328.9,-388.4,3.3,15.4,12.1,13.2,6.9,-6.3,111.9,98.3,-13.6,,,,27.5,7.5,-20,418.7,209.3,-209.4,,,,115.7,84,-31.7,115.9,65.8,-50.1,,,,165.1,96.4,-68.7,1639.9,1735.5,95.5999999999999,115.1,180.9,65.8,360.6,1090.6,730,423.9,680.2,256.3,,,,,,,,,,1071.9,968.3,-103.6,2508.2,1361.4,-1146.8,93.1,81.1,-12,,,,,,,,,,24.8,6.6,-18.2,,,,394.3,597.9,203.6,,,,,,,,,,32.6,25.6,-7,70.3,332.6,262.3,,,,,,,,,,,,,,,,,,,,,,,,,,,,,,,,,,,,,279.2,400.9,121.7,61.7,78.4,16.7,,,,,,,,,,,,,1069.3,614.2,-455.1,82.1,111.7,29.6,,,,,,,,,,,,,,,,,,,,,,,,,,,,49.3,49.8,0.5,,,,,,,85.9,138.9,53,,,,,,,,,,,,,0.8,0.1,-0.7,,,,,,,,,,,,,20.5,68.8,48.3,,,,459.5,372.5,-87,,,,10.4,58.4,48,,,,,,,14,10.1,-3.9,,,,255.2,170.8,-84.4,49.3,72.6,23.3,,,,38.6,3.5,-35.1,37.8,14.4,-23.4,,,,257.4,138.4,-119,,,,,,,,,,276.2,201.4,-74.8,619.1,459.7,-159.4,253.5,87.3,-166.2,,,,,,,216.3,158.8,-57.5,32.1,0.2,-31.9,,,,,,,509.9,407.8,-102.1,,,,,,,1414.7,995.4,-419.3,648.2,493.1,-155.1,1814.4,1479.3,-335.1,7408.3,3193.2,-4215.1,284.6,511.9,227.3,,,,,,,,,,,,,,,,122.6,67.1,-55.5,,,,,,,,,,,,,,,,,,,,,,,,,,,,,,,,,,,,,,,,,,,,,,,,,,,,,,,,,,125.9,70.1,-55.8,,,,,,,25.5,113,87.5,,,,,,,,,,,,,,,,,,,,,,,,,,,,,,,39.3,8.1,-31.2,,,,,,,,,,,,,266.8,31.2,-235.6,,,,34,3.6,-30.4,,,,,,,,,,,,,90.8,10.1,-80.7,24,0.7,-23.3,,,,,,,,,,,,,32,10.8,-21.2,,,,,,,,,,,,,,,,,,,,,,,,,,,,,,,,,,,,,,,,,,,,,,,,,,,,,,,129.1,158.7,29.6,,,,,,,,,,,,,,,,,,,,,,,,,,,
1988-04-01,1779.8,1041.3,-738.5,,,,,,,,,,,,,,,,4660.9,3116.1,-1544.8,2261.5,1641.6,-619.9,8638.4,7528.4,-1110,,,,,,,,,,34961.1,26727.8,-8233.3,14461.1,8042.1,-6419,,,,387.6,530.4,142.8,553.2,173.6,-379.6,,,,6842.5,5988,-854.5,,,,1795.9,1540.4,-255.5,42,48.9,6.9,,,,21.4,39.8,18.4,37.3,48,10.7,,,,49.9,47.8,-2.1,22.5,24.7,2.2,,,,25.4,52.1,26.7,,,,29,51,22,,,,,,,30.6,39.3,8.7,103.7,112.9,9.2,,,,,,,,,,,,,,,,,,,,,,,,,,,,,,,44.5,28,-16.5,31.4,36.9,5.5,,,,,,,,,,,,,,,,196.6,147.8,-48.8,439.8,328.5,-111.3,,,,,,,,,,111.1,39.7,-71.4,63.5,44,-19.5,,,,125.5,70.5,-55,772.5,371.2,-401.3,1.5,14.8,13.3,17.3,8.1,-9.2,96,87.6,-8.40000000000001,,,,14.6,15.2,0.6,413.6,233.6,-180,,,,105.8,91.5,-14.3,98.6,55,-43.6,,,,128.5,66.2,-62.3,1549.5,1533.7,-15.8,89.4,201.2,111.8,345.2,780,434.8,334.9,547.4,212.5,,,,,,,,,,952.3,846.6,-105.7,2152.9,1284.7,-868.2,82.8,59.6,-23.2,,,,,,,,,,23.7,3,-20.7,,,,375.2,411.2,36,,,,,,,,,,25.8,39.1,13.3,29.2,321.4,292.2,,,,,,,,,,,,,,,,,,,,,,,,,,,,,,,,,,,,,238,480.3,242.3,48.9,56.4,7.5,,,,,,,,,,,,,876.6,622,-254.6,82.2,68.2,-14,,,,,,,,,,,,,,,,,,,,,,,,,,,,23.1,63.4,40.3,,,,,,,89.1,146.5,57.4,,,,,,,,,,,,,0.5,0.7,0.2,,,,,,,,,,,,,5.9,53.2,47.3,,,,416.2,292.8,-123.4,,,,62.6,51.7,-10.9,,,,,,,6,8.5,2.5,,,,235.3,128.4,-106.9,43.4,66.2,22.8,,,,30.5,7.6,-22.9,24.9,4.6,-20.3,,,,253.4,132.2,-121.2,,,,,,,,,,278.3,186.5,-91.8,616.5,467,-149.5,207,84,-123,,,,,,,195.4,157.5,-37.9,30.3,0.2,-30.1,,,,,,,551.9,446.5,-105.4,,,,,,,1541.6,977.9,-563.7,642.3,433.8,-208.5,1860.5,1237.4,-623.1,7244.7,3046.8,-4197.9,281,476.7,195.7,,,,,,,,,,,,,,,,106.6,53.7,-52.9,,,,,,,,,,,,,,,,,,,,,,,,,,,,,,,,,,,,,,,,,,,,,,,,,,,,,,,,,,150.6,64.5,-86.1,,,,,,,17.6,165,147.4,,,,,,,,,,,,,,,,,,,,,,,,,,,,,,,23.3,5.4,-17.9,,,,,,,,,,,,,278.3,31.7,-246.6,,,,18.6,8.7,-9.9,,,,,,,,,,,,,89.7,8.4,-81.3,2,1.4,-0.6,,,,,,,,,,,,,31.1,10.1,-21,,,,,,,,,,,,,,,,,,,,,,,,,,,,,,,,,,,,,,,,,,,,,,,,,,,,,,,110.2,107.9,-2.3,,,,,,,,,,,,,,,,,,,,,,,,,,,
1988-05-01,2023.2,1181.6,-841.6,,,,,,,,,,,,,,,,5011.9,3114.2,-1897.7,2266.4,1914.7,-351.7,9188.8,8449.8,-739,,,,,,,,,,36107.5,28192.7,-7914.8,14439.9,8031.6,-6408.3,,,,401.3,607.1,205.8,702.2,213.5,-488.7,,,,7235.5,6597.3,-638.2,,,,1953.3,1852.5,-100.8,38.6,40.7,2.1,,,,19.1,61.9,42.8,39.3,41.4,2.1,,,,60.7,60.8,0.0999999999999943,25.1,47.8,22.7,,,,24.9,54.3,29.4,,,,43.1,54.9,11.8,,,,,,,34.5,42.4,7.9,111,101.2,-9.8,,,,,,,,,,,,,,,,,,,,,,,,,,,,,,,49.9,22.6,-27.3,40.6,41.2,0.600000000000001,,,,,,,,,,,,,,,,192.2,159.9,-32.3,499,361.3,-137.7,,,,,,,,,,91.5,66.9,-24.6,47.5,64.3,16.8,,,,68.4,74.6,6.19999999999999,742.6,515.1,-227.5,2.4,16.2,13.8,13.4,7.4,-6,122.6,79.8,-42.8,,,,6.9,8.3,1.4,481.4,209,-272.4,,,,124.9,80.9,-44,90,65.7,-24.3,,,,134,96.3,-37.7,1561,1656.4,95.4000000000001,111.5,187.6,76.1,392.8,826.3,433.5,376.8,654.1,277.3,,,,,,,,,,1093,774.8,-318.2,2128.9,1240.2,-888.7,98.2,124.7,26.5,,,,,,,,,,23.6,5.6,-18,,,,359.7,443.3,83.6,,,,,,,,,,28.5,43,14.5,38.8,323,284.2,,,,,,,,,,,,,,,,,,,,,,,,,,,,,,,,,,,,,264.2,413.6,149.4,49.4,53,3.6,,,,,,,,,,,,,876.3,609.7,-266.6,67,50.6,-16.4,,,,,,,,,,,,,,,,,,,,,,,,,,,,50.7,64.7,14,,,,,,,72.5,183.4,110.9,,,,,,,,,,,,,0.3,11.9,11.6,,,,,,,,,,,,,10.8,62,51.2,,,,420,351.3,-68.7,,,,69.1,58.1,-11,,,,,,,6,12,6,,,,232.9,169.2,-63.7,35.1,51.7,16.6,,,,22.5,3.2,-19.3,31.7,10.5,-21.2,,,,246.3,201,-45.3,,,,,,,,,,265.9,166.7,-99.2,641.4,484,-157.4,284.1,71.3,-212.8,,,,,,,204.6,158.6,-46,41.9,0.9,-41,,,,,,,615.1,313.8,-301.3,,,,,,,1602.6,882.6,-720,770.5,459.5,-311,1997.4,1288.1,-709.3,6685.4,2961.3,-3724.1,284.1,544.6,260.5,,,,,,,,,,,,,,,,117.2,62.5,-54.7,,,,,,,,,,,,,,,,,,,,,,,,,,,,,,,,,,,,,,,,,,,,,,,,,,,,,,,,,,183.9,70,-113.9,,,,,,,12.5,183.1,170.6,,,,,,,,,,,,,,,,,,,,,,,,,,,,,,,23.6,7,-16.6,,,,,,,,,,,,,341.2,28.9,-312.3,,,,5.9,5.9,0,,,,,,,,,,,,,137,9.2,-127.8,33.8,0.8,-33,,,,,,,,,,,,,31.7,7.5,-24.2,,,,,,,,,,,,,,,,,,,,,,,,,,,,,,,,,,,,,,,,,,,,,,,,,,,,,,,129,154.2,25.2,,,,,,,,,,,,,,,,,,,,,,,,,,,
1988-06-01,2047.3,1031.4,-1015.9,,,,,,,,,,,,,,,,5385.1,2769.3,-2615.8,2211.6,1730.6,-481,9605.5,7967.2,-1638.3,,,,,,,,,,38540.8,26802.5,-11738.3,15885.8,8248.1,-7637.7,,,,459.3,641.9,182.6,693.3,216.1,-477.2,,,,7488,6373.5,-1114.5,,,,2117.5,1593.7,-523.8,34.5,55.6,21.1,,,,19.2,40.1,20.9,38.1,45.4,7.3,,,,62.7,62.8,0.0999999999999943,21.7,52.1,30.4,,,,28.5,68.2,39.7,,,,42.9,59.6,16.7,,,,,,,34.1,40.9,6.8,143.9,109.8,-34.1,,,,,,,,,,,,,,,,,,,,,,,,,,,,,,,65.1,34.1,-31,33.6,32,-1.6,,,,,,,,,,,,,,,,131.9,154.7,22.8,438,368,-70,,,,,,,,,,84.7,47.2,-37.5,52.3,43.2,-9.09999999999999,,,,72,103,31,754.5,308,-446.5,2.9,16,13.1,23.7,8.4,-15.3,127.3,81.5,-45.8,,,,15.6,8.7,-6.9,455.3,158.5,-296.8,,,,105.6,68.8,-36.8,86,55.3,-30.7,,,,131.1,57.2,-73.9,1544.1,1518,-26.0999999999999,111.4,186.1,74.7,388.4,770,381.6,424.2,573,148.8,,,,,,,,,,1328.8,802.1,-526.7,2238.4,1231.7,-1006.7,95.4,56.1,-39.3,,,,,,,,,,23.8,4.6,-19.2,,,,385.9,326.9,-59,,,,,,,,,,37.2,17.2,-20,30,140.7,110.7,,,,,,,,,,,,,,,,,,,,,,,,,,,,,,,,,,,,,272.3,291.3,19,62.3,56.7,-5.59999999999999,,,,,,,,,,,,,1053.6,553.2,-500.4,70.3,37,-33.3,,,,,,,,,,,,,,,,,,,,,,,,,,,,55.5,39.4,-16.1,,,,,,,55.6,162.1,106.5,,,,,,,,,,,,,1.6,8.5,6.9,,,,,,,,,,,,,5,60.3,55.3,,,,427.9,240.9,-187,,,,72.4,56.2,-16.2,,,,,,,7.4,81.7,74.3,,,,246.6,193.9,-52.7,30.2,105.1,74.9,,,,26.5,13,-13.5,36,6.4,-29.6,,,,283,157.8,-125.2,,,,,,,,,,297.9,178.2,-119.7,678.3,449.8,-228.5,274.7,64.6,-210.1,,,,,,,212.7,173.8,-38.9,56.6,0.6,-56,,,,,,,720.8,503.2,-217.6,,,,,,,1645.3,891.8,-753.5,885,463.5,-421.5,2176.5,964.2,-1212.3,7556.1,3354.8,-4201.3,343,544.7,201.7,,,,,,,,,,,,,,,,116.3,97.2,-19.1,,,,,,,,,,,,,,,,,,,,,,,,,,,,,,,,,,,,,,,,,,,,,,,,,,,,,,,,,,143.1,54.8,-88.3,,,,,,,12.6,320.6,308,,,,,,,,,,,,,,,,,,,,,,,,,,,,,,,12.3,21,8.7,,,,,,,,,,,,,387.9,28.4,-359.5,,,,26.9,6.5,-20.4,,,,,,,,,,,,,85.9,9.4,-76.5,35.7,1,-34.7,,,,,,,,,,,,,16.7,11.7,-5,,,,,,,,,,,,,,,,,,,,,,,,,,,,,,,,,,,,,,,,,,,,,,,,,,,,,,,127.9,138.1,10.2,,,,,,,,,,,,,,,,,,,,,,,,,,,
1988-07-01,1853.6,1146.1,-707.5,,,,,,,,,,,,,,,,5369.1,3019.3,-2349.8,2192.4,1812.6,-379.8,7424.7,6361.3,-1063.4,,,,,,,,,,35397.3,25186.4,-10210.9,15745.3,8485.7,-7259.6,,,,356.1,644.3,288.2,610.7,193.3,-417.4,,,,5736.2,4740.2,-996,,,,1688.5,1621.1,-67.4000000000001,29,42,13,,,,21.9,38.5,16.6,35.3,41.2,5.90000000000001,,,,61,59.9,-1.1,24.3,48.4,24.1,,,,23.9,57.3,33.4,,,,39.2,61.9,22.7,,,,,,,34.3,41,6.7,127.2,100,-27.2,,,,,,,,,,,,,,,,,,,,,,,,,,,,,,,55.1,23.7,-31.4,50.8,33.4,-17.4,,,,,,,,,,,,,,,,171.9,151.4,-20.5,394,393.4,-0.600000000000023,,,,,,,,,,112.5,71.8,-40.7,53,55,2,,,,51.5,87.8,36.3,734.7,395.3,-339.4,1.7,18,16.3,50.9,10.1,-40.8,120.2,82.5,-37.7,,,,13.2,6.8,-6.4,415.7,183.7,-232,,,,148.1,64.7,-83.4,96.4,53.9,-42.5,,,,133.6,108.1,-25.5,1373.2,1397.4,24.2,110.8,161.8,51,379,774.9,395.9,363.1,576.3,213.2,,,,,,,,,,1168.1,747,-421.1,2077.2,1032.9,-1044.3,92.2,47.3,-44.9,,,,,,,,,,24.5,8.1,-16.4,,,,380.6,288,-92.6,,,,,,,,,,31.5,22.8,-8.7,27.1,64.4,37.3,,,,,,,,,,,,,,,,,,,,,,,,,,,,,,,,,,,,,295.6,320.9,25.3,51.7,58.9,7.2,,,,,,,,,,,,,1082.4,519.6,-562.8,82,27.2,-54.8,,,,,,,,,,,,,,,,,,,,,,,,,,,,28.2,47.4,19.2,,,,,,,116.7,158.5,41.8,,,,,,,,,,,,,0.1,8.7,8.6,,,,,,,,,,,,,1.7,44.3,42.6,,,,489.9,286,-203.9,,,,55.5,59.7,4.2,,,,,,,4.1,13.5,9.4,,,,262.1,190,-72.1,29,95.2,66.2,,,,31.5,7.9,-23.6,41.2,5.4,-35.8,,,,262.1,235.4,-26.7,,,,,,,,,,333.3,177.6,-155.7,658.6,448.3,-210.3,225.6,90.8,-134.8,,,,,,,225.2,170.1,-55.1,53.4,1.2,-52.2,,,,,,,761.6,483.6,-278,,,,,,,1721.4,912.6,-808.8,920.6,627.4,-293.2,2068.5,1031,-1037.5,7328.9,3280.1,-4048.8,244,571.7,327.7,,,,,,,,,,,,,,,,112.1,72.6,-39.5,,,,,,,,,,,,,,,,,,,,,,,,,,,,,,,,,,,,,,,,,,,,,,,,,,,,,,,,,,104.8,42.8,-62,,,,,,,15.5,321.5,306,,,,,,,,,,,,,,,,,,,,,,,,,,,,,,,16.1,4.5,-11.6,,,,,,,,,,,,,294.4,21.4,-273,,,,0.3,4.1,3.8,,,,,,,,,,,,,111,4.6,-106.4,19.1,3,-16.1,,,,,,,,,,,,,42.2,16.7,-25.5,,,,,,,,,,,,,,,,,,,,,,,,,,,,,,,,,,,,,,,,,,,,,,,,,,,,,,,127.6,139,11.4,,,,,,,,,,,,,,,,,,,,,,,,,,,
1988-08-01,2149,1191.1,-957.9,,,,,,,,,,,,,,,,6080.9,3147.9,-2933,2594.1,1876.5,-717.6,8322.3,7689.9,-632.4,,,,,,,,,,37545.4,26539,-11006.4,17073.6,8529.3,-8544.3,,,,419.2,724.5,305.3,624.1,236.7,-387.4,,,,6308.5,5861.4,-447.1,,,,2013.8,1828.5,-185.3,40.1,57.3,17.2,,,,29.8,37.6,7.8,40.4,42.4,2,,,,65.9,61.5,-4.40000000000001,22.6,59.8,37.2,,,,26.5,65,38.5,,,,41.1,57,15.9,,,,,,,32.8,43,10.2,134.3,126.6,-7.70000000000002,,,,,,,,,,,,,,,,,,,,,,,,,,,,,,,71.4,29.3,-42.1,23.7,39.2,15.5,,,,,,,,,,,,,,,,213.7,143,-70.7,494.3,417.3,-77,,,,,,,,,,104,70.6,-33.4,53.4,74,20.6,,,,74.3,96,21.7,932,330.4,-601.6,3.9,20.5,16.6,45.1,9.6,-35.5,144.8,96.4,-48.4,,,,16.2,5.5,-10.7,270.9,244.4,-26.5,,,,124.8,65.4,-59.4,91.4,69.9,-21.5,,,,105.8,73.5,-32.3,1445,1415.5,-29.5,115.8,187.3,71.5,389.2,700.6,311.4,243.7,572,328.3,,,,,,,,,,899.5,732.1,-167.4,1905.7,1034.3,-871.4,96.8,58.5,-38.3,,,,,,,,,,22.5,7.2,-15.3,,,,355.7,293.4,-62.3,,,,,,,,,,34.1,14.3,-19.8,51.7,130.1,78.4,,,,,,,,,,,,,,,,,,,,,,,,,,,,,,,,,,,,,309.8,311.7,1.89999999999998,74.7,71.2,-3.5,,,,,,,,,,,,,1054.5,474.8,-579.7,68.2,35.9,-32.3,,,,,,,,,,,,,,,,,,,,,,,,,,,,41.6,58.9,17.3,,,,,,,43.1,147.1,104,,,,,,,,,,,,,0.4,17,16.6,,,,,,,,,,,,,73.6,47.2,-26.4,,,,524.3,295,-229.3,,,,13.2,50.1,36.9,,,,,,,6.1,10.5,4.4,,,,283.2,230.2,-53,36.7,87,50.3,,,,33,11.9,-21.1,36.4,21.1,-15.3,,,,300.6,148.7,-151.9,,,,,,,,,,367.4,191.2,-176.2,750.6,588.6,-162,294.8,90.8,-204,,,,,,,256.1,164,-92.1,57.2,1.2,-56,,,,,,,803.9,424.4,-379.5,,,,,,,1928.7,1180.5,-748.2,1005.8,496.8,-509,2395.8,882,-1513.8,7672.4,3297.9,-4374.5,300.9,647.3,346.4,,,,,,,,,,,,,,,,118.3,77.2,-41.1,,,,,,,,,,,,,,,,,,,,,,,,,,,,,,,,,,,,,,,,,,,,,,,,,,,,,,,,,,148.9,54.8,-94.1,,,,,,,33.5,126.8,93.3,,,,,,,,,,,,,,,,,,,,,,,,,,,,,,,17.3,2.2,-15.1,,,,,,,,,,,,,293.9,37.7,-256.2,,,,8.4,4.5,-3.9,,,,,,,,,,,,,105.2,8.4,-96.8,37.5,3.9,-33.6,,,,,,,,,,,,,29.8,12.3,-17.5,,,,,,,,,,,,,,,,,,,,,,,,,,,,,,,,,,,,,,,,,,,,,,,,,,,,,,,132,167.7,35.7,,,,,,,,,,,,,,,,,,,,,,,,,,,
1988-09-01,1801.9,1255.8,-546.1,,,,,,,,,,,,,,,,5649.7,2787.4,-2862.3,2293.6,1879.8,-413.8,8920.4,8095.8,-824.599999999999,,,,,,,,,,36303.6,27066.6,-9237,15702.6,7989.8,-7712.8,,,,336.4,709.1,372.7,524.3,215.6,-308.7,,,,6976.6,6159.7,-816.900000000001,,,,1943.8,1936.1,-7.70000000000005,31,57.9,26.9,,,,24.1,51.3,27.2,33.7,41.1,7.4,,,,73.3,54.9,-18.4,21.4,60.6,39.2,,,,34.5,54.7,20.2,,,,28.6,51.4,22.8,,,,,,,31.9,37.1,5.2,122.2,124.8,2.59999999999999,,,,,,,,,,,,,,,,,,,,,,,,,,,,,,,57.6,24,-33.6,21.2,36.3,15.1,,,,,,,,,,,,,,,,171.4,164.7,-6.70000000000002,431.7,437.8,6.10000000000002,,,,,,,,,,86.3,52.7,-33.6,58,96.2,38.2,,,,66.5,98.6,32.1,854.6,324,-530.6,3.5,14,10.5,24,10.7,-13.3,118.1,87,-31.1,,,,16.1,7.7,-8.4,389.1,219.2,-169.9,,,,110.1,72.4,-37.7,95.4,56.4,-39,,,,131.5,93.9,-37.6,1390,1495.9,105.9,138.9,178.6,39.7,391.9,850,458.1,346.3,598.7,252.4,,,,,,,,,,1051,887.5,-163.5,2090.6,1141.2,-949.4,83.4,44.2,-39.2,,,,,,,,,,24.2,4.4,-19.8,,,,395.1,282.3,-112.8,,,,,,,,,,28.3,17.9,-10.4,38,109.8,71.8,,,,,,,,,,,,,,,,,,,,,,,,,,,,,,,,,,,,,217.1,316.2,99.1,54.9,59.5,4.6,,,,,,,,,,,,,712.8,533.4,-179.4,61.6,33.5,-28.1,,,,,,,,,,,,,,,,,,,,,,,,,,,,35.9,52.2,16.3,,,,,,,77.3,152.1,74.8,,,,,,,,,,,,,0.4,7.4,7,,,,,,,,,,,,,50.6,46.9,-3.7,,,,343.1,349.1,6,,,,54.5,53.9,-0.600000000000001,,,,,,,5,14.2,9.2,,,,260.5,204.3,-56.2,35.6,110.3,74.7,,,,26.9,44.5,17.6,30.6,11.6,-19,,,,273.2,178,-95.2,,,,,,,,,,353.8,178.2,-175.6,678.2,486.5,-191.7,245.2,81.4,-163.8,,,,,,,236.6,161.4,-75.2,61.5,0.3,-61.2,,,,,,,793.3,396.4,-396.9,,,,,,,1835.2,925.7,-909.5,960.3,510.9,-449.4,2176,864.3,-1311.7,7057.7,3110,-3947.7,255.4,569.8,314.4,,,,,,,,,,,,,,,,81,139.3,58.3,,,,,,,,,,,,,,,,,,,,,,,,,,,,,,,,,,,,,,,,,,,,,,,,,,,,,,,,,,151.5,45.6,-105.9,,,,,,,14,194.5,180.5,,,,,,,,,,,,,,,,,,,,,,,,,,,,,,,14,2.5,-11.5,,,,,,,,,,,,,228.9,38.9,-190,,,,1.2,5.8,4.6,,,,,,,,,,,,,114.4,7.9,-106.5,17.7,2.2,-15.5,,,,,,,,,,,,,36.3,10.4,-25.9,,,,,,,,,,,,,,,,,,,,,,,,,,,,,,,,,,,,,,,,,,,,,,,,,,,,,,,111.8,147.9,36.1,,,,,,,,,,,,,,,,,,,,,,,,,,,
1988-10-01,1847.9,1256.9,-591,,,,,,,,,,,,,,,,5512.6,2817.3,-2695.3,2191.1,1782.7,-408.4,9336.8,8406.1,-930.699999999999,,,,,,,,,,38795.2,28544.1,-10251.1,17144.9,8453.3,-8691.6,,,,338.6,882.6,544,597,215.4,-381.6,,,,7338.5,6358.7,-979.8,,,,1998.3,2047.4,49.1000000000001,29,47.1,18.1,,,,14.2,43.7,29.5,33.4,38.7,5.3,,,,72.6,58.4,-14.2,16,50.7,34.7,,,,34.2,58.1,23.9,,,,31.6,63.3,31.7,,,,,,,30,40.8,10.8,130.5,120.6,-9.90000000000001,,,,,,,,,,,,,,,,,,,,,,,,,,,,,,,39.4,19.2,-20.2,29,34.2,5.2,,,,,,,,,,,,,,,,171.1,142.8,-28.3,408.9,409.3,0.400000000000034,,,,,,,,,,103.8,62.6,-41.2,62,65.2,3.2,,,,85.7,99.3,13.6,766.7,313,-453.7,2.1,13.5,11.4,24.9,9.6,-15.3,106,92.6,-13.4,,,,15.3,7.6,-7.7,473.4,282.9,-190.5,,,,151.8,76.1,-75.7,108.8,83.2,-25.6,,,,141.8,79.2,-62.6,1508.9,1696.9,188,136.6,196.3,59.7,415,896.2,481.2,382.4,675.5,293.1,,,,,,,,,,1004,880.6,-123.4,2139.7,1291.5,-848.2,92.1,63.7,-28.4,,,,,,,,,,25.8,5.8,-20,,,,416.4,268.6,-147.8,,,,,,,,,,33.2,22.6,-10.6,38.2,218.4,180.2,,,,,,,,,,,,,,,,,,,,,,,,,,,,,,,,,,,,,255.6,298,42.4,60.2,54.5,-5.7,,,,,,,,,,,,,988.3,628.4,-359.9,79.2,20.3,-58.9,,,,,,,,,,,,,,,,,,,,,,,,,,,,46.8,70.5,23.7,,,,,,,104.4,130.4,26,,,,,,,,,,,,,0.8,7,6.2,,,,,,,,,,,,,14.7,80.4,65.7,,,,433.9,330.1,-103.8,,,,42.6,63.7,21.1,,,,,,,5.8,19.1,13.3,,,,272.8,381.5,108.7,34,139.2,105.2,,,,19.6,50.6,31,30.8,10.9,-19.9,,,,289,190.7,-98.3,,,,,,,,,,326.4,189.2,-137.2,738.3,508.8,-229.5,302.1,89.5,-212.6,,,,,,,260.8,153.9,-106.9,50.5,0.9,-49.6,,,,,,,834,412.9,-421.1,,,,,,,1699.1,959.4,-739.7,1000.2,529.1,-471.1,2075,820,-1255,8441.2,3259.6,-5181.6,266.9,795.3,528.4,,,,,,,,,,,,,,,,71.7,87.3,15.6,,,,,,,,,,,,,,,,,,,,,,,,,,,,,,,,,,,,,,,,,,,,,,,,,,,,,,,,,,133.3,68.7,-64.6,,,,,,,13.1,158.2,145.1,,,,,,,,,,,,,,,,,,,,,,,,,,,,,,,17,7.7,-9.3,,,,,,,,,,,,,263.2,32.4,-230.8,,,,14.3,4.3,-10,,,,,,,,,,,,,85.3,10.6,-74.7,47.1,2.7,-44.4,,,,,,,,,,,,,18.4,8.8,-9.6,,,,,,,,,,,,,,,,,,,,,,,,,,,,,,,,,,,,,,,,,,,,,,,,,,,,,,,151.7,148.9,-2.79999999999998,,,,,,,,,,,,,,,,,,,,,,,,,,,
1988-11-01,1715.9,1240.8,-475.1,,,,,,,,,,,,,,,,5242,2642.5,-2599.5,2253.5,1862.6,-390.9,9178.7,8261.7,-917,,,,,,,,,,38389.3,27565.2,-10824.1,16486.9,8124.3,-8362.6,,,,379.2,715.5,336.3,515.5,220.6,-294.9,,,,7122,6307.2,-814.8,,,,2056.7,1954.5,-102.2,40.7,53.8,13.1,,,,23.9,35.7,11.8,36.6,37.1,0.5,,,,75.4,68.5,-6.90000000000001,16.4,52.8,36.4,,,,33.1,61.6,28.5,,,,39.8,91.1,51.3,,,,,,,28.4,42.1,13.7,131,120.2,-10.8,,,,,,,,,,,,,,,,,,,,,,,,,,,,,,,63.1,34.2,-28.9,47.3,43.5,-3.8,,,,,,,,,,,,,,,,182.1,147.8,-34.3,391.2,424.1,32.9,,,,,,,,,,101.7,47.5,-54.2,55.9,56.8,0.899999999999999,,,,80.2,78.2,-2,745.4,344.8,-400.6,6.1,17.2,11.1,20.3,7.8,-12.5,134.9,97.8,-37.1,,,,18,6.9,-11.1,459.8,255.6,-204.2,,,,145.4,58.6,-86.8,114.3,60.2,-54.1,,,,147.9,90.2,-57.7,1615.1,1509.6,-105.5,119.9,161.3,41.4,424.6,921.8,497.2,369.9,632.4,262.5,,,,,,,,,,1032.2,793.1,-239.1,2293.4,1138,-1155.4,92.9,60.4,-32.5,,,,,,,,,,21.1,4.3,-16.8,,,,441,303.6,-137.4,,,,,,,,,,35.4,17.3,-18.1,63,259.4,196.4,,,,,,,,,,,,,,,,,,,,,,,,,,,,,,,,,,,,,304.8,321.1,16.3,57,84.7,27.7,,,,,,,,,,,,,1028.7,555.9,-472.8,65.4,56.7,-8.7,,,,,,,,,,,,,,,,,,,,,,,,,,,,52.4,38.4,-14,,,,,,,85.2,131.3,46.1,,,,,,,,,,,,,0.8,6.7,5.9,,,,,,,,,,,,,80.5,59.6,-20.9,,,,363.7,332.5,-31.2,,,,13.5,57.7,44.2,,,,,,,6.7,78.7,72,,,,235.6,328.2,92.6,38,96.2,58.2,,,,25,19.5,-5.5,33.5,2.4,-31.1,,,,288.9,173.4,-115.5,,,,,,,,,,331.3,178.7,-152.6,684,519.1,-164.9,296.5,84.4,-212.1,,,,,,,218.6,155.1,-63.5,43.8,0.4,-43.4,,,,,,,798.8,449.3,-349.5,,,,,,,1682.6,861.5,-821.1,931.6,433.5,-498.1,1943.8,828.4,-1115.4,8191.4,3233.7,-4957.7,314.1,640.2,326.1,,,,,,,,,,,,,,,,65.1,75.3,10.2,,,,,,,,,,,,,,,,,,,,,,,,,,,,,,,,,,,,,,,,,,,,,,,,,,,,,,,,,,152.1,53.5,-98.6,,,,,,,13.2,203.7,190.5,,,,,,,,,,,,,,,,,,,,,,,,,,,,,,,17.9,1.6,-16.3,,,,,,,,,,,,,180.3,29.6,-150.7,,,,11.1,3.1,-8,,,,,,,,,,,,,104.5,8.8,-95.7,29.1,0.6,-28.5,,,,,,,,,,,,,30,9.9,-20.1,,,,,,,,,,,,,,,,,,,,,,,,,,,,,,,,,,,,,,,,,,,,,,,,,,,,,,,142.6,167,24.4,,,,,,,,,,,,,,,,,,,,,,,,,,,
1988-12-01,1984.4,1326,-658.4,,,,,,,,,,,,,,,,5739.4,3164.3,-2575.1,2341.2,2046.9,-294.3,8443.9,7435.7,-1008.2,,,,,,,,,,39383.9,28982.1,-10401.8,17363.2,8856.3,-8506.9,,,,338.4,891.5,553.1,610.9,192.5,-418.4,,,,6476.8,5517.8,-959,,,,1967.1,1917.9,-49.1999999999998,38.7,58.8,20.1,,,,21.8,39,17.2,35.5,40.5,5,,,,78,62,-16,19.9,71.2,51.3,,,,41,75.3,34.3,,,,41.1,98,56.9,,,,,,,30.5,43,12.5,117.8,118,0.200000000000003,,,,,,,,,,,,,,,,,,,,,,,,,,,,,,,85.6,40.8,-44.8,24.9,34,9.1,,,,,,,,,,,,,,,,203.7,149.3,-54.4,416.3,458.6,42.3,,,,,,,,,,126.9,67.1,-59.8,54.5,54.2,-0.299999999999997,,,,107.8,118.7,10.9,759.6,408,-351.6,4.3,11,6.7,9.5,7.5,-2,123.8,91.9,-31.9,,,,17.4,7.6,-9.8,476,325.5,-150.5,,,,136.2,78.2,-58,128.6,62.8,-65.8,,,,180.1,74.8,-105.3,1735.4,1633.7,-101.7,118.8,200.9,82.1,411.4,1018.8,607.4,342.4,630.2,287.8,,,,,,,,,,1102.3,899.9,-202.4,2649.1,1293,-1356.1,99.7,66.7,-33,,,,,,,,,,29.7,14.3,-15.4,,,,415.5,456.2,40.7,,,,,,,,,,36,19.7,-16.3,104.5,272.8,168.3,,,,,,,,,,,,,,,,,,,,,,,,,,,,,,,,,,,,,311.3,469,157.7,68.1,54.4,-13.7,,,,,,,,,,,,,1025.6,644.8,-380.8,57,47.2,-9.8,,,,,,,,,,,,,,,,,,,,,,,,,,,,64.8,82.4,17.6,,,,,,,116.2,154.6,38.4,,,,,,,,,,,,,0.1,6.7,6.6,,,,,,,,,,,,,34.2,61.4,27.2,,,,590.5,319.9,-270.6,,,,19.5,69.8,50.3,,,,,,,18.7,16.7,-2,,,,182.5,231.6,49.1,37.2,146,108.8,,,,30.7,74.9,44.2,33.9,14.2,-19.7,,,,303.8,136.5,-167.3,,,,,,,,,,318.9,171.5,-147.4,773.5,556.6,-216.9,242.2,128.6,-113.6,,,,,,,232,147.1,-84.9,36,0.5,-35.5,,,,,,,818.2,533.9,-284.3,,,,,,,1937.4,1156.5,-780.9,915.6,526.9,-388.7,2112.9,924.3,-1188.6,8477.7,3315.6,-5162.1,274.3,813.5,539.2,,,,,,,,,,,,,,,,64.1,78,13.9,,,,,,,,,,,,,,,,,,,,,,,,,,,,,,,,,,,,,,,,,,,,,,,,,,,,,,,,,,159.1,75.4,-83.7,,,,,,,24.6,239.5,214.9,,,,,,,,,,,,,,,,,,,,,,,,,,,,,,,20.9,4.2,-16.7,,,,,,,,,,,,,269.6,27.5,-242.1,,,,10.3,6.2,-4.1,,,,,,,,,,,,,111.1,7.9,-103.2,44.9,0.7,-44.2,,,,,,,,,,,,,34.3,15.5,-18.8,,,,,,,,,,,,,,,,,,,,,,,,,,,,,,,,,,,,,,,,,,,,,,,,,,,,,,,119.8,130.5,10.7,,,,,,,,,,,,,,,,,,,,,,,,,,,
1989-01-01,2241.4,1273.8,-967.6,,,,37513.2,28380.8,-9132.4,,,,,,,3704.2,5762.2,2058,4978.3,2663.5,-2314.8,2320.1,1841.1,-479,9428.3,8002.8,-1425.5,,,,,,,,,,36179.3,27540.8,-8638.5,14748.8,7674.8,-7074,,,,418,651.5,233.5,686.4,190.3,-496.1,,,,7411.2,6101.7,-1309.5,,,,2017.1,1901.1,-116,44,52.3,8.3,,,,27.2,40.2,13,36.1,35.2,-0.899999999999999,,,,60.6,65.6,4.99999999999999,21,53.7,32.7,,,,51.3,58.9,7.6,,,,20.7,76.6,55.9,,,,,,,19.6,39,19.4,84.3,102.9,18.6,,,,,,,,,,,,,,,,,,,,,,,,,,,,,,,59.1,36.3,-22.8,25.4,25.3,-0.0999999999999979,,,,,,,,,,,,,,,,212.4,133.3,-79.1,517.5,415.6,-101.9,,,,,,,,,,126.5,60.1,-66.4,54.3,46.2,-8.09999999999999,,,,138.4,104,-34.4,706.3,384.3,-322,3.9,13,9.1,12.4,7,-5.4,99.1,91.6,-7.5,,,,5.3,5,-0.3,450.5,207.4,-243.1,,,,94.8,72.2,-22.6,115.6,72.4,-43.2,,,,115.1,79.6,-35.5,1269.5,1501.9,232.4,102,193,91,391,889.6,498.6,297.2,674.8,377.6,,,,,,,,,,928.7,958.2,29.5,1960.5,1264,-696.5,72.7,53.7,-19,,,,,,,,,,32.7,6.4,-26.3,,,,365.5,368.3,2.80000000000001,,,,,,,,,,47.8,21.1,-26.7,67.9,388.4,320.5,,,,,,,,,,,,,,,,,,,,,,,,,,,,,,,,,,,,,278.4,411.7,133.3,74.6,97.4,22.8,,,,,,,,,,,,,782.5,604.9,-177.6,65.1,35.6,-29.5,,,,,,,,,,,,,,,,,,,,,,,,,,,,47.1,63.6,16.5,,,,,,,100.3,126.6,26.3,,,,,,,,,,,,,0.1,1.3,1.2,,,,,,,,,,,,,22,61.2,39.2,,,,566.2,395.8,-170.4,,,,51.6,62.3,10.7,,,,,,,12.5,16.4,3.9,,,,257.7,140.8,-116.9,44.3,164.6,120.3,,,,26.7,20.5,-6.2,35.3,2.6,-32.7,,,,336.8,171.7,-165.1,,,,,,,,,,343.2,170.4,-172.8,643.6,482.1,-161.5,276.4,83.2,-193.2,,,,,,,231.4,156.8,-74.6,43.7,0.2,-43.5,,,,,,,788.9,439,-349.9,,,,,,,1652,1016.5,-635.5,815.4,411.6,-403.8,1867.3,753.3,-1114,6732.5,3124.5,-3608,295.8,585,289.2,,,,,,,,,,,,,,,,122.2,66.5,-55.7,,,,,,,,,,,,,,,,,,,,,,,,,,,,,,,,,,,,,,,,,,,,,,,,,,,,,,,,,,150.2,41.6,-108.6,,,,,,,8.1,266.9,258.8,,,,,,,,,,,,,,,,,,,,,,,,,,,,,,,32.8,8.8,-24,,,,,,,,,,,,,372.8,35.1,-337.7,,,,0,8,8,,,,,,,,,,,,,107.7,6,-101.7,21.8,0.7,-21.1,,,,,,,,,,,,,20.3,6.2,-14.1,,,,,,,,,,,,,,,,,,,,,,,,,,,,,,,,,,,,,,,,,,,,,,,,,,,,,,,131,125.5,-5.5,,,,,,,,,,,,,,,,,,,,,,,,,,,
1989-02-01,1925.5,1067.1,-858.4,,,,38561.7,28494,-10067.7,,,,,,,4195.7,6165.9,1970.2,4494.4,2787.5,-1706.9,2146.6,1713.4,-433.2,9284.8,8541.3,-743.5,,,,,,,,,,36548.8,27926.6,-8622.2,15130,7726.4,-7403.6,,,,351.8,681.5,329.7,653,163.1,-489.9,,,,7190.5,6512,-678.5,,,,2094.3,2029.3,-65.0000000000002,45.9,48.7,2.8,,,,23.5,60.2,36.7,35.5,40.2,4.7,,,,75.7,65.6,-10.1,19.5,63.5,44,,,,25.1,55.6,30.5,,,,31.8,70.3,38.5,,,,,,,30.3,34.4,4.1,102,111.2,9.2,,,,,,,,,,,,,,,,,,,,,,,,,,,,,,,50.2,29.8,-20.4,31.4,31.7,0.300000000000001,,,,,,,,,,,,,,,,194,131.5,-62.5,396.4,346.3,-50.1,,,,,,,,,,96.1,55.7,-40.4,48.1,41.9,-6.2,,,,135.2,99.2,-36,685.6,331.6,-354,3.5,9,5.5,12.2,7.3,-4.9,104.6,79.7,-24.9,,,,5.3,7.1,1.8,447.6,213.5,-234.1,,,,217.7,78.6,-139.1,120.6,58,-62.6,,,,116.2,64.6,-51.6,1453.2,1558.4,105.2,106.8,200.5,93.7,362,838.7,476.7,360.8,602.9,242.1,,,,,,,,,,1021.9,837.5,-184.4,1894.6,1436.7,-457.9,88,45.9,-42.1,,,,,,,,,,26.3,8.5,-17.8,,,,415.1,339.8,-75.3,,,,,,,,,,25.8,14.4,-11.4,41.8,468.6,426.8,,,,,,,,,,,,,,,,,,,,,,,,,,,,,,,,,,,,,271.3,511.4,240.1,55.1,67,11.9,,,,,,,,,,,,,803.2,572.5,-230.7,58.6,28.9,-29.7,,,,,,,,,,,,,,,,,,,,,,,,,,,,51.1,53.4,2.3,,,,,,,121.6,135.2,13.6,,,,,,,,,,,,,0.2,0.6,0.4,,,,,,,,,,,,,37.1,68.7,31.6,,,,525.9,257.5,-268.4,,,,14.2,63.3,49.1,,,,,,,10.3,11.2,0.899999999999999,,,,273.5,141.2,-132.3,51.1,64.8,13.7,,,,36.9,12.6,-24.3,32.6,10.9,-21.7,,,,295.8,189.1,-106.7,,,,,,,,,,303.2,173.5,-129.7,591.7,503.4,-88.3000000000001,242.8,84.1,-158.7,,,,,,,202.3,139.1,-63.2,47.8,0.1,-47.7,,,,,,,798.1,464.7,-333.4,,,,,,,1449.7,973.9,-475.8,669.3,494.1,-175.2,1783.7,816.1,-967.6,7763.2,3257.5,-4505.7,253.9,605.2,351.3,,,,,,,,,,,,,,,,97.9,76.3,-21.6,,,,,,,,,,,,,,,,,,,,,,,,,,,,,,,,,,,,,,,,,,,,,,,,,,,,,,,,,,175.6,32.4,-143.2,,,,,,,13.6,171.4,157.8,,,,,,,,,,,,,,,,,,,,,,,,,,,,,,,21.2,7.8,-13.4,,,,,,,,,,,,,298.9,42.1,-256.8,,,,11.2,3.9,-7.3,,,,,,,,,,,,,92.2,4.1,-88.1,56.3,0.5,-55.8,,,,,,,,,,,,,33.6,5.9,-27.7,,,,,,,,,,,,,,,,,,,,,,,,,,,,,,,,,,,,,,,,,,,,,,,,,,,,,,,139.6,98.8,-40.8,,,,,,,,,,,,,,,,,,,,,,,,,,,
1989-03-01,2270.4,1133.9,-1136.5,,,,39724.7,30659.3,-9065.4,,,,,,,4743.5,7572.6,2829.1,4642.5,3442.4,-1200.1,2509.9,1862,-647.9,9986.6,9444.9,-541.700000000001,,,,,,,,,,40196.9,33243.3,-6953.6,16075.6,9713.4,-6362.2,,,,433.7,756.4,322.7,786.4,245.7,-540.7,,,,7697,7264.1,-432.9,,,,2289.6,2180.8,-108.8,43.3,64.5,21.2,,,,32.1,64.8,32.7,38.3,44.8,6.5,,,,86.1,76.2,-9.89999999999999,20.7,63,42.3,,,,54.5,59.3,4.8,,,,39.9,81.3,41.4,,,,,,,37,42.4,5.4,136.4,144.9,8.5,,,,,,,,,,,,,,,,,,,,,,,,,,,,,,,71.9,58,-13.9,37.5,39.8,2.3,,,,,,,,,,,,,,,,193.6,152.5,-41.1,544.5,269.6,-274.9,,,,,,,,,,141.3,70.3,-71,66,50.1,-15.9,,,,138.4,112.5,-25.9,701.5,333.5,-368,4.3,18.3,14,13.9,10.4,-3.5,108.7,105.8,-2.90000000000001,,,,22.4,7.9,-14.5,485.9,378.4,-107.5,,,,184.6,97.7,-86.9,101.3,79.5,-21.8,,,,149.4,82.7,-66.7,1574.7,2149.3,574.6,125.5,209.9,84.4,429.8,1089.6,659.8,416.2,732.6,316.4,,,,,,,,,,1186.2,1109.8,-76.4000000000001,2337,1475.3,-861.7,90.6,68.7,-21.9,,,,,,,,,,27.8,15.2,-12.6,,,,447.2,479.9,32.7,,,,,,,,,,34,21,-13,80.6,613.5,532.9,,,,,,,,,,,,,,,,,,,,,,,,,,,,,,,,,,,,,283.5,472,188.5,59.7,122.4,62.7,,,,,,,,,,,,,1135.9,669.5,-466.4,73.8,66,-7.8,,,,,,,,,,,,,,,,,,,,,,,,,,,,39.5,60.8,21.3,,,,,,,129.3,129.1,-0.200000000000017,,,,,,,,,,,,,2,10.3,8.3,,,,,,,,,,,,,13.8,97.8,84,,,,546.1,333.1,-213,,,,66.5,74.7,8.2,,,,,,,5.8,13.3,7.5,,,,324.8,214.2,-110.6,47.3,111.5,64.2,,,,40.5,28.1,-12.4,40.7,12.3,-28.4,,,,325.8,214.2,-111.6,,,,,,,,,,370.3,219.6,-150.7,698.5,797.1,98.6,271.9,81.4,-190.5,,,,,,,236.4,190.3,-46.1,33.3,0.3,-33,,,,,,,667.3,565.4,-101.9,,,,,,,1610.1,1160.1,-450,622.1,583.8,-38.3000000000001,1711.8,901.4,-810.4,8439.6,4104.2,-4335.4,310.6,676.5,365.9,,,,,,,,,,,,,,,,123.1,79.9,-43.2,,,,,,,,,,,,,,,,,,,,,,,,,,,,,,,,,,,,,,,,,,,,,,,,,,,,,,,,,,133.7,48.3,-85.4,,,,,,,15.6,179.1,163.5,,,,,,,,,,,,,,,,,,,,,,,,,,,,,,,18.4,8.8,-9.6,,,,,,,,,,,,,336.3,33.5,-302.8,,,,29.1,4.8,-24.3,,,,,,,,,,,,,181.7,11.9,-169.8,58,0.7,-57.3,,,,,,,,,,,,,26.6,11.1,-15.5,,,,,,,,,,,,,,,,,,,,,,,,,,,,,,,,,,,,,,,,,,,,,,,,,,,,,,,136.3,174.9,38.6,,,,,,,,,,,,,,,,,,,,,,,,,,,
1989-04-01,2423.8,1090.5,-1333.3,,,,38664.7,30569.2,-8095.5,,,,,,,4385.8,7023.3,2637.5,4737.7,3227.7,-1510,2477.2,1760.1,-717.1,9942.2,9072.2,-870,,,,,,,,,,38243.2,31052.4,-7190.8,15209,8919.1,-6289.9,,,,408.9,702.4,293.5,836,205.4,-630.6,,,,7580.9,7027.8,-553.099999999999,,,,2361.3,2044.4,-316.9,38.7,59.6,20.9,,,,23.2,44.4,21.2,32.6,42.3,9.7,,,,68.9,73.4,4.5,20.2,68.3,48.1,,,,34.1,62.2,28.1,,,,28.1,86.6,58.5,,,,,,,26.3,38.6,12.3,136.8,140.6,3.79999999999998,,,,,,,,,,,,,,,,,,,,,,,,,,,,,,,43.3,37.9,-5.4,24.5,31.1,6.6,,,,,,,,,,,,,,,,208.2,169.3,-38.9,559.3,240.7,-318.6,,,,,,,,,,118,42.8,-75.2,83.6,47.6,-36,,,,158.4,102.5,-55.9,742,351.3,-390.7,2.6,17.3,14.7,14.3,9.4,-4.9,114.1,94.2,-19.9,,,,14.8,13.4,-1.4,433.1,319,-114.1,,,,215.9,94.8,-121.1,111.5,91.7,-19.8,,,,122.3,75,-47.3,1390.5,1858.5,468,114.7,218.7,104,350.7,915.4,564.7,389.3,672.9,283.6,,,,,,,,,,1106.1,955,-151.1,2082,1371.6,-710.4,82.4,94.7,12.3,,,,,,,,,,23.8,10.7,-13.1,,,,400.5,426.5,26,,,,,,,,,,31,99.4,68.4,65.9,462.9,397,,,,,,,,,,,,,,,,,,,,,,,,,,,,,,,,,,,,,268.8,447.1,178.3,67.3,87.9,20.6,,,,,,,,,,,,,926.1,620,-306.1,63.7,63.3,-0.400000000000006,,,,,,,,,,,,,,,,,,,,,,,,,,,,38.5,38,-0.5,,,,,,,101.8,149.6,47.8,,,,,,,,,,,,,0.3,0.8,0.5,,,,,,,,,,,,,9.8,70,60.2,,,,598.5,299,-299.5,,,,45.1,97.5,52.4,,,,,,,7,91.4,84.4,,,,297.3,220.8,-76.5,39.4,88.2,48.8,,,,27.1,45.6,18.5,34.5,11.8,-22.7,,,,321.3,145.9,-175.4,,,,,,,,,,371.6,238.3,-133.3,687.6,562.7,-124.9,229.1,110.4,-118.7,,,,,,,188.1,177,-11.1,34.5,0.3,-34.2,,,,,,,728.5,415.3,-313.2,,,,,,,1550.7,1019.8,-530.9,636.1,597.7,-38.4,1863.3,1047.5,-815.8,7537.3,3677.4,-3859.9,302,621.9,319.9,,,,,,,,,,,,,,,,106.9,80.5,-26.4,,,,,,,,,,,,,,,,,,,,,,,,,,,,,,,,,,,,,,,,,,,,,,,,,,,,,,,,,,166.2,76.6,-89.6,,,,,,,17.3,168.8,151.5,,,,,,,,,,,,,,,,,,,,,,,,,,,,,,,37.5,4.9,-32.6,,,,,,,,,,,,,402.2,18.4,-383.8,,,,35.4,2.5,-32.9,,,,,,,,,,,,,153.6,9.7,-143.9,50.3,0.6,-49.7,,,,,,,,,,,,,25.8,8,-17.8,,,,,,,,,,,,,,,,,,,,,,,,,,,,,,,,,,,,,,,,,,,,,,,,,,,,,,,131.2,161.3,30.1,,,,,,,,,,,,,,,,,,,,,,,,,,,
1989-05-01,2916.8,1085,-1831.8,,,,40909.6,30689.5,-10220.1,,,,,,,4620.7,6972,2351.3,5326.7,3298.9,-2027.8,2476.6,1702.7,-773.9,10514.1,9544.9,-969.200000000001,,,,,,,,,,40958.6,31495.7,-9462.9,16718.5,8950.9,-7767.6,,,,463.7,757.9,294.2,987,203.3,-783.7,,,,7984.2,7448.3,-535.9,,,,2529.9,2096.6,-433.3,50.8,47.4,-3.4,,,,19.8,47.3,27.5,43.6,43.3,-0.300000000000004,,,,76.6,73,-3.59999999999999,21.5,45.4,23.9,,,,37.5,62.8,25.3,,,,50.3,98.6,48.3,,,,,,,34.6,44.6,10,149.2,141.3,-7.89999999999998,,,,,,,,,,,,,,,,,,,,,,,,,,,,,,,92.2,34.4,-57.8,38.5,40.1,1.6,,,,,,,,,,,,,,,,194.5,159.6,-34.9,626.1,227.9,-398.2,,,,,,,,,,162.1,53.2,-108.9,67.4,41,-26.4,,,,107.3,111.9,4.60000000000001,576.5,312,-264.5,1.8,11.9,10.1,14.7,11.5,-3.2,111.6,95.5,-16.1,,,,19.5,87.1,67.6,465.2,293.6,-171.6,,,,180.6,82.5,-98.1,113.4,101.2,-12.2,,,,123.9,86.7,-37.2,1691.9,1680,-11.9000000000001,133.1,179.5,46.4,374,970.7,596.7,376.8,792.9,416.1,,,,,,,,,,1038,1002.2,-35.8,2081,1586.3,-494.7,93.9,67.6,-26.3,,,,,,,,,,27.1,7.2,-19.9,,,,380.5,419.3,38.8,,,,,,,,,,29.5,86.6,57.1,38.8,461.4,422.6,,,,,,,,,,,,,,,,,,,,,,,,,,,,,,,,,,,,,301.4,325.4,24,57.3,69,11.7,,,,,,,,,,,,,984.5,606.3,-378.2,80.5,32.7,-47.8,,,,,,,,,,,,,,,,,,,,,,,,,,,,42.3,65.2,22.9,,,,,,,92.9,145,52.1,,,,,,,,,,,,,0.1,7.2,7.1,,,,,,,,,,,,,69,65.5,-3.5,,,,615.4,286.7,-328.7,,,,96.3,96.2,-0.0999999999999943,,,,,,,5.1,97.9,92.8,,,,264.4,225.8,-38.6,43,69.6,26.6,,,,33.9,8.9,-25,32.6,21.1,-11.5,,,,326.6,179.9,-146.7,,,,,,,,,,378,202.8,-175.2,782,576,-206,365.6,111.5,-254.1,,,,,,,247.9,183.9,-64,45.4,0.5,-44.9,,,,,,,937.9,482.4,-455.5,,,,,,,1699.4,1180,-519.4,750.6,514.3,-236.3,2094.7,1028.6,-1066.1,7927.1,3610.3,-4316.8,324.3,685.8,361.5,,,,,,,,,,,,,,,,139.4,72.1,-67.3,,,,,,,,,,,,,,,,,,,,,,,,,,,,,,,,,,,,,,,,,,,,,,,,,,,,,,,,,,196.9,71.2,-125.7,,,,,,,20.7,249.8,229.1,,,,,,,,,,,,,,,,,,,,,,,,,,,,,,,26.9,5.3,-21.6,,,,,,,,,,,,,517.1,43.8,-473.3,,,,29.6,3.5,-26.1,,,,,,,,,,,,,235.6,7.5,-228.1,14,0.8,-13.2,,,,,,,,,,,,,25.2,7,-18.2,,,,,,,,,,,,,,,,,,,,,,,,,,,,,,,,,,,,,,,,,,,,,,,,,,,,,,,138.6,135.4,-3.19999999999999,,,,,,,,,,,,,,,,,,,,,,,,,,,
1989-06-01,2619.5,1030.7,-1588.8,,,,39780.9,31295.3,-8485.6,,,,,,,5028.5,7407.6,2379.1,5321.8,3656.9,-1664.9,2631.4,1906.5,-724.9,9883.7,9134.3,-749.400000000001,,,,,,,,,,40544.2,31820.4,-8723.8,16868.8,9733.4,-7135.4,,,,436.5,817.6,381.1,889.2,205.8,-683.4,,,,7639.5,6983.3,-656.2,,,,2244.2,2151,-93.1999999999998,51.5,49.6,-1.9,,,,24.4,30.9,6.5,38.1,42.5,4.4,,,,81.2,65.3,-15.9,30.7,54.7,24,,,,37.7,70.7,33,,,,60.7,100.9,40.2,,,,,,,33.3,39.2,5.90000000000001,134.6,155,20.4,,,,,,,,,,,,,,,,,,,,,,,,,,,,,,,90.8,36.2,-54.6,27.1,31,3.9,,,,,,,,,,,,,,,,214.3,204.4,-9.90000000000001,543.2,234.5,-308.7,,,,,,,,,,115.7,62.5,-53.2,65,47,-18,,,,90,150.8,60.8,836.3,437.4,-398.9,4.1,14.4,10.3,18.5,10,-8.5,134.2,69.5,-64.7,,,,14.8,11.4,-3.4,434.6,213.1,-221.5,,,,207.6,76.7,-130.9,120.1,79,-41.1,,,,128.8,87,-41.8,1413.3,1683.7,270.4,129.6,200.8,71.2,382.5,962.9,580.4,382.1,707.4,325.3,,,,,,,,,,1325.6,978.9,-346.7,2032.3,1444.3,-588,93.8,57.7,-36.1,,,,,,,,,,27.5,10.3,-17.2,,,,399.9,479.7,79.8,,,,,,,,,,36.6,24.3,-12.3,83.2,408,324.8,,,,,,,,,,,,,,,,,,,,,,,,,,,,,,,,,,,,,309.2,430.5,121.3,76.2,64.6,-11.6,,,,,,,,,,,,,1066.1,704.3,-361.8,72.8,38,-34.8,,,,,,,,,,,,,,,,,,,,,,,,,,,,46,45,-1,,,,,,,74.9,166.1,91.2,,,,,,,,,,,,,0.8,12,11.2,,,,,,,,,,,,,144.1,52,-92.1,,,,612.9,286.3,-326.6,,,,59.1,68.6,9.49999999999999,,,,,,,5.3,160.1,154.8,,,,262.5,227.4,-35.1,38.6,61.5,22.9,,,,34.5,41.2,6.7,36.7,11.7,-25,,,,377.4,209.2,-168.2,,,,,,,,,,417,214.4,-202.6,709.7,599.5,-110.2,298.7,99.1,-199.6,,,,,,,297.7,194.7,-103,61.1,1.9,-59.2,,,,,,,1021.7,362.7,-659,,,,,,,1672.1,1369.6,-302.5,805.2,691.5,-113.7,2134.8,996.3,-1138.5,7870.7,4072.6,-3798.1,330.5,734.4,403.9,,,,,,,,,,,,,,,,106,83.2,-22.8,,,,,,,,,,,,,,,,,,,,,,,,,,,,,,,,,,,,,,,,,,,,,,,,,,,,,,,,,,131.6,69,-62.6,,,,,,,25.7,162.8,137.1,,,,,,,,,,,,,,,,,,,,,,,,,,,,,,,13.6,4,-9.6,,,,,,,,,,,,,490.6,34.4,-456.2,,,,42.6,5,-37.6,,,,,,,,,,,,,137.2,3.6,-133.6,52.1,0.8,-51.3,,,,,,,,,,,,,32.2,10.3,-21.9,,,,,,,,,,,,,,,,,,,,,,,,,,,,,,,,,,,,,,,,,,,,,,,,,,,,,,,120.9,147.7,26.8,,,,,,,,,,,,,,,,,,,,,,,,,,,
1989-07-01,2761.3,1069.3,-1692,,,,38951.3,29933.6,-9017.7,,,,,,,4576.1,6958,2381.9,5516.5,3242.8,-2273.7,2460.5,1802.8,-657.7,8287.5,7233.3,-1054.2,,,,,,,,,,39290,28707.7,-10582.3,17461.5,9220.3,-8241.2,,,,466.8,785,318.2,1004.1,273,-731.1,,,,6114.4,5172.1,-942.299999999999,,,,2173.1,2061.2,-111.9,51.5,60.1,8.6,,,,15.7,43.9,28.2,43.1,38.9,-4.2,,,,75.6,77.7,2.10000000000001,27.5,59.3,31.8,,,,22.9,62.2,39.3,,,,36.6,84.2,47.6,,,,,,,33,34.8,1.8,170.2,124.8,-45.4,,,,,,,,,,,,,,,,,,,,,,,,,,,,,,,56.6,63.5,6.9,41.6,22.4,-19.2,,,,,,,,,,,,,,,,181.7,181.9,0.200000000000017,522.4,208,-314.4,,,,,,,,,,136.7,51.5,-85.2,50.5,59,8.5,,,,75.7,145.1,69.4,751.1,390.3,-360.8,2.6,13.2,10.6,22.6,14.5,-8.1,142.9,67.5,-75.4,,,,17.6,6.7,-10.9,390.5,196.6,-193.9,,,,121,141.6,20.6,109.1,58.6,-50.5,,,,135.1,70.9,-64.2,1507.4,2017.7,510.3,132.1,192.1,60,403.4,811.6,408.2,403.7,640.2,236.5,,,,,,,,,,1117.7,941.5,-176.2,2113.6,1169,-944.6,98,59.7,-38.3,,,,,,,,,,31.2,9.9,-21.3,,,,370.2,361.8,-8.39999999999998,,,,,,,,,,34,21.2,-12.8,66.5,224.5,158,,,,,,,,,,,,,,,,,,,,,,,,,,,,,,,,,,,,,291.9,267.6,-24.3,79.7,58,-21.7,,,,,,,,,,,,,1169.3,544.4,-624.9,73.5,30.1,-43.4,,,,,,,,,,,,,,,,,,,,,,,,,,,,39.4,56.7,17.3,,,,,,,109.9,207.7,97.8,,,,,,,,,,,,,1.7,0.6,-1.1,,,,,,,,,,,,,134.3,41.8,-92.5,,,,568.7,248.7,-320,,,,73.7,86.5,12.8,,,,,,,11.2,18.3,7.1,,,,296.9,268.4,-28.5,39.5,58.8,19.3,,,,33.2,28.2,-5,42,20.3,-21.7,,,,392.3,194.5,-197.8,,,,,,,,,,395.5,211.4,-184.1,723.8,660.3,-63.5,291.2,111.2,-180,,,,,,,278.9,171.8,-107.1,68.6,2.5,-66.1,,,,,,,1162.7,637.7,-525,,,,,,,1737,1205.5,-531.5,877.5,480,-397.5,2178.2,897,-1281.2,7855,3865.5,-3989.5,344,689.5,345.5,,,,,,,,,,,,,,,,122.8,95.5,-27.3,,,,,,,,,,,,,,,,,,,,,,,,,,,,,,,,,,,,,,,,,,,,,,,,,,,,,,,,,,125.5,95.4,-30.1,,,,,,,21.2,342.7,321.5,,,,,,,,,,,,,,,,,,,,,,,,,,,,,,,12.2,6.1,-6.1,,,,,,,,,,,,,649.4,112,-537.4,,,,17.1,2.8,-14.3,,,,,,,,,,,,,154.6,6.4,-148.2,17.9,0.8,-17.1,,,,,,,,,,,,,38.7,13.3,-25.4,,,,,,,,,,,,,,,,,,,,,,,,,,,,,,,,,,,,,,,,,,,,,,,,,,,,,,,114.2,131.6,17.4,,,,,,,,,,,,,,,,,,,,,,,,,,,
1989-08-01,2940.1,910.5,-2029.6,,,,40117.3,30167.5,-9949.8,,,,,,,4767.7,6894.5,2126.8,5859.4,3137.8,-2721.6,2594.6,1887.2,-707.4,9186,8437.4,-748.6,,,,,,,,,,40440.1,29405.9,-11034.2,18204.9,9447.3,-8757.6,,,,409.7,878.1,468.4,998.9,179.5,-819.4,,,,6825.4,6289.3,-536.099999999999,,,,2360.6,2148.1,-212.5,61,55.1,-5.9,,,,18.6,53.6,35,48.6,64,15.4,,,,77.6,82.8,5.2,21.3,77.7,56.4,,,,26.1,76.7,50.6,,,,52.4,77.8,25.4,,,,,,,32.8,45.1,12.3,160.3,141.3,-19,,,,,,,,,,,,,,,,,,,,,,,,,,,,,,,64.6,52.2,-12.4,34.5,33.4,-1.1,,,,,,,,,,,,,,,,247.6,162.1,-85.5,553,183.9,-369.1,,,,,,,,,,126.3,44.7,-81.6,69.8,47.3,-22.5,,,,78.4,111,32.6,775.4,472.9,-302.5,3.5,18.3,14.8,22.9,19.3,-3.6,119.9,68,-51.9,,,,22.1,12.5,-9.6,204,267.6,63.6,,,,132.6,79.2,-53.4,87,71.1,-15.9,,,,113.2,143.7,30.5,1635.6,1526.8,-108.8,116,182.2,66.2,373.8,824,450.2,243.9,616.6,372.7,,,,,,,,,,996.6,818.6,-178,2057,1185.8,-871.2,101.5,70.8,-30.7,,,,,,,,,,30.6,5,-25.6,,,,373.1,422.3,49.2,,,,,,,,,,27.5,21.6,-5.9,52.4,137,84.6,,,,,,,,,,,,,,,,,,,,,,,,,,,,,,,,,,,,,292.6,376.9,84.3,75.1,49,-26.1,,,,,,,,,,,,,1100.7,530.1,-570.6,64.4,34.3,-30.1,,,,,,,,,,,,,,,,,,,,,,,,,,,,33.5,49.9,16.4,,,,,,,114.1,239.4,125.3,,,,,,,,,,,,,1.7,1.4,-0.3,,,,,,,,,,,,,188.7,66.1,-122.6,,,,695.2,245.4,-449.8,,,,73.7,73.4,-0.299999999999997,,,,,,,5.2,12.8,7.6,,,,308.9,238.2,-70.7,42.8,101.2,58.4,,,,44.6,21.2,-23.4,45.7,4.8,-40.9,,,,399.2,164.5,-234.7,,,,,,,,,,430.4,262,-168.4,782.4,614.5,-167.9,343.2,121,-222.2,,,,,,,311.4,254.8,-56.6,77,1.5,-75.5,,,,,,,1279.6,688.5,-591.1,,,,,,,1741.8,1054.9,-686.9,959.1,498.4,-460.7,2376.1,970,-1406.1,7859.4,3917.4,-3942,302.9,788,485.1,,,,,,,,,,,,,,,,106.8,90.1,-16.7,,,,,,,,,,,,,,,,,,,,,,,,,,,,,,,,,,,,,,,,,,,,,,,,,,,,,,,,,,127.8,45.6,-82.2,,,,,,,22.5,185.1,162.6,,,,,,,,,,,,,,,,,,,,,,,,,,,,,,,26.4,2.8,-23.6,,,,,,,,,,,,,535,32.4,-502.6,,,,64.1,3.2,-60.9,,,,,,,,,,,,,163.3,5.2,-158.1,66.8,1.7,-65.1,,,,,,,,,,,,,23,7.2,-15.8,,,,,,,,,,,,,,,,,,,,,,,,,,,,,,,,,,,,,,,,,,,,,,,,,,,,,,,120.3,127,6.7,,,,,,,,,,,,,,,,,,,,,,,,,,,
1989-09-01,2414.3,946.9,-1467.4,,,,39232.9,30414.6,-8818.3,,,,,,,4980,7673.5,2693.5,5604.5,3144.2,-2460.3,2408.9,1769,-639.9,9344.7,8397.4,-947.300000000001,,,,,,,,,,38680.1,29709.5,-8970.6,17304.6,8782.3,-8522.3,,,,392.7,964.7,572,784.1,208.8,-575.3,,,,7133.9,6440.9,-693,,,,2210.8,1956.5,-254.3,59.8,50.9,-8.9,,,,12.1,32.3,20.2,36.5,40.1,3.6,,,,82.2,79.5,-2.7,25,63.6,38.6,,,,38.2,62.6,24.4,,,,49.5,84.6,35.1,,,,,,,33.8,44.9,11.1,138.1,136,-2.09999999999999,,,,,,,,,,,,,,,,,,,,,,,,,,,,,,,43,53.1,10.1,40.3,30.7,-9.6,,,,,,,,,,,,,,,,213,155.9,-57.1,539.6,217.4,-322.2,,,,,,,,,,131.5,54.2,-77.3,77.9,42.7,-35.2,,,,96.4,122.5,26.1,651.1,381.2,-269.9,5.7,15.5,9.8,20.9,10.7,-10.2,114.3,90.6,-23.7,,,,12.6,7,-5.6,341,304.6,-36.4,,,,164.1,68.9,-95.2,101.3,117.6,16.3,,,,125.8,111.2,-14.6,1497.5,1691.9,194.4,153,257.5,104.5,396.6,1226.8,830.2,364.1,709.9,345.8,,,,,,,,,,958.5,964.5,6,1848.2,1425.9,-422.3,95.7,60.6,-35.1,,,,,,,,,,25.2,10.4,-14.8,,,,347.3,315.6,-31.7,,,,,,,,,,25.5,18.8,-6.7,59,86.1,27.1,,,,,,,,,,,,,,,,,,,,,,,,,,,,,,,,,,,,,205.9,378.4,172.5,53.9,43.4,-10.5,,,,,,,,,,,,,775,524.8,-250.2,70.9,47.3,-23.6,,,,,,,,,,,,,,,,,,,,,,,,,,,,27,66.2,39.2,,,,,,,98.6,172.1,73.5,,,,,,,,,,,,,0.3,0.7,0.4,,,,,,,,,,,,,125.2,52.2,-73,,,,528.1,269.7,-258.4,,,,18,71,53,,,,,,,4.2,12.6,8.4,,,,278.5,219.6,-58.9,33.1,121.6,88.5,,,,35,28.5,-6.5,35.3,16.3,-19,,,,423.3,198.6,-224.7,,,,,,,,,,408.6,226,-182.6,825.9,574.3,-251.6,253.9,100.6,-153.3,,,,,,,259.1,193.7,-65.4,73.4,1.6,-71.8,,,,,,,1179.3,427.9,-751.4,,,,,,,1701.9,1130.2,-571.7,895.3,566.4,-328.9,2181.4,873.3,-1308.1,7742.9,3502.4,-4240.5,319.3,884.4,565.1,,,,,,,,,,,,,,,,73.4,80.3,6.89999999999999,,,,,,,,,,,,,,,,,,,,,,,,,,,,,,,,,,,,,,,,,,,,,,,,,,,,,,,,,,144,61.5,-82.5,,,,,,,16.1,280.5,264.4,,,,,,,,,,,,,,,,,,,,,,,,,,,,,,,13.1,8.8,-4.3,,,,,,,,,,,,,449.2,27.8,-421.4,,,,0.1,3.6,3.5,,,,,,,,,,,,,156.3,8.7,-147.6,10,1.6,-8.4,,,,,,,,,,,,,25.5,15.4,-10.1,,,,,,,,,,,,,,,,,,,,,,,,,,,,,,,,,,,,,,,,,,,,,,,,,,,,,,,129.9,142.9,13,,,,,,,,,,,,,,,,,,,,,,,,,,,
1989-10-01,2649.7,1128.5,-1521.2,,,,40961.2,31159.6,-9801.6,,,,,,,5220.6,7512.4,2291.8,5978.8,3164.3,-2814.5,2683.8,2014.5,-669.3,10310.8,9327.8,-983,,,,,,,,,,43536.2,31756.2,-11780,18908.3,9356.8,-9551.5,,,,477.5,907.1,429.6,875.6,231,-644.6,,,,7847.2,6976.1,-871.099999999999,,,,2463.6,2351.7,-111.9,59.4,61.6,2.2,,,,17,35.4,18.4,31.1,36.2,5.1,,,,98.8,78.6,-20.2,24.6,66,41.4,,,,48.9,65.5,16.6,,,,47.7,90.5,42.8,,,,,,,34,41.7,7.7,145.5,162.1,16.6,,,,,,,,,,,,,,,,,,,,,,,,,,,,,,,63.2,85,21.8,22.3,34.1,11.8,,,,,,,,,,,,,,,,227.5,172.2,-55.3,662.5,255.1,-407.4,,,,,,,,,,133.5,49.5,-84,73.6,64.5,-9.09999999999999,,,,94,119.6,25.6,742.7,471.4,-271.3,4,15.5,11.5,22.6,11.8,-10.8,130.9,98.2,-32.7,,,,21.8,7.2,-14.6,438.5,241.4,-197.1,,,,190.9,92.2,-98.7,131.5,74.9,-56.6,,,,141.9,85.2,-56.7,1748.7,1721.9,-26.8,158.2,253.1,94.9,508,916.9,408.9,398.1,734.9,336.8,,,,,,,,,,1106.7,1026.5,-80.2,2256.9,1624.9,-632,111.8,143.4,31.6,,,,,,,,,,27,13.4,-13.6,,,,437.6,380.7,-56.9,,,,,,,,,,32.6,31,-1.6,58.8,157.1,98.3,,,,,,,,,,,,,,,,,,,,,,,,,,,,,,,,,,,,,262.7,453.2,190.5,54.6,69.1,14.5,,,,,,,,,,,,,1140.4,613.3,-527.1,69.5,57.4,-12.1,,,,,,,,,,,,,,,,,,,,,,,,,,,,44.7,77.7,33,,,,,,,145.9,182,36.1,,,,,,,,,,,,,0.2,7.7,7.5,,,,,,,,,,,,,97,84.6,-12.4,,,,545.9,301.2,-244.7,,,,64.5,96.6,32.1,,,,,,,3.7,25.6,21.9,,,,320.2,219.3,-100.9,53.9,77.8,23.9,,,,41.1,28.1,-13,39.5,11.2,-28.3,,,,435.4,192.7,-242.7,,,,,,,,,,444.9,368,-76.9,849.3,577.4,-271.9,304.9,109.1,-195.8,,,,,,,297.2,208.8,-88.4,75.7,0.9,-74.8,,,,,,,1340.4,542.4,-798,,,,,,,1782.1,1116.5,-665.6,1061.2,471,-590.2,2286.2,999.4,-1286.8,8602.6,3698.7,-4903.9,402.9,810.2,407.3,,,,,,,,,,,,,,,,74.6,96.9,22.3,,,,,,,,,,,,,,,,,,,,,,,,,,,,,,,,,,,,,,,,,,,,,,,,,,,,,,,,,,175.2,78.8,-96.4,,,,,,,27.5,211.2,183.7,,,,,,,,,,,,,,,,,,,,,,,,,,,,,,,22.2,8.3,-13.9,,,,,,,,,,,,,360.1,40.2,-319.9,,,,80.6,2.4,-78.2,,,,,,,,,,,,,179.2,9.4,-169.8,85.1,1.7,-83.4,,,,,,,,,,,,,20.8,21.2,0.399999999999999,,,,,,,,,,,,,,,,,,,,,,,,,,,,,,,,,,,,,,,,,,,,,,,,,,,,,,,127.6,147.8,20.2,,,,,,,,,,,,,,,,,,,,,,,,,,,
1989-11-01,2782.9,1012.5,-1770.4,,,,40429,30526,-9903,,,,,,,5220.5,6454.6,1234.1,5376.8,3250.4,-2126.4,2517.7,1861.1,-656.6,10076.9,8631.6,-1445.3,,,,,,,,,,41033,30279,-10754,17237.8,9285.4,-7952.4,,,,423.9,716.5,292.6,874.9,197.8,-677.1,,,,7717.5,6627.5,-1090,,,,2359.4,2004.1,-355.3,49.9,59.6,9.7,,,,17.2,35,17.8,39.6,49.5,9.9,,,,96.2,79.9,-16.3,20.4,64,43.6,,,,43.5,66.4,22.9,,,,42.2,79.8,37.6,,,,,,,28.4,31.1,2.7,150.4,153.2,2.79999999999998,,,,,,,,,,,,,,,,,,,,,,,,,,,,,,,59.9,34.4,-25.5,35.3,47.7,12.4,,,,,,,,,,,,,,,,213,151.4,-61.6,671.4,194,-477.4,,,,,,,,,,111.8,56.6,-55.2,83.8,101.9,18.1,,,,96.7,119.8,23.1,606.3,425.3,-181,4.6,13.3,8.7,26.7,13.5,-13.2,120.4,84.7,-35.7,,,,35.5,6.6,-28.9,398.8,220.9,-177.9,,,,147.3,73.9,-73.4,155.3,85.7,-69.6,,,,138.1,76.7,-61.4,1702.1,1781.7,79.6000000000001,158.6,191.4,32.8,449.6,960.8,511.2,387.5,750.2,362.7,,,,,,,,,,1184.3,957.6,-226.7,2108.8,1435.7,-673.1,114.6,76.9,-37.7,,,,,,,,,,21.9,12.5,-9.4,,,,416.9,396.3,-20.6,,,,,,,,,,32.9,26.2,-6.7,49.2,423.5,374.3,,,,,,,,,,,,,,,,,,,,,,,,,,,,,,,,,,,,,274.9,340.8,65.9,63.2,70,6.8,,,,,,,,,,,,,1105.3,589.5,-515.8,50,36,-14,,,,,,,,,,,,,,,,,,,,,,,,,,,,36.1,67.5,31.4,,,,,,,134.3,152.6,18.3,,,,,,,,,,,,,0.5,2.6,2.1,,,,,,,,,,,,,75.9,93.4,17.5,,,,666.4,316.8,-349.6,,,,58.1,73,14.9,,,,,,,4.1,15.6,11.5,,,,243.2,182.7,-60.5,46.1,113.1,67,,,,35.3,10.5,-24.8,37.4,14.5,-22.9,,,,403.6,225.1,-178.5,,,,,,,,,,448.2,353.7,-94.5,858,702.3,-155.7,330.1,131.2,-198.9,,,,,,,273.6,191.5,-82.1,50.2,0.7,-49.5,,,,,,,1133.8,305,-828.8,,,,,,,1648.9,1102,-546.9,880.9,485.9,-395,1989,960.2,-1028.8,7773.5,3759.1,-4014.4,366,624.7,258.7,,,,,,,,,,,,,,,,57.9,91.8,33.9,,,,,,,,,,,,,,,,,,,,,,,,,,,,,,,,,,,,,,,,,,,,,,,,,,,,,,,,,,158.2,49.6,-108.6,,,,,,,28.4,220.7,192.3,,,,,,,,,,,,,,,,,,,,,,,,,,,,,,,4.4,9.5,5.1,,,,,,,,,,,,,423.6,38,-385.6,,,,62.7,2.9,-59.8,,,,,,,,,,,,,198.3,16.9,-181.4,31,0.9,-30.1,,,,,,,,,,,,,24.5,9.3,-15.2,,,,,,,,,,,,,,,,,,,,,,,,,,,,,,,,,,,,,,,,,,,,,,,,,,,,,,,130.4,120.3,-10.1,,,,,,,,,,,,,,,,,,,,,,,,,,,
1989-12-01,2665.7,1447.1,-1218.6,,,,38364,31522,-6842,,,,,,,5117.8,7794.9,2677.1,4936.8,3412.7,-1524.1,2429.9,1895.7,-534.2,8869.5,8023,-846.5,,,,,,,,,,37560.5,30874,-6686.5,16101.8,9763.9,-6337.9,,,,398.2,829.8,431.6,872.4,202,-670.4,,,,6811.3,5965.8,-845.5,,,,2058.2,2057.2,-1,53.1,52.1,-1,,,,14.1,32.2,18.1,37.4,37.4,0,,,,82.9,64.3,-18.6,15.6,44.2,28.6,,,,41.7,68.8,27.1,,,,49,74.5,25.5,,,,,,,31.2,35.7,4.5,137.9,131.9,-6,,,,,,,,,,,,,,,,,,,,,,,,,,,,,,,73.3,42.1,-31.2,25,44.9,19.9,,,,,,,,,,,,,,,,255.5,150.1,-105.4,634.8,232.2,-402.6,,,,,,,,,,74.8,41.5,-33.3,74,105.5,31.5,,,,83.3,115.2,31.9,635.2,512.7,-122.5,3.8,7.8,4,17.3,9,-8.3,90,93.6,3.59999999999999,,,,16.5,6.9,-9.6,401.9,282.3,-119.6,,,,134,78.3,-55.7,103.7,78.9,-24.8,,,,125.3,87.5,-37.8,1434.7,1665.2,230.5,135.9,204.2,68.3,388.2,957.1,568.9,317.6,745.4,427.8,,,,,,,,,,1043.1,1028.8,-14.3,2060.4,1442.8,-617.6,92.3,73.3,-19,,,,,,,,,,27.1,12.1,-15,,,,360.6,521,160.4,,,,,,,,,,29.9,28,-1.9,45.4,452.5,407.1,,,,,,,,,,,,,,,,,,,,,,,,,,,,,,,,,,,,,276.3,380.6,104.3,82.9,127.1,44.2,,,,,,,,,,,,,944.1,635.4,-308.7,56.3,29.4,-26.9,,,,,,,,,,,,,,,,,,,,,,,,,,,,28.1,53.2,25.1,,,,,,,147.8,198,50.2,,,,,,,,,,,,,0.7,10,9.3,,,,,,,,,,,,,56.2,100,43.8,,,,687.8,333.4,-354.4,,,,63,374.8,311.8,,,,,,,5.2,13.3,8.1,,,,186.5,159.1,-27.4,43.6,101.7,58.1,,,,39.2,8,-31.2,36.8,5.8,-31,,,,342,202.6,-139.4,,,,,,,,,,433.1,230.2,-202.9,850.3,695.1,-155.2,320.7,103.9,-216.8,,,,,,,243.9,139.5,-104.4,43.1,0.3,-42.8,,,,,,,951.5,424.4,-527.1,,,,,,,1490.8,1129.6,-361.2,749.5,496.6,-252.9,1846.2,1091.4,-754.8,7448.7,3904.1,-3544.6,320.7,625.7,305,,,,,,,,,,,,,,,,77.5,204.1,126.6,,,,,,,,,,,,,,,,,,,,,,,,,,,,,,,,,,,,,,,,,,,,,,,,,,,,,,,,,,144.6,85.6,-59,,,,,,,9.7,172.7,163,,,,,,,,,,,,,,,,,,,,,,,,,,,,,,,5.5,3.9,-1.6,,,,,,,,,,,,,448.7,32.6,-416.1,,,,64.3,3.8,-60.5,,,,,,,,,,,,,168.7,7.3,-161.4,40.4,1.4,-39,,,,,,,,,,,,,33.8,6.8,-27,,,,,,,,,,,,,,,,,,,,,,,,,,,,,,,,,,,,,,,,,,,,,,,,,,,,,,,111,146.2,35.2,,,,,,,,,,,,,,,,,,,,,,,,,,,
1990-01-01,3662.1,1023.6,-2638.5,,,,41380.4,31613.2,-9767.2,,,,,,,4574.6,6987.6,2413,5429.9,3245,-2184.9,2809.9,1744.9,-1065,9179.3,8508.8,-670.5,,,,,,,,,,40303.8,30664.1,-9639.7,16728.5,9625.9,-7102.6,,,,417.5,934.1,516.6,1155.5,211,-944.5,,,,6799,6377.5,-421.5,,,,2380.3,2131.3,-249,83.9,64.3,-19.6,,,,15.1,36.3,21.2,44.1,46.9,2.8,,,,79.2,73.6,-5.60000000000001,19.2,59.8,40.6,,,,63.4,91.2,27.8,,,,46.3,79.7,33.4,,,,,,,26.1,43.1,17,97.6,129.8,32.2,,,,,,,,,,,,,,,,,,,,,,,,,,,,,,,86.4,23.9,-62.5,22.1,37.8,15.7,,,,,,,,,,,,,,,,265.2,143,-122.2,770.6,156.2,-614.4,,,,,,,,,,115.9,45.7,-70.2,54.8,92.3,37.5,,,,132.7,130.3,-2.39999999999998,733.7,388.3,-345.4,5.1,10.7,5.6,17.2,11.6,-5.6,131.3,80.4,-50.9,,,,11.8,8.3,-3.5,339.6,207.3,-132.3,,,,129.4,88.5,-40.9,130,103.2,-26.8,,,,132.8,104.6,-28.2,1598.2,1601.4,3.20000000000005,127.6,206.4,78.8,414.1,1144.9,730.8,354.5,704.1,349.6,,,,,,,,,,1078.3,944.7,-133.6,2191.3,1439.7,-751.6,109.1,63.4,-45.7,,,,,,,,,,33.5,11.2,-22.3,,,,344.9,353.8,8.90000000000003,,,,,,,,,,29.7,38.9,9.2,118,408.2,290.2,,,,,,,,,,,,,,,,,,,,,,,,,,,,,,,,,,,,,276.6,400.1,123.5,69,72.2,3.2,,,,,,,,,,,,,1053.2,657.5,-395.7,67,31.9,-35.1,,,,,,,,,,,,,,,,,,,,,,,,,,,,86.3,66.4,-19.9,,,,,,,187.2,157,-30.2,,,,,,,,,,,,,0.1,1.7,1.6,,,,,,,,,,,,,141.5,58,-83.5,,,,774.1,281.7,-492.4,,,,77,109.1,32.1,,,,,,,6,19.8,13.8,,,,297.9,209.4,-88.5,54.3,117.5,63.2,,,,46.6,4.7,-41.9,52.1,21.5,-30.6,,,,403.6,217.7,-185.9,,,,,,,,,,434.9,252.3,-182.6,783.8,612.9,-170.9,311.3,188.6,-122.7,,,,,,,284.9,231.4,-53.5,52.7,0.4,-52.3,,,,,,,1186.1,361.2,-824.9,,,,,,,1618.8,1190.8,-428,956.4,440.4,-516,2070.9,1000.9,-1070,6878.2,4028,-2850.2,326.5,847.9,521.4,,,,,,,,,,,,,,,,91,86.2,-4.8,,,,,,,,,,,,,,,,,,,,,,,,,,,,,,,,,,,,,,,,,,,,,,,,,,,,,,,,,,379.8,61.2,-318.6,,,,,,,50.2,206.6,156.4,,,,,,,,,,,,,,,,,,,,,,,,,,,,,,,26.3,4.7,-21.6,,,,,,,,,,,,,628.9,27.4,-601.5,,,,80.5,1.6,-78.9,,,,,,,,,,,,,195.7,8.7,-187,38.6,0.8,-37.8,,,,,,,,,,,,,34.3,14.5,-19.8,,,,,,,,,,,,,,,,,,,,,,,,,,,,,,,,,,,,,,,,,,,,,,,,,,,,,,,151.2,153.3,2.10000000000002,,,,,,,,,,,,,,,,,,,,,,,,,,,
1990-02-01,2930.7,967.8,-1962.9,,,,39164.4,31709.6,-7454.8,,,,,,,4255.3,7802.3,3547,4078.9,3132.7,-946.2,2451.6,1849.1,-602.5,9250.9,8812.9,-438,,,,,,,,,,37111.9,30961.8,-6150.1,14918.5,9208.6,-5709.9,,,,505.3,632.8,127.5,917.2,201.1,-716.1,,,,6877.7,6749.7,-128,,,,2373.2,2063.2,-310,68.2,60.1,-8.1,,,,31.5,50.2,18.7,39.7,33.5,-6.2,,,,81.9,78.6,-3.30000000000001,21.4,57.8,36.4,,,,48.5,71.1,22.6,,,,44.1,63.8,19.7,,,,,,,30.6,34.8,4.2,134.2,139.7,5.5,,,,,,,,,,,,,,,,,,,,,,,,,,,,,,,71.7,36.6,-35.1,20.8,40.6,19.8,,,,,,,,,,,,,,,,239.6,131.2,-108.4,570.4,197.1,-373.3,,,,,,,,,,107.9,44.2,-63.7,54.5,81.7,27.2,,,,154.3,138.6,-15.7,601.4,482.6,-118.8,3.4,14.3,10.9,15.7,11.6,-4.1,111.8,81,-30.8,,,,17.9,5.2,-12.7,434.8,189.8,-245,,,,106.6,73.3,-33.3,83.3,103.3,20,,,,111.3,106,-5.3,1475.4,2015.5,540.1,119.8,191,71.2,387.2,1119,731.8,339,712.4,373.4,,,,,,,,,,919.1,1155.1,236,2112,1465.8,-646.2,100.7,63.5,-37.2,,,,,,,,,,25,6.1,-18.9,,,,379.3,398,18.7,,,,,,,,,,28.4,13.7,-14.7,86,385.1,299.1,,,,,,,,,,,,,,,,,,,,,,,,,,,,,,,,,,,,,225,494.3,269.3,57.2,79.2,22,,,,,,,,,,,,,1013.6,622.1,-391.5,54,83.4,29.4,,,,,,,,,,,,,,,,,,,,,,,,,,,,32.9,69,36.1,,,,,,,133.3,149.8,16.5,,,,,,,,,,,,,0.4,10.3,9.9,,,,,,,,,,,,,61.8,51.8,-10,,,,690.7,247.6,-443.1,,,,86.4,72.5,-13.9,,,,,,,5.4,20.4,15,,,,277.4,150.3,-127.1,63.3,82.4,19.1,,,,51.8,11.7,-40.1,43.1,14.7,-28.4,,,,341.9,315.1,-26.8,,,,,,,,,,402.3,255.7,-146.6,630.1,557.7,-72.4,340.7,96.3,-244.4,,,,,,,260.9,199.8,-61.1,48.9,0.5,-48.4,,,,,,,993.8,519.6,-474.2,,,,,,,1286.6,1052.4,-234.2,600,632.1,32.1,1562.2,890.5,-671.7,6911.3,3783.5,-3127.8,393.9,571.7,177.8,,,,,,,,,,,,,,,,111.4,61.1,-50.3,,,,,,,,,,,,,,,,,,,,,,,,,,,,,,,,,,,,,,,,,,,,,,,,,,,,,,,,,,225.4,75.8,-149.6,,,,,,,26.4,147.6,121.2,,,,,,,,,,,,,,,,,,,,,,,,,,,,,,,9.7,4.1,-5.6,,,,,,,,,,,,,495.7,53.7,-442,,,,36.6,5.1,-31.5,,,,,,,,,,,,,216.6,8.9,-207.7,33.4,1.8,-31.6,,,,,,,,,,,,,18.3,13.3,-5,,,,,,,,,,,,,,,,,,,,,,,,,,,,,,,,,,,,,,,,,,,,,,,,,,,,,,,106.9,114.2,7.3,,,,,,,,,,,,,,,,,,,,,,,,,,,
1990-03-01,3213.3,1322.5,-1890.8,,,,41830,33187.4,-8642.6,,,,,,,4929.4,8603.7,3674.3,4651.1,3744.2,-906.900000000001,2679.3,1928.7,-750.6,10911.6,10370,-541.6,,,,,,,,,,42339.3,35970.6,-6368.7,16514.4,10588.1,-5926.3,,,,400.1,810.8,410.7,1059.2,272.1,-787.1,,,,8275.2,8074.9,-200.300000000001,,,,2636.4,2295.1,-341.3,82.6,62.9,-19.7,,,,25.1,48.1,23,52,43.5,-8.5,,,,91.6,90.1,-1.5,17.9,65.9,48,,,,35,65.6,30.6,,,,44.4,84.6,40.2,,,,,,,31,37.6,6.6,148.6,149.2,0.599999999999994,,,,,,,,,,,,,,,,,,,,,,,,,,,,,,,63.8,33.8,-30,12.8,53.2,40.4,,,,,,,,,,,,,,,,264.7,245.4,-19.3,687.7,229.3,-458.4,,,,,,,,,,105.5,53.7,-51.8,55.2,71.6,16.4,,,,183.5,119.1,-64.4,644.9,378.3,-266.6,4.5,15.8,11.3,15.1,12.8,-2.3,113.4,68.2,-45.2,,,,12.5,8.2,-4.3,523.3,306,-217.3,,,,143.3,137.7,-5.60000000000002,133.1,86.5,-46.6,,,,143.6,106.1,-37.5,1659.7,2359.1,699.4,151.5,226.3,74.8,443.3,1174.6,731.3,420.6,877,456.4,,,,,,,,,,1101.5,1214.8,113.3,2645.4,1722.4,-923,114.4,140.8,26.4,,,,,,,,,,33.5,10.8,-22.7,,,,565.1,420.2,-144.9,,,,,,,,,,35.2,21.6,-13.6,74.7,415.8,341.1,,,,,,,,,,,,,,,,,,,,,,,,,,,,,,,,,,,,,235.8,464.4,228.6,71.8,81.6,9.8,,,,,,,,,,,,,1089,735.6,-353.4,61.8,36.2,-25.6,,,,,,,,,,,,,,,,,,,,,,,,,,,,72.7,75.6,2.89999999999999,,,,,,,110.3,179,68.7,,,,,,,,,,,,,0.3,2.1,1.8,,,,,,,,,,,,,66,77,11,,,,740.3,344.3,-396,,,,71.2,92.1,20.9,,,,,,,5.7,14.5,8.8,,,,296.3,227.5,-68.8,51.6,121.2,69.6,,,,64,7.8,-56.2,47.9,11.1,-36.8,,,,413.6,369.1,-44.5,,,,,,,,,,455.3,335.1,-120.2,791.5,663.2,-128.3,308.3,160.3,-148,,,,,,,271.6,224.5,-47.1,39,0.5,-38.5,,,,,,,931,376.1,-554.9,,,,,,,1399.5,1345,-54.5,646.3,554.5,-91.8,1813.8,1181.5,-632.3,7807.5,4236.3,-3571.2,292.9,733.4,440.5,,,,,,,,,,,,,,,,107.2,77.4,-29.8,,,,,,,,,,,,,,,,,,,,,,,,,,,,,,,,,,,,,,,,,,,,,,,,,,,,,,,,,,213.2,62.4,-150.8,,,,,,,33.6,204.1,170.5,,,,,,,,,,,,,,,,,,,,,,,,,,,,,,,21.4,4.5,-16.9,,,,,,,,,,,,,545.5,42.9,-502.6,,,,125.7,3.1,-122.6,,,,,,,,,,,,,185.9,6.7,-179.2,21.7,31.5,9.8,,,,,,,,,,,,,21.7,15.5,-6.2,,,,,,,,,,,,,,,,,,,,,,,,,,,,,,,,,,,,,,,,,,,,,,,,,,,,,,,137.3,167.9,30.6,,,,,,,,,,,,,,,,,,,,,,,,,,,
1990-04-01,2527.4,1055.1,-1472.3,,,,39796.9,32044.4,-7752.5,,,,,,,4692.7,7469.9,2777.2,4813.2,3315.6,-1497.6,2331.5,1711.8,-619.7,9643.7,9415.4,-228.300000000001,,,,,,,,,,39143.9,32617.1,-6526.8,16018.8,9053.9,-6964.9,,,,405,773.6,368.6,904.7,222,-682.7,,,,7463.4,7367.6,-95.7999999999993,,,,2180.3,2047.8,-132.5,62.1,56.4,-5.7,,,,22,42.5,20.5,39.4,36.6,-2.8,,,,77.6,77,-0.599999999999994,17.3,69.9,52.6,,,,35.4,57.5,22.1,,,,42.7,78.6,35.9,,,,,,,29,35.1,6.1,133.4,153.9,20.5,,,,,,,,,,,,,,,,,,,,,,,,,,,,,,,84.4,35.8,-48.6,25.1,52.3,27.2,,,,,,,,,,,,,,,,205.7,166.1,-39.6,551.5,236.1,-315.4,,,,,,,,,,84.2,52.7,-31.5,55.1,54.1,-1,,,,126,117.8,-8.2,638.4,302.2,-336.2,2.5,13.2,10.7,14.3,8.7,-5.6,85.4,65.3,-20.1,,,,15.7,89.3,73.6,453.1,291.1,-162,,,,162.9,108.1,-54.8,104.8,100.2,-4.59999999999999,,,,146.5,116.7,-29.8,1513.7,2063.6,549.9,146.3,218.2,71.9,378.8,1291.7,912.9,382.4,918,535.6,,,,,,,,,,1116,1084.5,-31.5,2371.7,1711.1,-660.6,115.4,73.8,-41.6,,,,,,,,,,25.8,18.3,-7.5,,,,450.5,415.8,-34.7,,,,,,,,,,31.5,28.1,-3.4,50.8,428.4,377.6,,,,,,,,,,,,,,,,,,,,,,,,,,,,,,,,,,,,,268.2,560.6,292.4,70.4,68.1,-2.30000000000001,,,,,,,,,,,,,1051.9,716.9,-335,59.5,27.3,-32.2,,,,,,,,,,,,,,,,,,,,,,,,,,,,34.9,62.8,27.9,,,,,,,77.8,205.8,128,,,,,,,,,,,,,0.3,1.7,1.4,,,,,,,,,,,,,32.5,55,22.5,,,,482.8,258.7,-224.1,,,,98.5,75.9,-22.6,,,,,,,10.2,33.7,23.5,,,,250.2,205.7,-44.5,53.9,63.4,9.5,,,,35.4,10.8,-24.6,35.4,17.7,-17.7,,,,388.3,218.6,-169.7,,,,,,,,,,396.7,253.3,-143.4,780.8,593.9,-186.9,248.4,165.5,-82.9,,,,,,,262.8,200.1,-62.7,46.6,1.1,-45.5,,,,,,,996.4,343.6,-652.8,,,,,,,1531.4,1131.8,-399.6,672.8,625,-47.8,1828.2,964.9,-863.3,7640.5,3598,-4042.5,304.2,696.2,392,,,,,,,,,,,,,,,,100.8,77.4,-23.4,,,,,,,,,,,,,,,,,,,,,,,,,,,,,,,,,,,,,,,,,,,,,,,,,,,,,,,,,,189.9,48,-141.9,,,,,,,36.8,188.5,151.7,,,,,,,,,,,,,,,,,,,,,,,,,,,,,,,39.7,5.1,-34.6,,,,,,,,,,,,,545.8,41.1,-504.7,,,,19.2,4.7,-14.5,,,,,,,,,,,,,115.1,15.8,-99.3,60.6,2.8,-57.8,,,,,,,,,,,,,21.6,8.5,-13.1,,,,,,,,,,,,,,,,,,,,,,,,,,,,,,,,,,,,,,,,,,,,,,,,,,,,,,,102.7,144,41.3,,,,,,,,,,,,,,,,,,,,,,,,,,,
1990-05-01,2856.6,1085.9,-1770.7,,,,40599.8,32511.2,-8088.6,,,,,,,4487.1,7626.3,3139.2,4946.4,3353.2,-1593.2,2686.6,1887.9,-798.7,10712,10416.9,-295.1,,,,,,,,,,40846.3,33538.7,-7307.60000000001,15677.5,9233.6,-6443.9,,,,462,688.9,226.9,990.8,209.7,-781.1,,,,8214.6,7933.3,-281.3,,,,2497.4,2483.6,-13.8000000000002,58.1,62.4,4.3,,,,18.7,39.8,21.1,51.5,42,-9.5,,,,87.8,94.3,6.5,18.1,80.4,62.3,,,,39.4,62.3,22.9,,,,42.5,70.9,28.4,,,,,,,32.1,45.3,13.2,166.6,157.3,-9.29999999999998,,,,,,,,,,,,,,,,,,,,,,,,,,,,,,,53.4,32.2,-21.2,24.2,46.6,22.4,,,,,,,,,,,,,,,,234.2,155,-79.2,687.2,261.4,-425.8,,,,,,,,,,95.2,57.4,-37.8,80.4,76.4,-4,,,,115.2,208.1,92.9,710,292.7,-417.3,3.3,18,14.7,18.6,10.1,-8.5,150.1,75.3,-74.8,,,,12.1,62.2,50.1,451.2,339.6,-111.6,,,,162.9,190,27.1,111,91.4,-19.6,,,,135.9,84.5,-51.4,1713.5,1966.3,252.8,146.8,197.6,50.8,450.4,1016.8,566.4,370.9,892.9,522,,,,,,,,,,1082.1,1022.3,-59.8,2377.1,1824.9,-552.2,110,64.5,-45.5,,,,,,,,,,24,11.5,-12.5,,,,493.6,449,-44.6,,,,,,,,,,29.7,32.8,3.1,47.5,343.7,296.2,,,,,,,,,,,,,,,,,,,,,,,,,,,,,,,,,,,,,302.1,469.1,167,69.2,127.8,58.6,,,,,,,,,,,,,1100.7,679.2,-421.5,77,40.6,-36.4,,,,,,,,,,,,,,,,,,,,,,,,,,,,66.2,73.2,7,,,,,,,63.9,266,202.1,,,,,,,,,,,,,0.6,4.2,3.6,,,,,,,,,,,,,33.8,58.9,25.1,,,,619.9,292.6,-327.3,,,,70.2,71.3,1.09999999999999,,,,,,,11.1,14.1,3,,,,275.8,211.2,-64.6,51.4,72.2,20.8,,,,36.2,16.4,-19.8,34.9,4.3,-30.6,,,,425,212.4,-212.6,,,,,,,,,,404,269.7,-134.3,726.1,602,-124.1,259.3,113.8,-145.5,,,,,,,262.2,244.4,-17.8,66.5,0.7,-65.8,,,,,,,1173.5,379.9,-793.6,,,,,,,1549.2,1133.5,-415.7,780.3,698,-82.3,1890.8,919.7,-971.1,6751.3,3675.5,-3075.8,367.1,613.3,246.2,,,,,,,,,,,,,,,,94.9,75.6,-19.3,,,,,,,,,,,,,,,,,,,,,,,,,,,,,,,,,,,,,,,,,,,,,,,,,,,,,,,,,,180.7,68.3,-112.4,,,,,,,28.1,179,150.9,,,,,,,,,,,,,,,,,,,,,,,,,,,,,,,51.7,9.1,-42.6,,,,,,,,,,,,,543.2,45.2,-498,,,,52.1,5.8,-46.3,,,,,,,,,,,,,97.7,11.1,-86.6,56.2,5.3,-50.9,,,,,,,,,,,,,21.4,11.1,-10.3,,,,,,,,,,,,,,,,,,,,,,,,,,,,,,,,,,,,,,,,,,,,,,,,,,,,,,,168.5,122.1,-46.4,,,,,,,,,,,,,,,,,,,,,,,,,,,
1990-06-01,2459,1169.5,-1289.5,,,,40687,33695.9,-6991.1,,,,,,,5021.4,8680.1,3658.7,5179.6,3752.3,-1427.3,2598.4,2020.8,-577.6,10787.7,10085.4,-702.300000000001,,,,,,,,,,40946.2,34470.2,-6476.00000000001,16395.6,10259.8,-6135.8,,,,515.6,747.8,232.2,763.8,230.9,-532.9,,,,8299.1,7553,-746.1,,,,2488.6,2532.4,43.8000000000002,62.4,63.3,0.899999999999999,,,,22.5,41.1,18.6,37.9,43.2,5.3,,,,81.9,84.4,2.5,27.1,74.7,47.6,,,,26.9,63.2,36.3,,,,58.4,72,13.6,,,,,,,27.6,39.6,12,155.8,151.4,-4.40000000000001,,,,,,,,,,,,,,,,,,,,,,,,,,,,,,,62.1,34.7,-27.4,25.6,39.1,13.5,,,,,,,,,,,,,,,,212.3,177.6,-34.7,653.4,292.2,-361.2,,,,,,,,,,109.6,63.3,-46.3,63.1,53.2,-9.9,,,,104.4,196.7,92.3,700.3,401.1,-299.2,5.9,28.1,22.2,18,9.1,-8.9,143.2,92.8,-50.4,,,,10.7,11.5,0.800000000000001,426,279.8,-146.2,,,,215.6,76.2,-139.4,103.9,70.7,-33.2,,,,136.9,192.9,56,1553.4,2207.1,653.7,144.7,219.8,75.1,401.4,955.4,554,331,820.3,489.3,,,,,,,,,,1120.3,1150.5,30.2,2236.6,1395.2,-841.4,97.6,65.5,-32.1,,,,,,,,,,29.1,10.3,-18.8,,,,459.8,469.9,10.1,,,,,,,,,,37.5,17.5,-20,59.8,424.1,364.3,,,,,,,,,,,,,,,,,,,,,,,,,,,,,,,,,,,,,336.5,538.2,201.7,80.1,97.3,17.2,,,,,,,,,,,,,1080.9,738.7,-342.2,59.8,27.1,-32.7,,,,,,,,,,,,,,,,,,,,,,,,,,,,42.7,66.9,24.2,,,,,,,93.3,171.2,77.9,,,,,,,,,,,,,0.7,14.3,13.6,,,,,,,,,,,,,56.6,55.5,-1.1,,,,462.1,273.6,-188.5,,,,62.8,73.7,10.9,,,,,,,5.6,13.4,7.8,,,,230.9,188.1,-42.8,43.5,115.5,72,,,,44.8,24.4,-20.4,36,2.2,-33.8,,,,436.5,194.7,-241.8,,,,,,,,,,411.8,309.5,-102.3,919.8,805.9,-113.9,247.3,152.4,-94.9,,,,,,,309.8,178.4,-131.4,70,0.3,-69.7,,,,,,,1317.2,504.5,-812.7,,,,,,,1599.5,1346.4,-253.1,802.3,653,-149.3,1858,947,-911,7220.1,4177.5,-3042.6,374.3,663.4,289.1,,,,,,,,,,,,,,,,141.3,84.4,-56.9,,,,,,,,,,,,,,,,,,,,,,,,,,,,,,,,,,,,,,,,,,,,,,,,,,,,,,,,,,171.4,126.4,-45,,,,,,,22.7,150,127.3,,,,,,,,,,,,,,,,,,,,,,,,,,,,,,,10.3,4.9,-5.4,,,,,,,,,,,,,402.1,47.4,-354.7,,,,27.2,3.7,-23.5,,,,,,,,,,,,,158.2,17.2,-141,10.2,1.5,-8.7,,,,,,,,,,,,,17.1,13.5,-3.6,,,,,,,,,,,,,,,,,,,,,,,,,,,,,,,,,,,,,,,,,,,,,,,,,,,,,,,138.7,142.7,4,,,,,,,,,,,,,,,,,,,,,,,,,,,
1990-07-01,2659.6,1040.5,-1619.1,,,,41315.8,32307.7,-9008.1,,,,,,,5115,7780.8,2665.8,5512.9,3122.4,-2390.5,2635.9,1893.5,-742.4,9356.2,8466.5,-889.700000000001,,,,,,,,,,41495.1,30736.2,-10758.9,17259.5,9747.3,-7512.2,,,,504.5,833.8,329.3,814.1,232.2,-581.9,,,,7046.3,6126.6,-919.7,,,,2309.9,2339.9,30,66.3,48.9,-17.4,,,,18.4,32.8,14.4,35.1,40.7,5.6,,,,84.3,79.8,-4.5,21.7,69.5,47.8,,,,31.1,61.9,30.8,,,,55.8,77,21.2,,,,,,,29,40.4,11.4,172.7,128.4,-44.3,,,,,,,,,,,,,,,,,,,,,,,,,,,,,,,54.6,38.8,-15.8,15.4,47.1,31.7,,,,,,,,,,,,,,,,223.8,166.4,-57.4,596.2,246.8,-349.4,,,,,,,,,,134.7,60.9,-73.8,83.3,67.4,-15.9,,,,92.4,147.4,55,767.7,411.7,-356,3.8,33.2,29.4,14.6,10.9,-3.7,135,83.5,-51.5,,,,18.2,6.6,-11.6,410.5,327.9,-82.6,,,,144,71.4,-72.6,94.6,58.6,-36,,,,161.4,92.9,-68.5,1611.2,1860.6,249.4,161.5,178,16.5,493.5,789.5,296,471.7,887.5,415.8,,,,,,,,,,1223.9,974.8,-249.1,2517.5,1498.5,-1019,117.1,57.7,-59.4,,,,,,,,,,33.2,7.4,-25.8,,,,522.7,385.9,-136.8,,,,,,,,,,41.4,21.8,-19.6,87.6,170.8,83.2,,,,,,,,,,,,,,,,,,,,,,,,,,,,,,,,,,,,,339.6,347.3,7.69999999999999,88.9,73.4,-15.5,,,,,,,,,,,,,1232.9,556.6,-676.3,83.5,36,-47.5,,,,,,,,,,,,,,,,,,,,,,,,,,,,30.9,63.9,33,,,,,,,96.3,219.6,123.3,,,,,,,,,,,,,1.5,14.5,13,,,,,,,,,,,,,17.8,45.7,27.9,,,,530,286.7,-243.3,,,,67.8,73.2,5.40000000000001,,,,,,,5.5,83.1,77.6,,,,284.1,264.3,-19.8,49.4,127.9,78.5,,,,54.4,7.5,-46.9,55.3,17.2,-38.1,,,,484.3,212.4,-271.9,,,,,,,,,,449.8,266.9,-182.9,842.9,628.9,-214,281.6,187.3,-94.3,,,,,,,307.6,173.9,-133.7,91.1,0.3,-90.8,,,,,,,1492.5,394.4,-1098.1,,,,,,,1719.3,1115,-604.3,932.2,502,-430.2,2018.5,876.5,-1142,7251.1,4207.8,-3043.3,387.1,755.5,368.4,,,,,,,,,,,,,,,,117.4,78.3,-39.1,,,,,,,,,,,,,,,,,,,,,,,,,,,,,,,,,,,,,,,,,,,,,,,,,,,,,,,,,,172.9,41.7,-131.2,,,,,,,35.2,113.8,78.6,,,,,,,,,,,,,,,,,,,,,,,,,,,,,,,7,2.6,-4.4,,,,,,,,,,,,,422.1,33.1,-389,,,,39.4,2.7,-36.7,,,,,,,,,,,,,157.5,8.2,-149.3,24.9,6.3,-18.6,,,,,,,,,,,,,34.8,12,-22.8,,,,,,,,,,,,,,,,,,,,,,,,,,,,,,,,,,,,,,,,,,,,,,,,,,,,,,,128.4,167.3,38.9,,,,,,,,,,,,,,,,,,,,,,,,,,,
1990-08-01,3540.1,1122.4,-2417.7,,,,41795.6,32557.2,-9238.4,,,,,,,4910.5,7558,2647.5,5630.3,3347.1,-2283.2,2914.8,2224.9,-689.9,9732.9,9266.9,-466,,,,,,,,,,42231.8,31722.9,-10508.9,18256.6,9673.2,-8583.4,,,,594.7,969.8,375.1,843.5,223,-620.5,,,,7162.2,6767.5,-394.7,,,,2570.7,2499.4,-71.2999999999997,79,68.9,-10.1,,,,17.4,70.7,53.3,42.2,109,66.8,,,,78.7,86.5,7.8,22,80.7,58.7,,,,36.7,72.3,35.6,,,,44,84.8,40.8,,,,,,,28.8,41.6,12.8,157.6,121.7,-35.9,,,,,,,,,,,,,,,,,,,,,,,,,,,,,,,106.5,38.6,-67.9,49.4,34.7,-14.7,,,,,,,,,,,,,,,,286.2,229.3,-56.9,762.5,277.8,-484.7,,,,,,,,,,149.2,59.6,-89.6,78.9,48.6,-30.3,,,,84.9,121.6,36.7,716.1,511.3,-204.8,5.5,33.6,28.1,24.2,19.9,-4.3,145,113.7,-31.3,,,,11.1,8.2,-2.9,240.4,220,-20.4,,,,169.2,68.3,-100.9,94.2,73.7,-20.5,,,,124.3,90.4,-33.9,1521.8,1666.3,144.5,125.6,211.2,85.6,427.1,1055.5,628.4,277,799.7,522.7,,,,,,,,,,956.3,1096.4,140.1,2492.2,1334.7,-1157.5,100.5,58.1,-42.4,,,,,,,,,,27.6,12.8,-14.8,,,,373.4,384.9,11.5,,,,,,,,,,33.8,96.8,63,74.6,50.7,-23.9,,,,,,,,,,,,,,,,,,,,,,,,,,,,,,,,,,,,,342.4,372.8,30.4,79.2,60.9,-18.3,,,,,,,,,,,,,1199.9,517.4,-682.5,75.9,43,-32.9,,,,,,,,,,,,,,,,,,,,,,,,,,,,46.6,59.4,12.8,,,,,,,82.3,148.6,66.3,,,,,,,,,,,,,0.5,21.1,20.6,,,,,,,,,,,,,131.1,1.5,-129.6,,,,890.7,355.5,-535.2,,,,75.8,78.3,2.5,,,,,,,6.2,86.7,80.5,,,,277.3,231.3,-46,50.6,118.1,67.5,,,,49.8,25.6,-24.2,55.1,5.5,-49.6,,,,485.9,242.5,-243.4,,,,,,,,,,490.5,255.8,-234.7,883.4,742.6,-140.8,272,136.9,-135.1,,,,,,,309.7,202,-107.7,88.4,0.9,-87.5,,,,,,,1568.6,408.4,-1160.2,,,,,,,1715.2,1183.3,-531.9,914.6,515.5,-399.1,2117.1,905.7,-1211.4,7629.3,3888.7,-3740.6,488.2,882,393.8,,,,,,,,,,,,,,,,106.5,87.8,-18.7,,,,,,,,,,,,,,,,,,,,,,,,,,,,,,,,,,,,,,,,,,,,,,,,,,,,,,,,,,190.2,135.8,-54.4,,,,,,,36.1,161.7,125.6,,,,,,,,,,,,,,,,,,,,,,,,,,,,,,,7.7,5.5,-2.2,,,,,,,,,,,,,493,43.7,-449.3,,,,47.5,4.3,-43.2,,,,,,,,,,,,,113,6.6,-106.4,13.6,3.9,-9.7,,,,,,,,,,,,,17.7,5,-12.7,,,,,,,,,,,,,,,,,,,,,,,,,,,,,,,,,,,,,,,,,,,,,,,,,,,,,,,151,154,3,,,,,,,,,,,,,,,,,,,,,,,,,,,
1990-09-01,3536.6,956.7,-2579.9,,,,41343.8,32311.6,-9032.2,,,,,,,4876.9,7991.4,3114.5,5116.3,3371.3,-1745,2838.5,1993.4,-845.1,10347.8,8770.1,-1577.7,,,,,,,,,,40601.5,31444.3,-9157.2,17051.2,9749.8,-7301.4,,,,487.2,746.7,259.5,952.5,236.9,-715.6,,,,7722.5,6385.8,-1336.7,,,,2625.3,2384.3,-241,50.2,68.4,18.2,,,,19,74.4,55.4,36.2,42.3,6.09999999999999,,,,82.8,81.5,-1.3,19.5,77.2,57.7,,,,40.4,55.8,15.4,,,,54.1,76.5,22.4,,,,,,,28.7,36.8,8.1,143.2,126.6,-16.6,,,,,,,,,,,,,,,,,,,,,,,,,,,,,,,72.9,34.8,-38.1,49.2,38.3,-10.9,,,,,,,,,,,,,,,,286.7,146.8,-139.9,912.1,283,-629.1,,,,,,,,,,128.4,62.2,-66.2,81.7,42.4,-39.3,,,,83.9,113.6,29.7,599.8,479,-120.8,6.2,35.9,29.7,18.1,13,-5.1,125.4,104.9,-20.5,,,,16.2,6.1,-10.1,331.2,397.8,66.6,,,,169.8,139.9,-29.9,90.5,77.8,-12.7,,,,134.3,114.5,-19.8,1656.7,1727.6,70.8999999999999,131.8,205.3,73.5,362.4,999.1,636.7,318.2,912,593.8,,,,,,,,,,963.7,1289.8,326.1,2022.7,1429.5,-593.2,101.7,66.9,-34.8,,,,,,,,,,23.4,7.9,-15.5,,,,528.1,294.5,-233.6,,,,,,,,,,34.3,24.7,-9.6,80.4,79.1,-1.30000000000001,,,,,,,,,,,,,,,,,,,,,,,,,,,,,,,,,,,,,168.7,373.9,205.2,43.9,53.2,9.3,,,,,,,,,,,,,724,653.6,-70.4,64.5,66.2,1.7,,,,,,,,,,,,,,,,,,,,,,,,,,,,19.7,42.8,23.1,,,,,,,61.2,148.1,86.9,,,,,,,,,,,,,0.5,8,7.5,,,,,,,,,,,,,27.7,0,-27.7,,,,989.1,288.2,-700.9,,,,55.5,61.1,5.6,,,,,,,4.8,50.9,46.1,,,,303.2,223,-80.2,42,72.6,30.6,,,,38.7,40.4,1.7,40.1,12.7,-27.4,,,,473.9,252.1,-221.8,,,,,,,,,,510.3,398.6,-111.7,871.7,794.5,-77.2,336.2,153.5,-182.7,,,,,,,293.8,198.6,-95.2,83.1,0.9,-82.2,,,,,,,1432.1,358.6,-1073.5,,,,,,,1517,1107.1,-409.9,825.3,596.6,-228.7,1902.3,873.1,-1029.2,7022.9,3999.6,-3023.3,401.4,654.5,253.1,,,,,,,,,,,,,,,,85.8,92.2,6.40000000000001,,,,,,,,,,,,,,,,,,,,,,,,,,,,,,,,,,,,,,,,,,,,,,,,,,,,,,,,,,271,57.4,-213.6,,,,,,,29.7,287.2,257.5,,,,,,,,,,,,,,,,,,,,,,,,,,,,,,,6.3,7.8,1.5,,,,,,,,,,,,,501.7,35.7,-466,,,,84.4,2.6,-81.8,,,,,,,,,,,,,147.3,11.3,-136,40.9,28.2,-12.7,,,,,,,,,,,,,41.5,8,-33.5,,,,,,,,,,,,,,,,,,,,,,,,,,,,,,,,,,,,,,,,,,,,,,,,,,,,,,,130.4,143.3,12.9,,,,,,,,,,,,,,,,,,,,,,,,,,,
1990-10-01,3619.1,1321.8,-2297.3,,,,43875.5,34492.6,-9382.9,,,,,,,5777.3,8098,2320.7,5695.5,3573.6,-2121.9,3298.5,2114.9,-1183.6,11769.1,10363.5,-1405.6,,,,,,,,,,47394.8,35310.3,-12084.5,19855.6,10670.6,-9185,,,,468.8,814,345.2,981.3,273.7,-707.6,,,,8701.4,7460.1,-1241.3,,,,3067.7,2903.4,-164.3,63.6,76.3,12.7,,,,21.6,43.6,22,39.9,44.4,4.5,,,,90.6,82.1,-8.5,18.2,78.1,59.9,,,,52.7,64.6,11.9,,,,50.7,75.7,25,,,,,,,28.6,45.6,17,154.8,140.6,-14.2,,,,,,,,,,,,,,,,,,,,,,,,,,,,,,,127.8,36.2,-91.6,54.9,43.8,-11.1,,,,,,,,,,,,,,,,377.1,152.2,-224.9,1133,288.3,-844.7,,,,,,,,,,140.7,61.5,-79.2,71.1,58.8,-12.3,,,,86.2,119.1,32.9,620.6,493.3,-127.3,3.6,54.6,51,22.2,13.3,-8.9,140.6,142.8,2.20000000000002,,,,11,8.1,-2.9,477.4,259.9,-217.5,,,,207.6,118.6,-89,126.5,99.7,-26.8,,,,156.8,96.3,-60.5,2131.2,2232.8,101.6,188,253.2,65.2,389.5,1089.9,700.4,416.3,926.6,510.3,,,,,,,,,,1407,1357.1,-49.9000000000001,2555,1633.8,-921.2,122.6,72.4,-50.2,,,,,,,,,,29.6,13.2,-16.4,,,,490.7,411,-79.7,,,,,,,,,,41.5,25.1,-16.4,150.5,84.1,-66.4,,,,,,,,,,,,,,,,,,,,,,,,,,,,,,,,,,,,,261.7,391.8,130.1,63.2,69.2,6,,,,,,,,,,,,,1120.3,668.9,-451.4,68.5,36.6,-31.9,,,,,,,,,,,,,,,,,,,,,,,,,,,,24.9,54.5,29.6,,,,,,,65.4,178.3,112.9,,,,,,,,,,,,,0.5,51.3,50.8,,,,,,,,,,,,,0,0,0,,,,1279.7,495.3,-784.4,,,,41.3,91,49.7,,,,,,,6.9,89.2,82.3,,,,310.9,229.1,-81.8,53.4,131.1,77.7,,,,42.2,12.7,-29.5,48.7,12.3,-36.4,,,,538.9,250.1,-288.8,,,,,,,,,,491.9,273.9,-218,880.4,704.5,-175.9,279.5,135.2,-144.3,,,,,,,320.8,271.9,-48.9,70.3,1,-69.3,,,,,,,1652.1,459,-1193.1,,,,,,,1732.2,1364,-368.2,1011.3,531.3,-480,2071.6,973.8,-1097.8,8721.2,4279.4,-4441.8,394.4,602.6,208.2,,,,,,,,,,,,,,,,74.4,211.4,137,,,,,,,,,,,,,,,,,,,,,,,,,,,,,,,,,,,,,,,,,,,,,,,,,,,,,,,,,,178.6,128.5,-50.1,,,,,,,32.8,212.5,179.7,,,,,,,,,,,,,,,,,,,,,,,,,,,,,,,3.9,19.5,15.6,,,,,,,,,,,,,539.1,54.6,-484.5,,,,24.6,7.9,-16.7,,,,,,,,,,,,,179,27.5,-151.5,37.7,3.4,-34.3,,,,,,,,,,,,,43.8,11.4,-32.4,,,,,,,,,,,,,,,,,,,,,,,,,,,,,,,,,,,,,,,,,,,,,,,,,,,,,,,153.2,149.4,-3.79999999999998,,,,,,,,,,,,,,,,,,,,,,,,,,,
1990-11-01,3819.6,1300.3,-2519.3,,,,43066.4,33581.1,-9485.3,,,,,,,5345.5,7490.4,2144.9,4974,3397.8,-1576.2,3076.2,2075.2,-1001,10784.1,9401.9,-1382.2,,,,,,,,,,43795.9,33267,-10528.9,18083,10467.8,-7615.2,,,,445.7,689,243.3,953.4,244.6,-708.8,,,,7995.1,6916.2,-1078.9,,,,2789,2485.7,-303.3,57.9,63.1,5.2,,,,13.1,33.2,20.1,36,40.3,4.3,,,,88.6,79.9,-8.69999999999999,15.4,73.9,58.5,,,,54.2,67.1,12.9,,,,38.8,101.3,62.5,,,,,,,27.8,43.5,15.7,156.1,147.6,-8.5,,,,,,,,,,,,,,,,,,,,,,,,,,,,,,,125,41.3,-83.7,55.4,54.3,-1.1,,,,,,,,,,,,,,,,290,139.3,-150.7,1199,306.1,-892.9,,,,,,,,,,91.5,58.4,-33.1,65.7,61.8,-3.90000000000001,,,,71,122.1,51.1,554.9,464.6,-90.3,3.4,30.4,27,14,10.6,-3.4,118.4,136.4,18,,,,9.4,10,0.6,464.8,281.3,-183.5,,,,131.1,117.4,-13.7,104.5,96.8,-7.7,,,,154.4,84.4,-70,1971.4,1855.6,-115.8,150.3,202.9,52.6,434.4,1209.6,775.2,372.6,954.5,581.9,,,,,,,,,,1140.4,1157.9,17.5,2341.2,1477.6,-863.6,126.4,63.4,-63,,,,,,,,,,29.5,30.6,1.1,,,,531.8,367.4,-164.4,,,,,,,,,,32.8,41.7,8.90000000000001,120.4,144.1,23.7,,,,,,,,,,,,,,,,,,,,,,,,,,,,,,,,,,,,,269.8,394.8,125,73.8,76.1,2.3,,,,,,,,,,,,,1149.9,670.1,-479.8,49.9,72.7,22.8,,,,,,,,,,,,,,,,,,,,,,,,,,,,30.1,60.3,30.2,,,,,,,145.1,189.3,44.2,,,,,,,,,,,,,0.6,24.7,24.1,,,,,,,,,,,,,0,0,0,,,,1422.7,439.5,-983.2,,,,100.9,78.2,-22.7,,,,,,,6.2,272.3,266.1,,,,213,183.8,-29.2,50.7,70.6,19.9,,,,36.7,7.5,-29.2,45.8,13.2,-32.6,,,,475.9,262.3,-213.6,,,,,,,,,,415.2,256.1,-159.1,852.6,640.8,-211.8,253,236.8,-16.2,,,,,,,263.7,174.1,-89.6,50,0.6,-49.4,,,,,,,1367.9,327.9,-1040,,,,,,,1490.5,1258.4,-232.1,806.6,529.3,-277.3,1824.3,969.3,-855,8105.5,4394.8,-3710.7,369.3,582.6,213.3,,,,,,,,,,,,,,,,76.4,106.4,30,,,,,,,,,,,,,,,,,,,,,,,,,,,,,,,,,,,,,,,,,,,,,,,,,,,,,,,,,,219.3,69.3,-150,,,,,,,36.8,180.3,143.5,,,,,,,,,,,,,,,,,,,,,,,,,,,,,,,8.3,5.5,-2.8,,,,,,,,,,,,,419.7,73.8,-345.9,,,,110.7,2.4,-108.3,,,,,,,,,,,,,174.1,6.5,-167.6,28.5,2.5,-26,,,,,,,,,,,,,21.4,17,-4.4,,,,,,,,,,,,,,,,,,,,,,,,,,,,,,,,,,,,,,,,,,,,,,,,,,,,,,,190.7,136.9,-53.8,,,,,,,,,,,,,,,,,,,,,,,,,,,
1990-12-01,3227.7,1336.4,-1891.3,,,,39986.1,33800.3,-6185.8,,,,,,,5468.1,8628.1,3160,4545.3,3379.1,-1166.2,2865.4,2067.4,-798,9061.6,8074.5,-987.1,,,,,,,,,,39100.1,32889,-6211.1,16520.6,10128.4,-6392.2,,,,437.3,1031.5,594.2,886.5,234.7,-651.8,,,,6823.6,5961.6,-862,,,,2238,2112.9,-125.1,60,68.6,8.59999999999999,,,,13.2,41,27.8,36.8,41.6,4.8,,,,80.2,78.7,-1.5,16.1,80.8,64.7,,,,45.8,67.7,21.9,,,,47.1,77.7,30.6,,,,,,,23.7,33.1,9.4,131.2,109.7,-21.5,,,,,,,,,,,,,,,,,,,,,,,,,,,,,,,111.3,41.8,-69.5,74.2,55.3,-18.9,,,,,,,,,,,,,,,,282,176.9,-105.1,955.8,333.9,-621.9,,,,,,,,,,112.9,58.6,-54.3,57.9,64.2,6.3,,,,78,129.5,51.5,610.3,442.6,-167.7,3.2,19,15.8,13.9,12.5,-1.4,111.8,134.2,22.4,,,,16.8,7.9,-8.9,385,304,-81,,,,87.6,91.3,3.7,86.1,164,77.9,,,,139.5,121.5,-18,1782.1,1934.6,152.5,161.4,229.6,68.2,369.5,1176.1,806.6,320.9,912.4,591.5,,,,,,,,,,1044.8,1216.5,171.7,2299.3,1826.7,-472.6,103,84.7,-18.3,,,,,,,,,,33.4,16.3,-17.1,,,,447.1,592.2,145.1,,,,,,,,,,32.6,43.6,11,108.6,152.9,44.3,,,,,,,,,,,,,,,,,,,,,,,,,,,,,,,,,,,,,284.8,405.4,120.6,65.1,63.4,-1.7,,,,,,,,,,,,,935.2,775.3,-159.9,54.7,64,9.3,,,,,,,,,,,,,,,,,,,,,,,,,,,,20.8,68.5,47.7,,,,,,,66.3,230.7,164.4,,,,,,,,,,,,,0.8,8.6,7.8,,,,,,,,,,,,,0.4,0,-0.4,,,,1138.7,485.7,-653,,,,82,127.3,45.3,,,,,,,7.5,23.2,15.7,,,,179.8,162.5,-17.3,45.5,50.3,4.8,,,,38.3,12,-26.3,43.3,4.9,-38.4,,,,420.8,248.2,-172.6,,,,,,,,,,409.3,298.2,-111.1,837.5,675.7,-161.8,203.4,170.6,-32.8,,,,,,,236.1,171.6,-64.5,29.2,0.3,-28.9,,,,,,,1126.2,373.2,-753,,,,,,,1326.2,1176.5,-149.7,673.4,539,-134.4,1708.2,987.9,-720.3,7745.1,4310.4,-3434.7,347.3,934.6,587.3,,,,,,,,,,,,,,,,90,96.9,6.90000000000001,,,,,,,,,,,,,,,,,,,,,,,,,,,,,,,,,,,,,,,,,,,,,,,,,,,,,,,,,,233.1,76.7,-156.4,,,,,,,29.6,217.7,188.1,,,,,,,,,,,,,,,,,,,,,,,,,,,,,,,7.6,5.4,-2.2,,,,,,,,,,,,,445.3,54.6,-390.7,,,,53.2,5,-48.2,,,,,,,,,,,,,163.5,23.2,-140.3,47.1,1.6,-45.5,,,,,,,,,,,,,31.4,8.4,-23,,,,,,,,,,,,,,,,,,,,,,,,,,,,,,,,,,,,,,,,,,,,,,,,,,,,,,,138.4,136.5,-1.90000000000001,,,,,,,,,,,,,,,,,,,,,,,,,,,
1991-01-01,3239.1,1260.5,-1978.6,,,,41282.2,34290,-6992.2,,,,,,,4487.6,7756,3268.4,4966.7,3971.3,-995.4,2894,1908.5,-985.5,9696.4,9195.9,-500.5,,,,,,,,,,40243.7,33165,-7078.7,17159.8,10512,-6647.8,,,,470.7,680.4,209.7,921.6,368,-553.6,,,,7220.2,6800.8,-419.4,,,,2476.2,2395.1,-81.0999999999999,97.6,69.1,-28.5,,,,28.4,30.7,2.3,39.7,34.8,-4.90000000000001,,,,80,81.5,1.5,19,69.2,50.2,,,,37,62.2,25.2,,,,37.6,76.7,39.1,,,,,,,15,34.2,19.2,102.2,107,4.8,,,,,,,,,,,,,,,,,,,,,,,,,,,,,,,68.8,32.2,-36.6,98.1,41.7,-56.4,,,,,,,,,,,,,,,,283.5,168.9,-114.6,871.1,284.7,-586.4,,,,,,,,,,97,70.1,-26.9,52.5,73.7,21.2,,,,146.3,183.4,37.1,679.5,346.3,-333.2,3.4,19.1,15.7,12.4,10.4,-2,124.9,112.6,-12.3,,,,17.4,6.9,-10.5,413.2,255,-158.2,,,,110.9,82,-28.9,87.2,76,-11.2,,,,146.7,103.3,-43.4,1537.4,1829.9,292.5,140.8,238.4,97.6,308.4,1089.8,781.4,330.7,903.7,573,,,,,,,,,,1050,1228.8,178.8,2141.5,1636.4,-505.1,118.7,70.7,-48,,,,,,,,,,39,10.6,-28.4,,,,397.3,362.3,-35,,,,,,,,,,27.4,27.7,0.300000000000001,56.2,218.6,162.4,,,,,,,,,,,,,,,,,,,,,,,,,,,,,,,,,,,,,249.9,439.8,189.9,73,70.7,-2.3,,,,,,,,,,,,,955.6,638.5,-317.1,67.7,35.6,-32.1,,,,,,,,,,,,,,,,,,,,,,,,,,,,24.8,61.5,36.7,,,,,,,145.1,217.4,72.3,,,,,,,,,,,,,0.6,11.4,10.8,,,,,,,,,,,,,0,0,0,,,,1213.7,502.5,-711.2,,,,78.7,82.9,4.2,,,,,,,3.5,13.8,10.3,,,,269.6,226.5,-43.1,58.5,72.2,13.7,,,,44,12.1,-31.9,55.2,7.8,-47.4,,,,501.5,383.7,-117.8,,,,,,,,,,442.3,319.2,-123.1,786.3,804,17.7,232.7,171.9,-60.8,,,,,,,289.6,183.4,-106.2,42.1,0.4,-41.7,,,,,,,1321.6,406,-915.6,,,,,,,1504.7,1448.1,-56.6000000000001,798.8,715,-83.8,1876.9,1004.2,-872.7,7344.1,3805.6,-3538.5,377.2,599.2,222,,,,,,,,,,,,,,,,93.5,81.2,-12.3,,,,,,,,,,,,,,,,,,,,,,,,,,,,,,,,,,,,,,,,,,,,,,,,,,,,,,,,,,256.8,62.7,-194.1,,,,,,,15.8,218.3,202.5,,,,,,,,,,,,,,,,,,,,,,,,,,,,,,,9.3,6.7,-2.6,,,,,,,,,,,,,428.2,54.4,-373.8,,,,58.6,3.8,-54.8,,,,,,,,,,,,,152.1,9.4,-142.7,57.2,4.8,-52.4,,,,,,,,,,,,,47.5,4.1,-43.4,,,,,,,,,,,,,,,,,,,,,,,,,,,,,,,,,,,,,,,,,,,,,,,,,,,,,,,168.7,284.8,116.1,,,,,,,,,,,,,,,,,,,,,,,,,,,
1991-02-01,2487.2,1260.8,-1226.4,,,,39411.9,33637.2,-5774.7,,,,,,,4650.4,7227.1,2576.7,4172.2,3636.4,-535.8,2329.3,1865,-464.3,9062.4,8786.7,-275.699999999999,,,,,,,,,,36975.9,32774.7,-4201.2,15657.7,10471.4,-5186.3,,,,379,765.1,386.1,786.1,220.4,-565.7,,,,6868.2,6422.5,-445.7,,,,2194.2,2364.2,170,69.8,59.9,-9.9,,,,28.7,37.4,8.7,45,39.7,-5.3,,,,97,73.9,-23.1,24.1,75.7,51.6,,,,33.7,50.5,16.8,,,,47.1,82,34.9,,,,,,,22.2,29.9,7.7,155.2,118.2,-37,,,,,,,,,,,,,,,,,,,,,,,,,,,,,,,78.2,28.1,-50.1,22.6,35.9,13.3,,,,,,,,,,,,,,,,193.6,141.9,-51.7,575.2,317.5,-257.7,,,,,,,,,,93.4,65.2,-28.2,51.7,48.1,-3.6,,,,128.7,121.3,-7.39999999999999,542.8,393.3,-149.5,2,24.5,22.5,12.2,16.6,4.4,106.1,105.4,-0.699999999999989,,,,9.5,8.1,-1.4,354.1,228.2,-125.9,,,,124.2,100.4,-23.8,86.7,70.2,-16.5,,,,125,80.3,-44.7,1388.2,1672.2,284,140,222.2,82.2,333.2,1172.7,839.5,298.6,960.4,661.8,,,,,,,,,,1016.7,1319.5,302.8,2164.7,1658.9,-505.8,91.4,125.8,34.4,,,,,,,,,,29,14.8,-14.2,,,,446.5,462.5,16,,,,,,,,,,26.6,30.1,3.5,65.9,388.9,323,,,,,,,,,,,,,,,,,,,,,,,,,,,,,,,,,,,,,245,424.9,179.9,58.6,68.6,9.99999999999999,,,,,,,,,,,,,965,660.8,-304.2,62.9,40.5,-22.4,,,,,,,,,,,,,,,,,,,,,,,,,,,,18.3,66.8,48.5,,,,,,,92.5,164.3,71.8,,,,,,,,,,,,,0.1,88.3,88.2,,,,,,,,,,,,,0,0,0,,,,787.2,395.5,-391.7,,,,54.8,88.7,33.9,,,,,,,7.8,8.4,0.600000000000001,,,,236,228.4,-7.59999999999999,57.1,76.8,19.7,,,,50.4,13.5,-36.9,44.1,10,-34.1,,,,414.5,258.8,-155.7,,,,,,,,,,386.2,285,-101.2,689.8,767.3,77.5,245.4,176,-69.4,,,,,,,241.7,160.8,-80.9,34.9,1.2,-33.7,,,,,,,1253.7,487.6,-766.1,,,,,,,1175.5,1236.2,60.7,617.3,597.7,-19.5999999999999,1689.6,1035.2,-654.4,7420.3,4266.5,-3153.8,285.1,700.3,415.2,,,,,,,,,,,,,,,,93.9,64.8,-29.1,,,,,,,,,,,,,,,,,,,,,,,,,,,,,,,,,,,,,,,,,,,,,,,,,,,,,,,,,,217.6,71.3,-146.3,,,,,,,11.2,155.1,143.9,,,,,,,,,,,,,,,,,,,,,,,,,,,,,,,10.2,9.5,-0.699999999999999,,,,,,,,,,,,,407.6,51.1,-356.5,,,,104,2.8,-101.2,,,,,,,,,,,,,94.8,16.3,-78.5,4.1,1.1,-3,,,,,,,,,,,,,20.8,5.2,-15.6,,,,,,,,,,,,,,,,,,,,,,,,,,,,,,,,,,,,,,,,,,,,,,,,,,,,,,,144.6,134.4,-10.2,,,,,,,,,,,,,,,,,,,,,,,,,,,
1991-03-01,2462,1605.5,-856.5,,,,38896.7,34411.7,-4485,,,,,,,5350.4,9120.3,3769.9,4090.1,3875.3,-214.8,2339.7,2090,-249.7,9932.2,9361.1,-571.1,,,,,,,,,,38708.3,36819.8,-1888.5,16023,11053.1,-4969.9,,,,390,660.8,270.8,708.1,266,-442.1,,,,7523,7008.1,-514.9,,,,2409.2,2353,-56.1999999999998,78.9,67.2,-11.7,,,,24.6,45.5,20.9,44,49.4,5.4,,,,103.3,85.3,-18,22.2,80.3,58.1,,,,36.6,55.1,18.5,,,,46.2,73.3,27.1,,,,,,,29.6,39.5,9.9,142.8,143.4,0.599999999999994,,,,,,,,,,,,,,,,,,,,,,,,,,,,,,,72.1,40.4,-31.7,34.1,62.2,28.1,,,,,,,,,,,,,,,,199.5,153.3,-46.2,636.8,358.6,-278.2,,,,,,,,,,107.2,81.4,-25.8,53.3,66.9,13.6,,,,139.8,129.4,-10.4,448.8,416.8,-32,2.5,28.7,26.2,13.4,9.8,-3.6,104,103.5,-0.5,,,,12.3,11.1,-1.2,403.4,373.4,-30,,,,100.8,130.8,30,88.5,92.1,3.59999999999999,,,,144.6,195.1,50.5,1503.7,2228.8,725.1,130.2,304.5,174.3,388.3,1208.8,820.5,347.7,1101.8,754.1,,,,,,,,,,1122.6,1572.1,449.5,2302.5,1918.6,-383.9,109.7,125.4,15.7,,,,,,,,,,31.6,15.4,-16.2,,,,484.6,644,159.4,,,,,,,,,,29,41.5,12.5,121.6,511.6,390,,,,,,,,,,,,,,,,,,,,,,,,,,,,,,,,,,,,,229.4,605.4,376,54.2,74.5,20.3,,,,,,,,,,,,,967.7,844.3,-123.4,56.6,35,-21.6,,,,,,,,,,,,,,,,,,,,,,,,,,,,24.5,76.2,51.7,,,,,,,81.4,274.9,193.5,,,,,,,,,,,,,0.2,32.9,32.7,,,,,,,,,,,,,0,38.1,38.1,,,,850.3,622.4,-227.9,,,,50.2,121.6,71.4,,,,,,,3.9,12,8.1,,,,269.6,211.9,-57.7,47.2,67.3,20.1,,,,59.4,16.5,-42.9,50.3,5.4,-44.9,,,,445.8,267.5,-178.3,,,,,,,,,,419.5,318.7,-100.8,794.5,850.2,55.7,246.9,191.7,-55.2,,,,,,,267.7,197.6,-70.1,26.3,1.2,-25.1,,,,,,,974.3,472.3,-502,,,,,,,1231.2,1356.8,125.6,538.9,623.8,84.9,1525.5,1044.5,-481,7925,4259.6,-3665.4,288.1,588.6,300.5,,,,,,,,,,,,,,,,101.9,72.2,-29.7,,,,,,,,,,,,,,,,,,,,,,,,,,,,,,,,,,,,,,,,,,,,,,,,,,,,,,,,,,185.5,80,-105.5,,,,,,,11.7,245.2,233.5,,,,,,,,,,,,,,,,,,,,,,,,,,,,,,,24.3,5.5,-18.8,,,,,,,,,,,,,350.4,58.4,-292,,,,32,7.1,-24.9,,,,,,,,,,,,,106.7,10.5,-96.2,14.7,3.4,-11.3,,,,,,,,,,,,,25.8,10.3,-15.5,,,,,,,,,,,,,,,,,,,,,,,,,,,,,,,,,,,,,,,,,,,,,,,,,,,,,,,154.2,170.8,16.6,,,,,,,,,,,,,,,,,,,,,,,,,,,
1991-04-01,2499.1,1622.2,-876.9,,,,39769.4,35302.6,-4466.8,,,,,,,5054.8,8618.9,3564.1,4407,3647.1,-759.9,2635.9,2236.8,-399.1,10523.4,10345.9,-177.5,,,,,,,,,,39547.7,36137,-3410.7,15641,10552.9,-5088.1,,,,454.8,673.5,218.7,924.4,270.7,-653.7,,,,7844.5,7587.1,-257.4,,,,2678.9,2758.8,79.9000000000001,76.2,62.3,-13.9,,,,24.8,34.1,9.3,44.5,50.4,5.9,,,,91.4,71.4,-20,30.8,72,41.2,,,,85.4,57.3,-28.1,,,,37.9,75,37.1,,,,,,,27.3,43,15.7,163.4,142.3,-21.1,,,,,,,,,,,,,,,,,,,,,,,,,,,,,,,71.1,45.4,-25.7,57.4,45.5,-11.9,,,,,,,,,,,,,,,,215.6,168.9,-46.7,571.7,400.6,-171.1,,,,,,,,,,107.3,84.9,-22.4,72.5,73.8,1.3,,,,146,136.7,-9.30000000000001,684.9,465.7,-219.2,2.7,33.5,30.8,14.9,35.8,20.9,110.1,138.2,28.1,,,,26.1,45.6,19.5,419.4,314.4,-105,,,,125.5,130.5,5,97.8,81.9,-15.9,,,,138.8,131.2,-7.60000000000002,1532,1909.8,377.8,130.6,229.7,99.1,376.6,1125.8,749.2,390.9,967.9,577,,,,,,,,,,1148.7,1406.2,257.5,2285.8,2298.8,13,129.1,77.8,-51.3,,,,,,,,,,27.3,45.7,18.4,,,,488,585.4,97.4,,,,,,,,,,29.8,51.5,21.7,54.2,298.5,244.3,,,,,,,,,,,,,,,,,,,,,,,,,,,,,,,,,,,,,254.6,471.6,217,51.2,65.1,13.9,,,,,,,,,,,,,933.6,735,-198.6,55.6,26.5,-29.1,,,,,,,,,,,,,,,,,,,,,,,,,,,,44.5,68.5,24,,,,,,,61.5,214.8,153.3,,,,,,,,,,,,,0.2,65.7,65.5,,,,,,,,,,,,,0.1,97.9,97.8,,,,831.8,578.8,-253,,,,42.3,93.8,51.5,,,,,,,5,18.5,13.5,,,,295.2,192.4,-102.8,52.9,111,58.1,,,,34.1,14.1,-20,40.4,12.7,-27.7,,,,447.2,303.6,-143.6,,,,,,,,,,434.2,261.4,-172.8,781.1,654.2,-126.9,219.4,152.2,-67.2,,,,,,,251.3,182.5,-68.8,27.2,1,-26.2,,,,,,,1104.2,440.3,-663.9,,,,,,,1319.6,1250.3,-69.3,597,751.2,154.2,1709.3,991.4,-717.9,7178.9,3925.6,-3253.3,338.1,599.6,261.5,,,,,,,,,,,,,,,,116.7,73.9,-42.8,,,,,,,,,,,,,,,,,,,,,,,,,,,,,,,,,,,,,,,,,,,,,,,,,,,,,,,,,,190,57.3,-132.7,,,,,,,10.9,226.5,215.6,,,,,,,,,,,,,,,,,,,,,,,,,,,,,,,31.6,6.7,-24.9,,,,,,,,,,,,,460.2,60.9,-399.3,,,,74,21.3,-52.7,,,,,,,,,,,,,150.8,13.2,-137.6,31.5,1.2,-30.3,,,,,,,,,,,,,21,4.8,-16.2,,,,,,,,,,,,,,,,,,,,,,,,,,,,,,,,,,,,,,,,,,,,,,,,,,,,,,,155.3,162.6,7.29999999999998,,,,,,,,,,,,,,,,,,,,,,,,,,,
1991-05-01,2934.6,1567,-1367.6,,,,40256,35109.7,-5146.3,,,,,,,5130.9,8213.1,3082.2,4674.2,3864,-810.2,2638.9,2386.4,-252.5,10697.9,10500.1,-197.799999999999,,,,,,,,,,40181.3,36023.6,-4157.7,15966,11068.8,-4897.2,,,,468.7,653.5,184.8,905,239.5,-665.5,,,,8055.9,7662.1,-393.799999999999,,,,2642,2838,196,70.1,81.7,11.6,,,,26.2,43.9,17.7,42.1,54.4,12.3,,,,95.3,98.6,3.3,28.4,74.4,46,,,,31.2,62.9,31.7,,,,60.3,91.9,31.6,,,,,,,29.4,41.1,11.7,186.9,170.7,-16.2,,,,,,,,,,,,,,,,,,,,,,,,,,,,,,,69.5,37.4,-32.1,58.6,47.2,-11.4,,,,,,,,,,,,,,,,218.2,175,-43.2,686,402.7,-283.3,,,,,,,,,,130.9,83.7,-47.2,66.1,73.9,7.80000000000001,,,,102.8,130.5,27.7,546.3,494.3,-51.9999999999999,3.8,43.9,40.1,63.6,16.4,-47.2,123.2,161.8,38.6,,,,21.8,16.8,-5,378.9,238.3,-140.6,,,,171.4,95.1,-76.3,99.2,75.1,-24.1,,,,143.2,126.2,-17,1705.8,1872.2,166.4,160.7,248.1,87.4,408.2,1342.6,934.4,344.9,886.7,541.8,,,,,,,,,,1081,1200.5,119.5,2193.2,1778.7,-414.5,107.6,108.5,0.900000000000006,,,,,,,,,,27.8,13.8,-14,,,,491.9,490.6,-1.29999999999995,,,,,,,,,,32.9,46.6,13.7,84.4,156.5,72.1,,,,,,,,,,,,,,,,,,,,,,,,,,,,,,,,,,,,,256.9,355.5,98.6,58.3,58.2,-0.0999999999999943,,,,,,,,,,,,,964,777.5,-186.5,51.5,45.4,-6.1,,,,,,,,,,,,,,,,,,,,,,,,,,,,85.8,59.5,-26.3,,,,,,,47,256.5,209.5,,,,,,,,,,,,,0.3,29.2,28.9,,,,,,,,,,,,,0.1,126.8,126.7,,,,1079.4,512.4,-567,,,,66.2,139.2,73,,,,,,,3.6,23.8,20.2,,,,248,139.3,-108.7,43.3,79.7,36.4,,,,31.1,7.3,-23.8,38.8,4,-34.8,,,,435.7,350.2,-85.5,,,,,,,,,,443.2,287,-156.2,737.6,810.6,73,242.4,140.9,-101.5,,,,,,,262.4,191.9,-70.5,32.8,0.6,-32.2,,,,,,,1380.8,625.3,-755.5,,,,,,,1423.5,1353,-70.5,679.6,648.8,-30.8000000000001,1833.5,1051.6,-781.9,6711.3,4227.7,-2483.6,341.4,584.6,243.2,,,,,,,,,,,,,,,,127.3,68.9,-58.4,,,,,,,,,,,,,,,,,,,,,,,,,,,,,,,,,,,,,,,,,,,,,,,,,,,,,,,,,,195.2,61,-134.2,,,,,,,15.8,214.4,198.6,,,,,,,,,,,,,,,,,,,,,,,,,,,,,,,16.4,3.1,-13.3,,,,,,,,,,,,,482.9,54,-428.9,,,,49.6,7.9,-41.7,,,,,,,,,,,,,134.9,15.9,-119,10.1,1.9,-8.2,,,,,,,,,,,,,32.6,3.5,-29.1,,,,,,,,,,,,,,,,,,,,,,,,,,,,,,,,,,,,,,,,,,,,,,,,,,,,,,,178.5,153.2,-25.3,,,,,,,,,,,,,,,,,,,,,,,,,,,
1991-06-01,2602.6,1503.4,-1099.2,,,,39842.7,34926.2,-4916.5,,,,,,,5315.1,9038.3,3723.2,4864,3892.1,-971.9,2354.6,2282.4,-72.1999999999998,10427.8,10283.8,-144,,,,,,,,,,39428.2,35479.8,-3948.39999999999,16600.8,10872.2,-5728.6,,,,523,896.7,373.7,861,396.6,-464.4,,,,7854.6,7422.9,-431.700000000001,,,,2573.2,2860.9,287.7,62.3,75.6,13.3,,,,17.4,32.4,15,41.7,49.4,7.7,,,,92.7,83.3,-9.40000000000001,24.2,70.2,46,,,,26.9,55,28.1,,,,52.5,92.1,39.6,,,,,,,28,39.8,11.8,168.7,147.2,-21.5,,,,,,,,,,,,,,,,,,,,,,,,,,,,,,,69.2,40.3,-28.9,47.6,39.3,-8.3,,,,,,,,,,,,,,,,200.2,147.8,-52.4,598.5,422.4,-176.1,,,,,,,,,,132.8,73,-59.8,58.6,68.7,10.1,,,,70.5,183.1,112.6,528.2,458.6,-69.6,3.9,25.9,22,16.5,17.7,1.2,114.2,160.6,46.4,,,,20.5,16,-4.5,392.8,250.5,-142.3,,,,160.5,79.8,-80.7,74.1,47,-27.1,,,,144.2,164.4,20.2,1478.6,1994.4,515.8,172.2,174.1,1.90000000000001,338.4,993.9,655.5,288,851.5,563.5,,,,,,,,,,1136,1187.2,51.2,1919.4,1797.6,-121.8,99.2,77.3,-21.9,,,,,,,,,,23.4,71.8,48.4,,,,437,477.7,40.7,,,,,,,,,,30.2,35.1,4.9,29.9,117.8,87.9,,,,,,,,,,,,,,,,,,,,,,,,,,,,,,,,,,,,,228.4,546.1,317.7,49.3,83,33.7,,,,,,,,,,,,,975.4,788,-187.4,50.2,37.1,-13.1,,,,,,,,,,,,,,,,,,,,,,,,,,,,31.1,54.7,23.6,,,,,,,47.6,175.8,128.2,,,,,,,,,,,,,13.8,46.9,33.1,,,,,,,,,,,,,0,99.7,99.7,,,,834.9,488.4,-346.5,,,,72.4,121.5,49.1,,,,,,,15.7,13.5,-2.2,,,,244.7,118.2,-126.5,45.2,65.6,20.4,,,,37.6,8.2,-29.4,40.9,4.2,-36.7,,,,496.4,344.9,-151.5,,,,,,,,,,527.3,533.8,6.5,889.9,915.9,26,272.8,121,-151.8,,,,,,,288.5,188.7,-99.8,43.2,0.6,-42.6,,,,,,,1525.5,530.2,-995.3,,,,,,,1370.2,1176.5,-193.7,736.1,610.8,-125.3,1867.8,1188.9,-678.9,6997,3976.2,-3020.8,398.2,737.7,339.5,,,,,,,,,,,,,,,,124.8,159,34.2,,,,,,,,,,,,,,,,,,,,,,,,,,,,,,,,,,,,,,,,,,,,,,,,,,,,,,,,,,147.2,26.8,-120.4,,,,,,,13.8,200,186.2,,,,,,,,,,,,,,,,,,,,,,,,,,,,,,,23.2,3,-20.2,,,,,,,,,,,,,493.1,85.4,-407.7,,,,29.1,7.6,-21.5,,,,,,,,,,,,,127.1,17,-110.1,16,3.8,-12.2,,,,,,,,,,,,,22.8,8.5,-14.3,,,,,,,,,,,,,,,,,,,,,,,,,,,,,,,,,,,,,,,,,,,,,,,,,,,,,,,149.7,271.3,121.6,,,,,,,,,,,,,,,,,,,,,,,,,,,
1991-07-01,2730.9,1636.2,-1094.7,,,,40413.4,34870.5,-5542.9,,,,,,,5541.2,7900.5,2359.3,5394.1,3684.3,-1709.8,2681.8,2448.9,-232.9,9386.1,9349.5,-36.6000000000004,,,,,,,,,,41337.8,33443.9,-7893.9,18240.8,10549.4,-7691.4,,,,447.6,848.1,400.5,942.8,245.2,-697.6,,,,6906.3,6420.5,-485.8,,,,2479.8,2929,449.2,71,77.8,6.8,,,,26.6,50.7,24.1,49.3,60,10.7,,,,98.9,77.1,-21.8,23.3,87.2,63.9,,,,44.6,65.1,20.5,,,,52,78.4,26.4,,,,,,,26.7,39.2,12.5,180,135,-45,,,,,,,,,,,,,,,,,,,,,,,,,,,,,,,77.2,36.6,-40.6,39.9,68.5,28.6,,,,,,,,,,,,,,,,229.3,164.8,-64.5,779.8,415.7,-364.1,,,,,,,,,,102.6,71.5,-31.1,57.1,77.9,20.8,,,,91.9,165.8,73.9,566.7,544.2,-22.5,3,41.1,38.1,17.6,14,-3.6,144.3,178.3,34,,,,23.1,11.8,-11.3,352.4,174.3,-178.1,,,,144.2,72.1,-72.1,73.9,54.7,-19.2,,,,155.2,137.5,-17.7,1591.7,1575.3,-16.4000000000001,173.7,176.7,3,431.3,918.7,487.4,403.7,770.1,366.4,,,,,,,,,,1317.9,1236.9,-81,2144.9,1927.1,-217.8,111.8,60.5,-51.3,,,,,,,,,,36,12.7,-23.3,,,,421.7,386.9,-34.8,,,,,,,,,,27.8,31.1,3.3,84.1,202.6,118.5,,,,,,,,,,,,,,,,,,,,,,,,,,,,,,,,,,,,,264.2,446,181.8,61.2,58.8,-2.40000000000001,,,,,,,,,,,,,1139.6,571.8,-567.8,63,21.2,-41.8,,,,,,,,,,,,,,,,,,,,,,,,,,,,28,71.3,43.3,,,,,,,56.4,228.2,171.8,,,,,,,,,,,,,29.4,30,0.600000000000001,,,,,,,,,,,,,0.1,157.9,157.8,,,,823.4,498,-325.4,,,,40,163.2,123.2,,,,,,,5.5,21.6,16.1,,,,293.3,163.6,-129.7,55.1,54,-1.1,,,,48.1,3.8,-44.3,60.3,21.2,-39.1,,,,540.7,354.1,-186.6,,,,,,,,,,501.8,352.8,-149,796.8,663.9,-132.9,255.7,169.8,-85.9,,,,,,,332.6,182.9,-149.7,52,0.9,-51.1,,,,,,,1813.2,522.8,-1290.4,,,,,,,1624.9,1272.3,-352.6,910.1,578,-332.1,2062.3,1170.1,-892.2,7659,3861.9,-3797.1,339.2,756.3,417.1,,,,,,,,,,,,,,,,108.4,91.8,-16.6,,,,,,,,,,,,,,,,,,,,,,,,,,,,,,,,,,,,,,,,,,,,,,,,,,,,,,,,,,124.8,43.6,-81.2,,,,,,,24.5,271.9,247.4,,,,,,,,,,,,,,,,,,,,,,,,,,,,,,,11.2,5.5,-5.7,,,,,,,,,,,,,512.5,65,-447.5,,,,59.6,7.5,-52.1,,,,,,,,,,,,,157.4,12.7,-144.7,27.4,2.2,-25.2,,,,,,,,,,,,,22.1,8.6,-13.5,,,,,,,,,,,,,,,,,,,,,,,,,,,,,,,,,,,,,,,,,,,,,,,,,,,,,,,152.6,143.7,-8.90000000000001,,,,,,,,,,,,,,,,,,,,,,,,,,,
1991-08-01,2849.6,1490.5,-1359.1,,,,40901.9,34856.3,-6045.6,,,,,,,5303.2,7682.6,2379.4,5257.8,3791.4,-1466.4,2538,2553.1,15.0999999999999,10068.5,9643.3,-425.200000000001,,,,,,,,,,41082.4,33632.7,-7449.7,18469.5,10598.4,-7871.1,,,,444.5,807.2,362.7,1001.1,277.6,-723.5,,,,7426,6794.2,-631.8,,,,2642.5,2849.1,206.6,69.3,78.4,9.10000000000001,,,,26.3,45.9,19.6,46.6,58.4,11.8,,,,94.9,92.4,-2.5,19.6,95.6,76,,,,58.5,56.5,-2,,,,57.4,75.3,17.9,,,,,,,27.9,43.3,15.4,176.6,143.9,-32.7,,,,,,,,,,,,,,,,,,,,,,,,,,,,,,,66.5,38.8,-27.7,64.1,56.3,-7.8,,,,,,,,,,,,,,,,236.1,172.3,-63.8,664.8,400.8,-264,,,,,,,,,,132.7,75.2,-57.5,72.9,65.7,-7.2,,,,71.5,147,75.5,526,646.1,120.1,5.6,43.4,37.8,18.9,16.8,-2.1,101.8,201,99.2,,,,17.8,8.5,-9.3,189.8,220.6,30.8,,,,145,67.2,-77.8,93.2,86.7,-6.5,,,,113.2,130.1,16.9,1479.7,1735.6,255.9,136.8,190.9,54.1,502.9,891.5,388.6,197.8,889.2,691.4,,,,,,,,,,1032.8,1113.6,80.8,1988.8,1521.2,-467.6,84.2,64.6,-19.6,,,,,,,,,,25.6,10.9,-14.7,,,,395.3,429.2,33.9,,,,,,,,,,32,32.3,0.299999999999997,79,254.6,175.6,,,,,,,,,,,,,,,,,,,,,,,,,,,,,,,,,,,,,239.7,350.8,111.1,58.3,50.3,-8,,,,,,,,,,,,,1058.9,570.7,-488.2,65.9,28.6,-37.3,,,,,,,,,,,,,,,,,,,,,,,,,,,,48,66.7,18.7,,,,,,,62.8,194.5,131.7,,,,,,,,,,,,,38.3,33.3,-5,,,,,,,,,,,,,0,116.2,116.2,,,,1027.1,483.9,-543.2,,,,52.6,114.6,62,,,,,,,16.2,17,0.800000000000001,,,,272.8,142.2,-130.6,45.1,65.3,20.2,,,,38.6,15.3,-23.3,54.3,10.4,-43.9,,,,567.9,291.9,-276,,,,,,,,,,546.5,346.8,-199.7,796.6,612,-184.6,249.9,129.2,-120.7,,,,,,,321.2,184.3,-136.9,61.5,0.6,-60.9,,,,,,,1872.4,565.2,-1307.2,,,,,,,1486.9,1174.6,-312.3,857.5,797.9,-59.6,2116.8,1206.9,-909.9,7789.6,4038.8,-3750.8,336.7,731.7,395,,,,,,,,,,,,,,,,107.8,75.5,-32.3,,,,,,,,,,,,,,,,,,,,,,,,,,,,,,,,,,,,,,,,,,,,,,,,,,,,,,,,,,146.8,52.4,-94.4,,,,,,,21,207.3,186.3,,,,,,,,,,,,,,,,,,,,,,,,,,,,,,,19.2,4.8,-14.4,,,,,,,,,,,,,504.5,68.5,-436,,,,30,7.5,-22.5,,,,,,,,,,,,,203.6,11,-192.6,74.4,5.5,-68.9,,,,,,,,,,,,,26.3,5.7,-20.6,,,,,,,,,,,,,,,,,,,,,,,,,,,,,,,,,,,,,,,,,,,,,,,,,,,,,,,143.1,174.6,31.5,,,,,,,,,,,,,,,,,,,,,,,,,,,
1991-09-01,2840.4,1702.6,-1137.8,,,,41488.2,35158.6,-6329.6,,,,,,,5616.6,8591.2,2974.6,5397.8,3739.1,-1658.7,2554.5,2548.3,-6.19999999999982,10398,10059.1,-338.9,,,,,,,,,,41501.9,34391.3,-7110.6,18798.4,10381.5,-8416.9,,,,463.6,834.7,371.1,834.9,310.4,-524.5,,,,7702.5,7318.9,-383.6,,,,2695.5,2740.2,44.6999999999998,65,82.9,17.9,,,,30.9,47.2,16.3,47.8,57.1,9.3,,,,95.3,91.3,-4,20.8,83,62.2,,,,28.1,61.4,33.3,,,,46.6,85,38.4,,,,,,,29,40.1,11.1,184.2,135.9,-48.3,,,,,,,,,,,,,,,,,,,,,,,,,,,,,,,84.9,42,-42.9,34.7,47.6,12.9,,,,,,,,,,,,,,,,222.6,159.7,-62.9,745.1,378.5,-366.6,,,,,,,,,,124.1,82.7,-41.4,75.4,56.9,-18.5,,,,95.1,155.1,60,503.7,674,170.3,7.6,35.1,27.5,19.6,15.6,-4,94,217.2,123.2,,,,16.7,6.6,-10.1,381.2,304.2,-77,,,,159.5,190.5,31,90.8,93.6,2.8,,,,137.5,183.1,45.6,1512.4,1614.5,102.1,204.2,204,-0.199999999999989,377.1,855.6,478.5,284.1,801.4,517.3,,,,,,,,,,1022.7,1302.4,279.7,1964.9,1612.2,-352.7,95.9,68.7,-27.2,,,,,,,,,,24.8,16.2,-8.6,,,,517.9,388.7,-129.2,,,,,,,,,,30.5,32.5,2,37.8,271,233.2,,,,,,,,,,,,,,,,,,,,,,,,,,,,,,,,,,,,,180.3,481.2,300.9,54.1,53.2,-0.899999999999999,,,,,,,,,,,,,757.9,622.2,-135.7,50.7,30.7,-20,,,,,,,,,,,,,,,,,,,,,,,,,,,,30.5,121.6,91.1,,,,,,,82.7,173.4,90.7,,,,,,,,,,,,,96.9,51.3,-45.6,,,,,,,,,,,,,17.4,116.8,99.4,,,,951.3,623.4,-327.9,,,,9.7,129.2,119.5,,,,,,,7.1,214.3,207.2,,,,298.2,119.8,-178.4,55.7,84.5,28.8,,,,39.8,25.4,-14.4,50.1,15.7,-34.4,,,,598.9,276.7,-322.2,,,,,,,,,,560.9,305.5,-255.4,926.7,629,-297.7,306,119,-187,,,,,,,334.4,191.9,-142.5,64.9,0.7,-64.2,,,,,,,1936.3,501.9,-1434.4,,,,,,,1438.9,1253,-185.9,885.6,744.4,-141.2,2146.6,1112.7,-1033.9,7794,3620.4,-4173.6,381.6,758.8,377.2,,,,,,,,,,,,,,,,82,75.9,-6.09999999999999,,,,,,,,,,,,,,,,,,,,,,,,,,,,,,,,,,,,,,,,,,,,,,,,,,,,,,,,,,120.6,78.6,-42,,,,,,,13,182.9,169.9,,,,,,,,,,,,,,,,,,,,,,,,,,,,,,,12.5,3.8,-8.7,,,,,,,,,,,,,395.9,104.2,-291.7,,,,72.2,6,-66.2,,,,,,,,,,,,,171.3,18.8,-152.5,46.9,3.9,-43,,,,,,,,,,,,,20.2,5.8,-14.4,,,,,,,,,,,,,,,,,,,,,,,,,,,,,,,,,,,,,,,,,,,,,,,,,,,,,,,115.9,167.9,52,,,,,,,,,,,,,,,,,,,,,,,,,,,
1991-10-01,2831.8,1801.4,-1030.4,,,,42461.9,36655.5,-5806.4,,,,,,,5780.6,8860.2,3079.6,5746.4,3599.2,-2147.2,2502.4,2531.6,29.1999999999998,11787.2,11456.4,-330.800000000001,,,,,,,,,,46631,37896.5,-8734.5,20748.2,11018.8,-9729.4,,,,392.1,946.4,554.3,833.1,269.4,-563.7,,,,8636.3,8231,-405.299999999999,,,,3150.9,3225.4,74.5,73.6,112.9,39.3,,,,24.7,53.7,29,51.8,55.5,3.7,,,,104.7,90.7,-14,19.3,96.3,77,,,,32.9,69.6,36.7,,,,47.8,76.1,28.3,,,,,,,21.5,26.9,5.4,196.1,172.9,-23.2,,,,,,,,,,,,,,,,,,,,,,,,,,,,,,,64,44.2,-19.8,68.7,56.9,-11.8,,,,,,,,,,,,,,,,236.2,156.7,-79.5,650.7,449,-201.7,,,,,,,,,,116.1,88.7,-27.4,69.4,71.2,1.8,,,,101.9,147.2,45.3,522.9,487.3,-35.6,3,33.4,30.4,19.1,19.6,0.5,78,222.8,144.8,,,,12.8,8.5,-4.3,471.4,335.4,-136,,,,140.4,221.3,80.9,91.9,59.7,-32.2,,,,150.8,109.2,-41.6,1685.4,2180.2,494.8,214.6,237.9,23.3,534.9,1404.9,870,434.1,859.6,425.5,,,,,,,,,,1152.4,1191,38.5999999999999,2445.2,1629.5,-815.7,109.4,92,-17.4,,,,,,,,,,29.3,15.6,-13.7,,,,577.2,447.3,-129.9,,,,,,,,,,30.7,36.5,5.8,73.8,395.4,321.6,,,,,,,,,,,,,,,,,,,,,,,,,,,,,,,,,,,,,257.8,413.7,155.9,71.1,76.7,5.60000000000001,,,,,,,,,,,,,1054.4,689.9,-364.5,46.7,17.7,-29,,,,,,,,,,,,,,,,,,,,,,,,,,,,45.6,122.7,77.1,,,,,,,76.7,168.8,92.1,,,,,,,,,,,,,31.7,59.6,27.9,,,,,,,,,,,,,17.7,172.6,154.9,,,,880.8,572.3,-308.5,,,,117.6,131.3,13.7,,,,,,,3.9,29,25.1,,,,324.5,152.1,-172.4,68.9,103.9,35,,,,47.1,31.8,-15.3,59.5,8.6,-50.9,,,,610.2,285.6,-324.6,,,,,,,,,,650,315,-335,928.1,694.7,-233.4,327.7,166.8,-160.9,,,,,,,320.5,210,-110.5,90.7,1.7,-89,,,,,,,2236.4,552.3,-1684.1,,,,,,,1570.7,1258.6,-312.1,1037.1,646.9,-390.2,2210.5,999,-1211.5,8883.5,4266.7,-4616.8,311.6,867.6,556,,,,,,,,,,,,,,,,80.5,78.8,-1.7,,,,,,,,,,,,,,,,,,,,,,,,,,,,,,,,,,,,,,,,,,,,,,,,,,,,,,,,,,177.5,69.9,-107.6,,,,,,,21.6,267.6,246,,,,,,,,,,,,,,,,,,,,,,,,,,,,,,,21.4,11.6,-9.8,,,,,,,,,,,,,423.5,67.6,-355.9,,,,86.3,4.6,-81.7,,,,,,,,,,,,,126.6,23.9,-102.7,9.6,8.3,-1.3,,,,,,,,,,,,,18.3,1,-17.3,,,,,,,,,,,,,,,,,,,,,,,,,,,,,,,,,,,,,,,,,,,,,,,,,,,,,,,147.4,152.4,5,,,,,,,,,,,,,,,,,,,,,,,,,,,
1991-11-01,2678.2,1791.9,-886.3,,,,41653.4,37085.3,-4568.1,,,,,,,5243.9,9528.8,4284.9,5229.7,3993.1,-1236.6,2605.2,2690.7,85.5,10721.5,10445.4,-276.1,,,,,,,,,,41911.2,36969.6,-4941.6,18395.3,11320.9,-7074.4,,,,391.1,891.7,500.6,834.7,287.4,-547.3,,,,7943.5,7402.7,-540.8,,,,2778,3042.7,264.7,72.5,90.7,18.2,,,,23.4,55.5,32.1,47.7,61,13.3,,,,98.4,100.6,2.19999999999999,17.2,90.4,73.2,,,,18.2,64,45.8,,,,40.7,86.9,46.2,,,,,,,16.7,15.1,-1.6,173.9,174.5,0.599999999999994,,,,,,,,,,,,,,,,,,,,,,,,,,,,,,,61.3,39.1,-22.2,66.3,58.1,-8.2,,,,,,,,,,,,,,,,223,170.6,-52.4,742.1,444.2,-297.9,,,,,,,,,,92,84.9,-7.09999999999999,75.5,77.7,2.2,,,,102.9,168.4,65.5,633.7,614.2,-19.5,2.6,24.4,21.8,15.6,21.9,6.3,81.5,248.5,167,,,,17,9.5,-7.5,398,253.9,-144.1,,,,127.2,186.1,58.9,102.1,61.6,-40.5,,,,129.7,106.1,-23.6,1429.3,1765.6,336.3,160.8,232.1,71.3,361.3,1241.9,880.6,327.3,846.7,519.4,,,,,,,,,,1013.4,1268.6,255.2,2190.5,1739.8,-450.7,101.4,84.9,-16.5,,,,,,,,,,33.7,13.8,-19.9,,,,449.9,478.2,28.3,,,,,,,,,,27.5,43.7,16.2,49.5,407.6,358.1,,,,,,,,,,,,,,,,,,,,,,,,,,,,,,,,,,,,,216.1,467.9,251.8,54.1,66.7,12.6,,,,,,,,,,,,,986.9,757.6,-229.3,49,22.7,-26.3,,,,,,,,,,,,,,,,,,,,,,,,,,,,22.1,125.5,103.4,,,,,,,94.3,193.6,99.3,,,,,,,,,,,,,19,40.5,21.5,,,,,,,,,,,,,0.2,165.9,165.7,,,,841.8,621.6,-220.2,,,,36.9,118,81.1,,,,,,,9.8,21.3,11.5,,,,240.4,156.3,-84.1,64.2,64,-0.200000000000003,,,,41.4,11.1,-30.3,54.5,14.3,-40.2,,,,541.5,260.1,-281.4,,,,,,,,,,604.1,273,-331.1,910.4,700.2,-210.2,323.8,144.5,-179.3,,,,,,,281.4,205.4,-76,58.5,0.9,-57.6,,,,,,,1957.6,595.3,-1362.3,,,,,,,1456.7,1401,-55.7,878.7,743.9,-134.8,1983.9,1148,-835.9,7770.6,4323.8,-3446.8,313,803.3,490.3,,,,,,,,,,,,,,,,78.1,88.4,10.3,,,,,,,,,,,,,,,,,,,,,,,,,,,,,,,,,,,,,,,,,,,,,,,,,,,,,,,,,,159.1,52.7,-106.4,,,,,,,18.4,225.4,207,,,,,,,,,,,,,,,,,,,,,,,,,,,,,,,17.5,12,-5.5,,,,,,,,,,,,,403.6,99,-304.6,,,,55.6,5.4,-50.2,,,,,,,,,,,,,173,17.7,-155.3,60.7,2.4,-58.3,,,,,,,,,,,,,21.8,2,-19.8,,,,,,,,,,,,,,,,,,,,,,,,,,,,,,,,,,,,,,,,,,,,,,,,,,,,,,,102.5,148.9,46.4,,,,,,,,,,,,,,,,,,,,,,,,,,,
1991-12-01,2488.8,1812.1,-676.7,,,,41795,35619.3,-6175.7,,,,,,,5777.4,9104.4,3327,5076.4,3935.1,-1141.3,2561.6,2506.2,-55.4000000000001,9492.1,8999.8,-492.300000000001,,,,,,,,,,40903.7,34996.1,-5907.6,18005.4,10881,-7124.4,,,,372,752.3,380.3,756.5,250.1,-506.4,,,,7082.9,6079,-1003.9,,,,2409.2,2920.8,511.6,92.9,86.4,-6.5,,,,21,56.6,35.6,56.6,54.6,-2,,,,101.7,87.5,-14.2,20.3,83.7,63.4,,,,36.3,61.5,25.2,,,,49.7,68.5,18.8,,,,,,,10.9,3.1,-7.8,177.5,151.6,-25.9,,,,,,,,,,,,,,,,,,,,,,,,,,,,,,,83.1,43.3,-39.8,55.3,67.5,12.2,,,,,,,,,,,,,,,,278.5,172,-106.5,656.7,381.5,-275.2,,,,,,,,,,91.1,86.4,-4.69999999999999,70.8,85.5,14.7,,,,104.7,171.1,66.4,533.2,607.1,73.9,3,21.4,18.4,13.5,21.7,8.2,104.8,195.2,90.4,,,,13.8,7,-6.8,369.9,338.5,-31.4,,,,114.2,132.8,18.6,99.2,153.6,54.4,,,,132.5,107.8,-24.7,1568.7,1667.2,98.5,182.9,222.1,39.2,450.6,1264.4,813.8,281.7,732.6,450.9,,,,,,,,,,1238.8,1318.8,80,2395,1783.7,-611.3,105.1,99.5,-5.59999999999999,,,,,,,,,,39.5,15,-24.5,,,,468.6,404.2,-64.4,,,,,,,,,,32.3,50.5,18.2,65.4,356,290.6,,,,,,,,,,,,,,,,,,,,,,,,,,,,,,,,,,,,,225.7,471.4,245.7,51.9,65.7,13.8,,,,,,,,,,,,,1005.2,913.5,-91.7,54.1,29.5,-24.6,,,,,,,,,,,,,,,,,,,,,,,,,,,,26.2,143.7,117.5,,,,,,,157.6,205.4,47.8,,,,,,,,,,,,,0.2,38.5,38.3,,,,,,,,,,,,,0.4,136.5,136.1,,,,778.5,658.2,-120.3,,,,91.9,150.8,58.9,,,,,,,4.9,107.1,102.2,,,,200.1,148.7,-51.4,69.1,106,36.9,,,,52.2,19.7,-32.5,55.8,6.6,-49.2,,,,521.7,375.6,-146.1,,,,,,,,,,585.5,301.6,-283.9,918.8,701.7,-217.1,317.9,208.5,-109.4,,,,,,,280.1,185.5,-94.6,46.5,0.6,-45.9,,,,,,,1593.2,579,-1014.2,,,,,,,1415.5,1324.6,-90.9000000000001,741.8,678.8,-63,2000.3,1230,-770.3,8037.3,3552.5,-4484.8,277.8,676.1,398.3,,,,,,,,,,,,,,,,94.2,76.2,-18,,,,,,,,,,,,,,,,,,,,,,,,,,,,,,,,,,,,,,,,,,,,,,,,,,,,,,,,,,181.5,70.3,-111.2,,,,,,,28.1,305.9,277.8,,,,,,,,,,,,,,,,,,,,,,,,,,,,,,,25.8,9,-16.8,,,,,,,,,,,,,305.6,62.9,-242.7,,,,60.5,3.2,-57.3,,,,,,,,,,,,,176.9,19.7,-157.2,57,4.7,-52.3,,,,,,,,,,,,,15.3,2.2,-13.1,,,,,,,,,,,,,,,,,,,,,,,,,,,,,,,,,,,,,,,,,,,,,,,,,,,,,,,115.4,148.4,33,,,,,,,,,,,,,,,,,,,,,,,,,,,
1992-01-01,2596,1835.7,-760.3,,,,41809.5,35403.7,-6405.8,,,,,,,4908.7,8101.8,3193.1,5077.5,3763.2,-1314.3,2447.9,2527.6,79.6999999999998,9663.2,9982.1,318.9,,,,,,,16380.8,9402.7,-6978.1,39984.9,34514.3,-5470.6,18306.8,10565.7,-7741.1,,,,475.5,707.1,231.6,825.3,371.4,-453.9,0.5,0.2,-0.3,7169.6,6921.5,-248.1,0.3,0,-0.3,2493.6,3060.6,567,86.4,74.5,-11.9,3.5,8.3,4.8,32.4,69.2,36.8,48.2,57.5,9.3,3.1,16.9,13.8,85.3,90.6,5.3,14.3,70,55.7,0.4,15.4,15,30.2,55.8,25.6,0,0.1,0.1,41.3,78.4,37.1,0.5,4.5,4,0.2,47.9,47.7,0.5,11.7,11.2,111.6,141.8,30.2,0,0.9,0.9,0.4,2.5,2.1,0.9,2.4,1.5,0.2,5.6,5.4,0.2,0.4,0.2,0.3,2.1,1.8,1.8,5.8,4,0.3,2,1.7,0.4,2,1.6,1.7,9.7,8,57.7,34.7,-23,34.3,38.7,4.40000000000001,,,,,,,8.5,18,9.5,0,6.2,6.2,0.2,3,2.8,219.4,186.3,-33.1,581.4,354.7,-226.7,8.2,8.4,0.200000000000001,6.1,13.1,7,0.7,1.5,0.8,99.8,69,-30.8,73.1,88.4,15.3,15.1,15.6,0.5,147.4,236.4,89,624.2,442.9,-181.3,3.3,29.9,26.6,11.2,20.6,9.4,93.2,184.2,91,0,0,0,3.7,8.1,4.4,364.8,199.5,-165.3,0,0,0,78.4,121.9,43.5,103.4,74,-29.4,1.6,0.1,-1.5,114.3,132.9,18.6,1478.3,1787.2,308.9,157.2,217.5,60.3,363.8,1171.6,807.8,272.5,742.5,470,28.4,16.5,-11.9,0,0.2,0.2,0.6,0.5,-0.1,1076,1190.5,114.5,1996.2,1761.2,-235,94.6,66.2,-28.4,14,12.9,-1.1,,,,,,,39.6,19,-20.6,1.3,1.1,-0.2,413,347.2,-65.8,0.5,0.1,-0.4,0.1,6,5.9,0.1,4.2,4.1,30.3,33.4,3.1,100.4,391.8,291.4,0.1,1.3,1.2,0,0,0,0,0,0,0,0,0,0,0,0,0,0,0,0,0,0,0,0,0,0,0,0,0,0,0,0,0,0,0,0,0,207,550.7,343.7,47.2,107.2,60,0,2.4,2.4,4.6,3.9,-0.7,0,0,0,0,0,0,859.2,774.1,-85.1,43.5,28.7,-14.8,0,0,0,0,0,0,0,0,0,0,0,0,0,0,0,,,,,,,,,,0.2,3.2,3,22.7,83.2,60.5,5.8,18.1,12.3,9.6,10.3,0.700000000000001,131.3,146.9,15.6,0.7,11.7,11,0.3,12.9,12.6,2.4,11.5,9.1,0,0.3,0.3,0,57.3,57.3,,,,0,0,0,0,0,0,0.6,22.5,21.9,0.2,149.6,149.4,,,,889.4,646.3,-243.1,6.3,13.8,7.5,101.8,111.7,9.90000000000001,0.1,20.8,20.7,18.9,20.8,1.9,3.8,28,24.2,0.4,0.2,-0.2,272.8,153.2,-119.6,74.3,70.5,-3.8,7.5,0.3,-7.2,58.3,3.1,-55.2,68.8,6.4,-62.4,1.6,0.4,-1.2,584.8,242.7,-342.1,0,0.7,0.7,0,0.1,0.1,0,0,0,570.8,281.4,-289.4,860.8,646.7,-214.1,369.7,313.8,-55.9,,,,1.1,10.3,9.2,315.9,194.5,-121.4,60.6,1.1,-59.5,0,0,0,3.8,0.4,-3.4,1912.6,502.5,-1410.1,0.1,0,-0.1,0,0,0,1364.4,1463,98.5999999999999,838.2,628.7,-209.5,2014.1,1024.8,-989.3,7608.8,3650.6,-3958.2,369.8,604.6,234.8,0,0.3,0.3,0,0.1,0.1,0,0,0,0,0,0,1,4.5,3.5,93,76.3,-16.7,0,0,0,0.2,0,-0.2,0,0,0,0,0.5,0.5,0,0,0,0,0.2,0.2,0,0,0,0,3.5,3.5,0,0,0,1.5,1.1,-0.4,0,0,0,0.8,7,6.2,3.7,2.5,-1.2,1,3.5,2.5,0,1,1,0.1,0,-0.1,3.5,1.7,-1.8,0.9,0.3,-0.6,14.3,24.2,9.9,164.3,48.9,-115.4,2.4,20.4,18,0,0,0,18.8,215.8,197,1.9,9.2,7.3,,,,0.1,0,-0.1,0,1.1,1.1,1.6,0.6,-1,0.5,6,5.5,0.7,7,6.3,0.1,0.3,0.2,8.8,3.5,-5.3,0.8,1.7,0.9,33.3,6.3,-27,10.6,9.8,-0.799999999999999,0.1,0.3,0.2,0.2,1.7,1.5,0.1,2.2,2.1,331.4,67,-264.4,0,0,0,51.8,3.4,-48.4,0,0.2,0.2,0,0,0,0,2.2,2.2,0,1.7,1.7,169.1,12.1,-157,6.7,3.8,-2.9,0,0,0,0.1,0.2,0.1,0,0.5,0.5,0.7,1.5,0.8,19.7,3.3,-16.4,1.6,0.4,-1.2,2.5,0.2,-2.3,0,0,0,0.4,3,2.6,,,,0,0.8,0.8,1.3,0.3,-1,6.4,5,-1.4,0.1,0.2,0.1,0,0,0,1.4,1.4,0,9.1,1,-8.1,1.7,71.8,70.1,6.5,0.5,-6,,,,0,0,0,0,0.1,0.1,0.1,0,-0.1,119.9,134.9,15,0.3,1.1,0.8,0.1,1.8,1.7,6.4,0.8,-5.6,2.4,0.1,-2.3,14.8,4.5,-10.3,8.7,0.9,-7.8,3.9,0.1,-3.8,0,0,0,,,
1992-02-01,2184.3,1796.7,-387.6,,,,41370.6,37702.1,-3668.5,,,,,,,5107.5,9316.6,4209.1,4304.4,3684.9,-619.5,2584.5,2645.5,61,10265.6,10241.4,-24.2000000000007,,,,,,,15010.4,10142.5,-4867.9,39075,36897.5,-2177.5,16827.7,11311.1,-5516.6,,,,381.4,791.8,410.4,585.4,343.2,-242.2,0,0.2,0.2,7653.2,7040.3,-612.9,0.1,0,-0.1,2612.4,3201.1,588.7,101.1,80,-21.1,9.9,8.8,-1.1,32.6,64,31.4,55.2,66.5,11.3,1.4,13.6,12.2,109,88.9,-20.1,20.7,79.1,58.4,0.6,20.2,19.6,31.8,54.7,22.9,0,0.1,0.1,53.2,75.3,22.1,0.5,3.5,3,1.7,56.7,55,1.5,13.9,12.4,176.5,150.5,-26,0,0.7,0.7,0.2,2.7,2.5,1.2,2.6,1.4,0.3,4.9,4.6,0,0.2,0.2,0.2,4,3.8,2.1,7.5,5.4,0.3,3.8,3.5,0.8,2.1,1.3,2.6,10.2,7.6,63.9,31.9,-32,55.4,46.7,-8.7,,,,,,,8.1,16.4,8.3,0,5.3,5.3,0.1,3.2,3.1,234.8,262.7,27.9,540.4,392.2,-148.2,7,16.8,9.8,3.2,11.5,8.3,0,3.2,3.2,105,65.4,-39.6,62,78.4,16.4,14.4,15.4,1,141.5,167.6,26.1,650.9,464.3,-186.6,6.3,36.9,30.6,10.1,13.7,3.6,78,199.4,121.4,0,0,0,10.5,8.3,-2.2,357.2,325.9,-31.3,0,0,0,72.7,173.8,101.1,83,58.3,-24.7,1.4,1,-0.4,160.8,128.2,-32.6,1538.1,1911,372.9,163.1,218.8,55.7,365.9,1528.2,1162.3,362.8,782.2,419.4,17.6,51.6,34,0,3,3,2.4,0.4,-2,1067.2,1428.7,361.5,2027.2,1967.5,-59.7,95,82.2,-12.8,16.6,13.9,-2.7,,,,,,,23.5,15.3,-8.2,1.7,1.7,0,445.6,428.2,-17.4,0.3,11.9,11.6,0,12.4,12.4,0.6,8.4,7.8,25.6,28,2.4,23.3,213.5,190.2,22,66.4,44.4,0.5,0,-0.5,0.1,12.5,12.4,0,5.4,5.4,0,0,0,0,0,0,1.1,1.4,0.3,0,1.8,1.8,0,0,0,0,0,0,0,0.3,0.3,0,0,0,220.4,451.6,231.2,47.9,118,70.1,0,0.5,0.5,7.3,3.6,-3.7,0,0,0,0,0,0,878.6,740.7,-137.9,43.2,25,-18.2,0,0,0,0,0,0,0,0,0,0,0,0,0,0,0,,,,,,,,,,0.2,1.6,1.4,32.8,89.1,56.3,4.1,14,9.9,11.4,10.3,-1.1,105.7,291.1,185.4,0.6,14.5,13.9,0.5,13,12.5,1.7,22.5,20.8,0,0,0,0,44.2,44.2,,,,0,0,0,0,0,0,1.6,18.7,17.1,0.7,134.6,133.9,,,,766.5,621.3,-145.2,7,23.1,16.1,101.5,134.3,32.8,0.1,24.3,24.2,14.1,17.9,3.8,4.5,19.6,15.1,0.1,0.1,0,290.9,147.1,-143.8,73,83.5,10.5,7.6,1.2,-6.4,74.3,4.5,-69.8,63.5,11.8,-51.7,2.5,0.5,-2,489.1,280.2,-208.9,0,0.2,0.2,0,0,0,0,0,0,560.1,299.3,-260.8,705.5,679.3,-26.2,315.2,219.2,-96,,,,0.9,83.7,82.8,279.2,189.8,-89.4,49.5,1,-48.5,0,0,0,3.6,0.1,-3.5,1693.7,471.1,-1222.6,0.1,0.1,0,0,0.1,0.1,1180.9,1203,22.0999999999999,636.8,660.2,23.4000000000001,1781.2,1142.4,-638.8,7433,4421.5,-3011.5,275.1,605.1,330,0,0.9,0.9,0,0,0,0,0,0,0,0,0,3.7,5.1,1.4,95.4,161.6,66.2,0,0.1,0.1,0.2,0,-0.2,0,0,0,0,0.5,0.5,0,1.2,1.2,0,0,0,0,0,0,0,3.3,3.3,0,0,0,0,1.5,1.5,0,0,0,1,6,5,0.7,2.3,1.6,0.9,1.5,0.6,0,0.5,0.5,0,0,0,4,1.7,-2.3,0.4,0.5,0.1,13.4,15.6,2.2,154.1,57.4,-96.7,3.1,10.9,7.8,0,0,0,21.3,228.1,206.8,1,2.1,1.1,,,,0,0.1,0.1,0,1.1,1.1,0,1.4,1.4,1,3.1,2.1,0.9,7.5,6.6,0,1.3,1.3,9.6,6,-3.6,6.3,3.7,-2.6,14.3,7.7,-6.6,6.5,15.5,9,0,0.6,0.6,0.5,1.2,0.7,0.2,0.9,0.7,142.9,101.9,-41,0,0,0,51,2.9,-48.1,0,0.6,0.6,0,0,0,0,1.1,1.1,0,2.5,2.5,137.3,8.4,-128.9,24.7,3,-21.7,0,0,0,0,0,0,0,0.2,0.2,1.6,6.4,4.8,11.1,1.1,-10,0.9,0.1,-0.8,0.1,0.2,0.1,0,0,0,0.4,1.9,1.5,,,,0,1,1,1.1,1.6,0.5,5.3,5.9,0.600000000000001,0.1,0.2,0.1,0,0,0,0.4,1.5,1.1,12.1,1.6,-10.5,0.1,1.4,1.3,0.7,0.5,-0.2,,,,0.1,0,-0.1,0,0.1,0.1,0,0,0,117.4,134.2,16.8,0.5,2.5,2,0.9,0.8,-0.1,12,1.1,-10.9,0.9,1.3,0.4,14.2,7.9,-6.3,7.5,0.8,-6.7,2.2,0.4,-1.8,0,0,0,,,
1992-03-01,2280.8,1871.5,-409.3,,,,42681.2,37208.1,-5473.1,,,,,,,5969.9,10233.9,4264,4787.3,4032.8,-754.5,2773.6,2823.2,49.5999999999999,11521.3,11732.1,210.800000000001,,,,,,,16422.6,10522.8,-5899.8,43343.9,39816.9,-3527.00000000005,18331.5,11766.1,-6565.4,,,,423,770.8,347.8,796.7,375,-421.7,0,0.3,0.3,8576.9,8204.3,-372.6,0.2,0,-0.2,2944.4,3527.8,583.4,102.7,84.3,-18.4,6.9,10.5,3.6,34.1,58.5,24.4,71,64.4,-6.59999999999999,14.2,11.1,-3.1,120.8,111.9,-8.89999999999999,27.6,90.6,63,0.5,19.7,19.2,66.7,58.2,-8.5,0,0.1,0.1,51.2,67,15.8,0.4,3.2,2.8,1.8,23.8,22,7.5,13.9,6.4,188.6,182.1,-6.5,0,0.6,0.6,0.5,4.4,3.9,1.6,2.9,1.3,0.1,5.7,5.6,0,0.4,0.4,0.1,2.8,2.7,2.7,7.3,4.6,0.3,3.2,2.9,1.2,2,0.8,2.8,10.7,7.9,65.1,31.6,-33.5,41.5,43.3,1.8,,,,,,,20.5,43.1,22.6,0.2,5.7,5.5,0.1,2.3,2.2,235.2,277.7,42.5,598.4,496,-102.4,11.3,8.8,-2.5,2,14,12,2.2,14.9,12.7,94,75.1,-18.9,55.6,77.6,22,9.9,17.6,7.7,147.3,159,11.7,617.9,460.1,-157.8,2.2,37.7,35.5,70.9,15.2,-55.7,96,204.2,108.2,0,0,0,14.9,9.6,-5.3,387.1,301.8,-85.3,0,0,0,88.1,124.7,36.6,84.3,67.2,-17.1,2.1,0.1,-2,129.1,198.9,69.8,1566,2344.8,778.8,185.1,236.5,51.4,441,1237.1,796.1,319.1,868,548.9,18.3,56.1,37.8,0,1.6,1.6,0.2,0.4,0.2,1231.2,1533.9,302.7,2382.9,2048.2,-334.7,130.5,83.8,-46.7,21.7,15.2,-6.5,,,,,,,30.3,13.6,-16.7,1.5,0.4,-1.1,480.5,376.6,-103.9,0.4,1,0.6,2.3,2,-0.3,0,1,1,32.7,39.2,6.5,26.4,95.6,69.2,13.1,161.3,148.2,2.3,0,-2.3,4.5,1.2,-3.3,0,0.2,0.2,0,0,0,0,0.4,0.4,0.2,0,-0.2,0.2,0,-0.2,0,0.1,0.1,0.9,0.6,-0.3,0,1,1,0,0.2,0.2,259.2,631.2,372,49.6,98.2,48.6,0,0.2,0.2,8.7,2.9,-5.8,0,0,0,0,0,0,1083,889.1,-193.9,51.5,47.8,-3.7,0,0,0,0,0,0,0,0,0,0,0,0,0,0,0,,,,,,,,,,0.3,1,0.7,45.8,68.7,22.9,9.1,24.5,15.4,7.7,3,-4.7,180.2,221.8,41.6,1.6,12.7,11.1,6.1,8.5,2.4,2.9,21.3,18.4,0,0.1,0.1,0.1,52.5,52.4,,,,0,0,0,0,0,0,1.4,17.1,15.7,0.3,143.9,143.6,,,,755.9,624.3,-131.6,5.4,16.4,11,42.8,150.1,107.3,5.6,15.7,10.1,6.5,41.5,35,5,21.8,16.8,0.3,0.1,-0.2,361.8,174.2,-187.6,71.7,54.2,-17.5,10.2,0.5,-9.7,76.2,16.8,-59.4,65.8,17.9,-47.9,5.1,0.4,-4.7,562.5,271.7,-290.8,0,0.8,0.8,0.2,0,-0.2,0,0,0,619.4,340,-279.4,957.7,762.1,-195.6,351.1,190,-161.1,,,,11.7,8.2,-3.5,340.7,212.1,-128.6,35.4,0.9,-34.5,0,0,0,2.2,0,-2.2,1441.8,646.3,-795.5,0,0,0,0,0,0,1315.6,1395.4,79.8000000000002,591.5,669.1,77.6,1922.5,1206.2,-716.3,8421.6,4350.6,-4071,299.2,646.2,347,0,0.1,0.1,0,0,0,0,0,0,0,0,0,3.6,4,0.4,110.9,91.6,-19.3,0,0,0,0,0,0,0,0,0,0,0.6,0.6,0,0.8,0.8,1.9,0,-1.9,0,0,0,0,4.1,4.1,0,0,0,1.9,4.3,2.4,0,0,0,1.1,6.6,5.5,0.1,3.7,3.6,1.1,4.2,3.1,0,1.6,1.6,0,0,0,2.8,2.6,-0.2,0.4,0.4,0,14.8,85,70.2,147,47.8,-99.2,1.7,36.5,34.8,0,0,0,40.1,348,307.9,0.9,2.2,1.3,,,,0,0,0,0,0.1,0.1,2.1,1.3,-0.8,4.6,4.2,-0.399999999999999,1.4,5.5,4.1,0.1,0.3,0.2,17.6,2.1,-15.5,3.7,1.8,-1.9,18.4,7.1,-11.3,9.9,9.5,-0.4,0.1,0.8,0.7,0,0.7,0.7,0.2,1.4,1.2,266.6,70.6,-196,0,0,0,19.3,4.6,-14.7,0,0.1,0.1,0.2,0,-0.2,0,0.7,0.7,0,2.1,2.1,183.6,16.6,-167,37.3,7.4,-29.9,0,0,0,0,0.3,0.3,0,0.1,0.1,0.5,6.4,5.9,30.2,1.7,-28.5,0.4,0.1,-0.3,0,0.2,0.2,0.5,0,-0.5,0.1,8.5,8.4,,,,0,0.4,0.4,1.2,1.6,0.4,11.2,17.7,6.5,0,0.1,0.1,0.1,0,-0.1,1,2.1,1.1,10.4,1.1,-9.3,1.1,3.7,2.6,7.2,0.1,-7.1,,,,1.1,0.2,-0.9,0,0.2,0.2,0,0,0,129.3,180,50.7,4.1,3.5,-0.6,0.9,0.9,0,5.3,4.6,-0.7,1.3,0.1,-1.2,15.1,9.7,-5.4,5.7,1.2,-4.5,4.4,0.1,-4.3,0,0,0,,,
1992-04-01,2444,2089.6,-354.4,,,,43398.8,36558.4,-6840.4,,,,,,,5645.6,8492.8,2847.2,4716.6,3792.9,-923.7,2616.1,2874.8,258.7,11349.5,11340.4,-9.10000000000036,,,,,,,16080.8,9603.5,-6477.3,42924.3,37153.4,-5770.9,17789.4,10896.6,-6892.8,,,,495.3,791.4,296.1,1091.1,362.6,-728.5,0.1,0.5,0.4,8408.7,7826.3,-582.400000000001,0.1,0,-0.1,2940.8,3514.1,573.3,108.6,96.8,-11.8,2.2,10.5,8.3,30.6,49.7,19.1,60.4,66.9,6.50000000000001,5,10.7,5.7,113,112,-1,26.5,103.6,77.1,0.2,24.8,24.6,32.2,62.9,30.7,0,0.1,0.1,42.9,72.4,29.5,0.5,3.7,3.2,2.7,25.1,22.4,10.3,13.5,3.2,195.7,185.3,-10.4,0,0.9,0.9,0.5,10.8,10.3,1.7,2.5,0.8,0.5,6.6,6.1,0,0.8,0.8,0.4,4,3.6,2.5,6.8,4.3,0.4,2.7,2.3,0.5,2.6,2.1,2.6,11.8,9.2,62.7,34.1,-28.6,62.8,42.5,-20.3,,,,,,,1.7,23.9,22.2,0,10.5,10.5,0.1,3.1,3,226.3,341.1,114.8,551.4,473.8,-77.6,10.9,6.3,-4.6,5.8,10.3,4.5,0,1.6,1.6,104.8,86.2,-18.6,94.4,66.9,-27.5,10.9,11.7,0.799999999999999,140.2,166.9,26.7,566.3,378.5,-187.8,4,37.7,33.7,20.7,21.4,0.699999999999999,113.2,270.8,157.6,0,0,0,18.1,11.8,-6.3,459.4,230.1,-229.3,0,0,0,167.4,85,-82.4,104.8,94.3,-10.5,2.1,0,-2.1,139.9,105.1,-34.8,1569.3,1989.1,419.8,154.5,302.1,147.6,370.3,1108.2,737.9,341.3,779.9,438.6,18.7,13.6,-5.1,0,0.3,0.3,1.2,0.4,-0.8,1443,1281.1,-161.9,2487.3,1770.1,-717.2,94.9,85.5,-9.40000000000001,18.3,17.9,-0.400000000000002,,,,,,,27.4,101,73.6,1.9,0.6,-1.3,441.6,383.4,-58.2,1.6,15.3,13.7,1.3,2.6,1.3,0.4,1.7,1.3,29.8,33.9,4.1,15.5,95,79.5,23.7,178.4,154.7,0.9,0,-0.9,0.6,3.6,3,0,2.4,2.4,0,0,0,0,0,0,13.6,0.8,-12.8,0,0,0,0,1.2,1.2,0,0,0,0,0,0,0,0,0,282,529.4,247.4,54.7,104,49.3,0,0.3,0.3,7.3,2.4,-4.9,0,0.1,0.1,0,0,0,967.6,705.2,-262.4,46.3,39.8,-6.5,0,0,0,0,0,0,0,0,0,0,0,0,0.2,0,-0.2,,,,,,,,,,0.1,4.9,4.8,41.7,87.9,46.2,3.4,19.1,15.7,3.6,1.6,-2,83.8,181.1,97.3,0.7,12.9,12.2,5,23.8,18.8,2.6,15,12.4,0,0,0,0.2,39.2,39,,,,0,0,0,0,0,0,0.8,12.5,11.7,2.1,110.1,108,,,,771.6,804.2,32.6,5.9,21,15.1,44.1,123.3,79.2,0.2,13,12.8,12.3,18,5.7,3.7,59.4,55.7,0.2,0.3,0.1,315.1,120.4,-194.7,77.4,50.9,-26.5,9.2,0.1,-9.1,54.9,23.7,-31.2,54.5,14.4,-40.1,4.1,0.6,-3.5,541.4,225.3,-316.1,0,0.3,0.3,0.1,0,-0.1,0,0.1,0.1,600.9,284.6,-316.3,840.5,733.7,-106.8,311.5,286.2,-25.3,,,,1.3,166.2,164.9,321.7,217.9,-103.8,45.7,0.9,-44.8,0,0,0,2,0,-2,1677.6,580.7,-1096.9,0.2,0.1,-0.1,0,0,0,1319.7,1087.7,-232,666.8,670,3.20000000000005,1889.6,1301.5,-588.1,7921.9,3567.3,-4354.6,352.1,625.1,273,0,0.2,0.2,0,0,0,0,0.1,0.1,0,0,0,0.6,3.2,2.6,131,78.5,-52.5,0,0,0,0,0,0,0,0,0,0,29.7,29.7,0.2,35.8,35.6,2,0,-2,0,0,0,0,3.8,3.8,0,0,0,0.7,1.4,0.7,0,0,0,0.3,5.8,5.5,0.1,2.6,2.5,0.6,2.5,1.9,0,0.7,0.7,0,0,0,7.5,1.8,-5.7,0.2,0.2,0,12,24.8,12.8,73.7,54.5,-19.2,13.3,39.7,26.4,0,0,0,42.4,280.2,237.8,0.9,3.5,2.6,,,,0,0,0,0,5.1,5.1,1.8,1.2,-0.6,13.7,4.2,-9.5,0.5,4.2,3.7,0.1,0.5,0.4,10.9,8.1,-2.8,1.8,6.9,5.1,28.1,6.2,-21.9,5.2,4.9,-0.3,0.5,0.4,-0.1,0.5,1.2,0.7,0.3,1.8,1.5,463.6,84.4,-379.2,0,0.1,0.1,115,6.8,-108.2,0,0.5,0.5,0,0,0,0,1.1,1.1,0.1,0.7,0.6,176.5,23.9,-152.6,18.5,6.4,-12.1,0,0,0,0,0.1,0.1,0,0,0,1.4,0.4,-1,19.2,1.7,-17.5,0.3,0,-0.3,0.7,0.1,-0.6,0,0,0,1.1,56.7,55.6,,,,0,1.6,1.6,1,0.6,-0.4,7.8,12.4,4.6,0,0.1,0.1,0,0,0,1.2,2,0.8,9,1.4,-7.6,8,11.5,3.5,3.3,0.9,-2.4,,,,4.2,0.2,-4,0,0.2,0.2,0,0,0,153.5,143.2,-10.3,7.9,4.3,-3.6,1.9,0.7,-1.2,12.2,2.2,-10,2.1,0.6,-1.5,14.6,6,-8.6,0.7,0.4,-0.3,4.1,0.1,-4,0,47.9,47.9,,,
1992-05-01,2700.7,1808.4,-892.3,,,,43954.1,36012,-7942.1,,,,,,,5316.2,8219.8,2903.6,4931.4,4091,-840.4,2729.6,2928.9,199.3,11442.2,11084,-358.200000000001,,,,,,,15585.6,10095.1,-5490.5,42146,36736.5,-5409.5,17370.2,11038,-6332.2,,,,433.9,943.1,509.2,1139.1,370.6,-768.5,0,0.5,0.5,8479.6,7679.2,-800.400000000001,0.1,0,-0.1,2962.6,3404.8,442.2,81.6,85.3,3.7,8.3,9.7,1.4,31.7,54.7,23,58.2,67,8.8,2.9,12.3,9.4,120.2,135.9,15.7,24.7,100,75.3,0.4,22.5,22.1,49.2,59.7,10.5,0,0.1,0.1,47.6,84.5,36.9,0.3,3.1,2.8,0.7,22.2,21.5,10.5,19.2,8.7,195.7,186.4,-9.29999999999998,0,0.9,0.9,0.1,4.7,4.6,1.6,3.5,1.9,0.3,4.9,4.6,0,0.6,0.6,0.7,1.3,0.6,1.8,7.7,5.9,0.9,1.6,0.7,1,1.9,0.9,2.6,10.8,8.2,65,36.3,-28.7,57.1,34.2,-22.9,,,,,,,12.9,19.2,6.3,0,4.7,4.7,0,2.3,2.3,211.4,293.6,82.2,594.5,496.2,-98.3,7.5,8.7,1.2,3.4,8.7,5.3,0.1,0.8,0.7,94.6,83.2,-11.4,52,72.8,20.8,10.6,19.4,8.8,119,213.5,94.5,727,430.4,-296.6,2.8,41.2,38.4,20.5,17.8,-2.7,110.2,245.4,135.2,0,0,0,14.4,11.2,-3.2,384.1,286.1,-98,0,0,0,224,90.4,-133.6,91.8,66.4,-25.4,0.6,0.2,-0.4,118.8,133.5,14.7,1605.4,1925.8,320.4,189.2,214.6,25.4,486.2,1026.2,540,360.4,848,487.6,15.6,18.9,3.3,0,0.4,0.4,0.5,0.7,0.2,1044.4,1215.5,171.1,2294.1,1831.6,-462.5,111,89.4,-21.6,16.9,15.4,-1.5,,,,,,,24.5,16.8,-7.7,1.6,1.1,-0.5,448.6,291.2,-157.4,1.1,0.5,-0.6,1.9,1.1,-0.8,0.1,3,2.9,25.4,40.9,15.5,2.5,54,51.5,30.5,158,127.5,1.5,0.3,-1.2,6.4,14,7.6,0.1,1.1,1,0,0,0,0,0.1,0.1,0.7,0.1,-0.6,0.1,0,-0.1,0,0,0,0,0,0,0,0,0,0.1,0.1,0,214.5,456.9,242.4,53,63.4,10.4,0.5,0.2,-0.3,7,5.6,-1.4,0,0.2,0.2,0,0,0,909.3,770.8,-138.5,40.6,20.2,-20.4,0,1.3,1.3,0,0.3,0.3,0,0.2,0.2,0,0,0,0.7,1.6,0.9,,,,,,,,,,0.2,4.3,4.1,26.6,57.7,31.1,10.4,18.3,7.9,2.9,3,0.1,63.1,255.4,192.3,1.4,11.3,9.9,7.6,6.6,-1,1.9,14.5,12.6,0,0,0,0,82.3,82.3,,,,0,0,0,0,0,0,0.4,16.9,16.5,1.1,109.4,108.3,,,,848.5,529.4,-319.1,4.9,14.6,9.7,51.2,122.2,71,0,43.4,43.4,9.5,15.9,6.4,4.6,26.2,21.6,0.5,0.4,-0.1,280.9,171.4,-109.5,58.1,52.9,-5.2,5.1,0.2,-4.9,49.4,19.1,-30.3,49.3,7.4,-41.9,2.8,0.4,-2.4,538.1,276.6,-261.5,0,0.3,0.3,0.4,0,-0.4,0,0,0,617.1,320.9,-296.2,846.7,792.7,-54,334.3,214.9,-119.4,,,,0.9,18,17.1,292.8,212,-80.8,52.4,0.8,-51.6,0,0,0,1.6,0.1,-1.5,1853.9,621.7,-1232.2,0,0.2,0.2,0,0,0,1336.1,1290.8,-45.3,721.5,708.5,-13,2027.1,1299,-728.1,7075.4,3714,-3361.4,284.9,804.5,519.6,0,0.1,0.1,0,0.1,0.1,0,0.1,0.1,0,0,0,3.1,18.9,15.8,139.5,78.4,-61.1,0,0.7,0.7,0,0,0,0,0,0,0.1,4.2,4.1,0.2,14.6,14.4,0.8,0,-0.8,0,0,0,0,3.8,3.8,0,0,0,1.1,1.2,0.0999999999999999,0,0,0,0.3,8.4,8.1,0.8,2.8,2,0.6,2.5,1.9,0,0.8,0.8,0,0,0,2.3,1,-1.3,0.2,1,0.8,16.6,30.2,13.6,144.7,59.2,-85.5,3.2,8.7,5.5,0,0,0,32.6,223,190.4,0.5,2.5,2,,,,0,0,0,0,0.4,0.4,1.8,1.4,-0.4,1.1,2.7,1.6,0.8,5.9,5.1,0.1,0.6,0.5,10.3,5.4,-4.9,5.1,2,-3.1,11.2,5.5,-5.7,4.2,12.3,8.1,0,0.8,0.8,0.3,0.4,0.1,0.4,1.2,0.8,558.1,94.1,-464,0.4,0.1,-0.3,68.9,3.1,-65.8,0,0.5,0.5,0,0,0,0,2.2,2.2,0,1,1,203,15.9,-187.1,72.5,5,-67.5,0,0,0,0,0.2,0.2,0,0,0,1.1,1.3,0.2,15.2,1,-14.2,0.7,0,-0.7,0.1,0.1,0,0,2.6,2.6,1.1,9.3,8.2,,,,0,0.7,0.7,1.6,1.2,-0.4,7.7,4.3,-3.4,0.1,0.1,0,0,0,0,1.3,2.8,1.5,8.9,2.5,-6.4,1,0.8,-0.2,2.8,0.2,-2.6,,,,0,0.1,0.1,0,0.3,0.3,0,0,0,139.6,164.6,25,0.5,5.1,4.6,1.3,1.1,-0.2,8,8.6,0.6,0.9,0,-0.9,4.2,9.7,5.5,2.3,0.6,-1.7,3.1,0,-3.1,0,13.4,13.4,,,
1992-06-01,3079,1935.5,-1143.5,,,,44954.1,38356.1,-6598,,,,,,,6232,9793.9,3561.9,5408.5,4556.2,-852.3,2909.3,3047.1,137.8,11935.3,11901,-34.2999999999993,,,,,,,17229.8,11070.6,-6159.2,45811.5,39094.6,-6716.9,19403.5,12370.2,-7033.3,,,,473.7,979.7,506,1110.6,442.2,-668.4,0.8,0.2,-0.6,8787.9,8428.6,-359.299999999999,0.3,0.1,-0.2,3147.4,3472.4,325,92.8,100.5,7.7,4.9,9.8,4.9,33.2,69.5,36.3,67.8,66.6,-1.2,2.2,17.7,15.5,134.5,107.7,-26.8,26.8,97,70.2,0.4,20.9,20.5,52.1,61.3,9.2,0,0.1,0.1,47.7,76,28.3,0.2,2.3,2.1,0.4,17,16.6,11,17.2,6.2,208.3,176.2,-32.1,0,1.1,1.1,0.1,2.3,2.2,4.6,2.6,-2,0.2,5.6,5.4,0.3,1.2,0.9,0.4,3.3,2.9,2.5,6.4,3.9,0.2,3.7,3.5,0.3,1.5,1.2,3.6,10.3,6.7,81.6,36.9,-44.7,65.4,33.8,-31.6,,,,,,,23.8,13.3,-10.5,0.1,4.1,4,0.4,2.2,1.8,237.7,268.9,31.2,684.8,456.4,-228.4,8.5,9.4,0.9,2.6,12.4,9.8,0,13.2,13.2,136.2,94.9,-41.3,57.2,80.3,23.1,12.4,15.7,3.3,103.2,233.1,129.9,661.4,594.4,-67,1.2,31,29.8,18.9,19.7,0.800000000000001,119.3,249.6,130.3,0.1,0,-0.1,17.6,11.2,-6.4,421.1,179.3,-241.8,0,0,0,197.4,81.9,-115.5,105.1,56.6,-48.5,2.8,1,-1.8,135.8,145.8,10,1791.8,1807.8,16,201.4,187.3,-14.1,440,1061.3,621.3,386.7,816.2,429.5,18.7,16.7,-2,0,0.1,0.1,0.3,0.3,0,1320.7,1153.3,-167.4,2345.1,1619.1,-726,123.4,91.7,-31.7,18.5,50.7,32.2,,,,,,,29.8,18.2,-11.6,1.9,1.6,-0.3,488.8,478.4,-10.4,1.4,2,0.6,0.2,1.3,1.1,0.4,1.7,1.3,30.6,33.3,2.7,5.5,51.7,46.2,45.7,191.1,145.4,1.7,0,-1.7,2.5,42.2,39.7,0,0.2,0.2,0,0,0,0.2,0.1,-0.1,1.6,1.3,-0.3,0,0,0,0,0,0,0,0,0,0.8,0,-0.8,0.1,0.1,0,259.8,443.8,184,52.4,76.3,23.9,0,0.2,0.2,7.2,4.2,-3,0,0,0,0,0,0,1169.5,838.8,-330.7,0,5.1,5.1,2.1,5.3,3.2,8.1,3.1,-5,0.3,0.6,0.3,2.2,0.1,-2.1,26.3,2.2,-24.1,,,,,,,,,,0.4,0.1,-0.3,36.8,61.1,24.3,11.5,10.1,-1.4,6.4,8.6,2.2,85.9,332.5,246.6,0.8,11.2,10.4,6.1,11.5,5.4,1.8,29.7,27.9,0,0,0,0.1,71.8,71.7,,,,0,0,0,0,0.2,0.2,1.7,23.5,21.8,0.5,96.5,96,,,,1064.7,729.1,-335.6,7.1,12.4,5.3,82.8,117.1,34.3,0.3,48.8,48.5,12.1,14.4,2.3,4.5,203.8,199.3,0.1,0.4,0.3,317.3,204.6,-112.7,80.8,55.5,-25.3,5.4,0.3,-5.1,70.8,11.3,-59.5,54.3,22.3,-32,2.8,0.3,-2.5,586.7,243.7,-343,0,0.2,0.2,0.5,0,-0.5,0,1,1,691.7,349.4,-342.3,1030.1,1063,32.9000000000001,376.4,185,-191.4,,,,0.8,16.8,16,361.8,214.3,-147.5,73.4,0.8,-72.6,0,0,0,2.2,0.1,-2.1,2179.2,689.2,-1490,0.7,0.2,-0.5,0,0,0,1428.6,1350.9,-77.6999999999998,846.6,842.3,-4.30000000000007,2103.2,1300,-803.2,7675.6,4127.3,-3548.3,327,823.5,496.5,0,0,0,0,0,0,0,0,0,0,0,0,1.3,5.9,4.6,134.1,102.2,-31.9,0,0.2,0.2,0.1,0.1,0,0,0,0,0,0.6,0.6,0.1,0,-0.1,0,0,0,0,0,0,0,3,3,0,0,0,1.5,1.7,0.2,0,0,0,0.4,5.7,5.3,0.3,2.8,2.5,1.4,3.9,2.5,0,0.8,0.8,0,0,0,7.1,28.8,21.7,0.4,0.5,0.1,16.1,42.4,26.3,107.5,75.2,-32.3,2.7,10.2,7.5,0,0,0,43.6,280.8,237.2,0.7,12,11.3,,,,0.1,0,-0.1,0,0.3,0.3,0.1,5.2,5.1,5.7,4.7,-1,0.6,7,6.4,0.1,0.6,0.5,7.3,6.8,-0.5,2.1,0.7,-1.4,12.6,3.7,-8.9,12,11.3,-0.699999999999999,0,0.8,0.8,0.5,0.5,0,0.2,0.9,0.7,544.5,90.9,-453.6,0,0.1,0.1,74.5,6.2,-68.3,0,0.5,0.5,0,0,0,0,0.6,0.6,5.4,4.3,-1.1,157.6,9.5,-148.1,32.8,5.6,-27.2,0,0,0,0,0.1,0.1,0,0,0,1.7,3.1,1.4,27.9,3.7,-24.2,1.1,0.3,-0.8,0,0.3,0.3,0.3,3.2,2.9,0.7,12.3,11.6,,,,0,0.6,0.6,1.3,2.7,1.4,4.2,7,2.8,0,0.1,0.1,0,0,0,0.3,5.2,4.9,12.4,1.1,-11.3,0.7,1.5,0.8,3.5,0.3,-3.2,,,,0.9,0,-0.9,0,0.2,0.2,0,0,0,176.8,193.6,16.8,2.2,1.6,-0.6,1.2,28,26.8,8.1,10.5,2.4,2.1,0.1,-2,3,6.5,3.5,1.2,0.5,-0.7,5,0,-5,0,26.2,26.2,,,
1992-07-01,3128.9,1730.5,-1398.4,,,,44989.4,37501.9,-7487.5,,,,,,,6025.6,8278.7,2253.1,5690.3,4017.7,-1672.6,2886.4,3114.1,227.7,10101.6,10399.6,298,,,,,,,18481,10218,-8263,45872.4,35979.2,-9893.2,20808.2,11539.9,-9268.3,,,,441.8,797,355.2,1291.1,440.6,-850.5,1.7,0.3,-1.4,7240.8,6877,-363.8,0.6,0,-0.6,2860.8,3522.6,661.8,82.7,94.2,11.5,5.4,11.4,6,34.6,59,24.4,69.8,67.9,-1.89999999999999,9.3,17.4,8.1,117.3,128.3,11,27.2,92.6,65.4,0.4,23.4,23,6.8,58.4,51.6,0,0.2,0.2,53.7,80.1,26.4,0.2,1.8,1.6,0.5,13.1,12.6,11.5,17.5,6,257,177.2,-79.8,0,0.9,0.9,0.2,2.4,2.2,1.8,2.5,0.7,0.7,8,7.3,1.4,2.3,0.9,0.2,3.1,2.9,2.8,7.8,5,0.3,3.6,3.3,0.6,1.8,1.2,2.6,9.5,6.9,83.1,34.6,-48.5,17.1,35.5,18.4,,,,,,,49.2,56.4,7.2,0.1,4.1,4,0.1,3,2.9,237,235.5,-1.5,736,523.8,-212.2,7.4,8.4,1,8.7,9.8,1.1,0,40.9,40.9,128.6,113.1,-15.5,53.1,96.4,43.3,14,16.5,2.5,112.9,181.2,68.3,616.9,462.9,-154,3.9,37.9,34,21,24.1,3.1,110.2,345.5,235.3,0.1,0.1,0,19.8,18.5,-1.3,383.7,183.7,-200,0,0,0,180.5,75.3,-105.2,89.1,52.2,-36.9,0.7,0,-0.7,149.5,96.9,-52.6,1752.6,1676.9,-75.6999999999998,210.2,290.5,80.3,526.1,985.2,459.1,481.1,722.9,241.8,15.6,14.3,-1.3,0,1.7,1.7,1.6,0.2,-1.4,1361.2,1021.7,-339.5,2440.4,1660.6,-779.8,110,79.6,-30.4,24.7,116.5,91.8,,,,,,,30.9,15.8,-15.1,2,2.3,0.3,473.4,370.4,-103,1.5,2.8,1.3,0.5,1.4,0.9,0.2,2.3,2.1,34.1,43.2,9.1,12.6,41.5,28.9,69.9,257.8,187.9,1.2,0,-1.2,9.6,26.5,16.9,0.1,3.2,3.1,0.2,0.1,-0.1,0.1,0.4,0.3,0.6,0.8,0.2,0,0,0,0.1,0,-0.1,0,0,0,0,0,0,0.1,0.1,0,288.9,410.9,122,68.5,84.4,15.9,0.1,0.6,0.5,6.5,6.4,-0.0999999999999996,0,0,0,0,0,0,1219.1,704.9,-514.2,0,0,0,7.7,5.4,-2.3,13.1,9.2,-3.9,2,1.8,-0.2,4.5,1.3,-3.2,9.6,0.1,-9.5,,,,,,,,,,0.2,0.1,-0.1,25.4,58.6,33.2,13.4,14.4,1,6.9,7.1,0.199999999999999,77.2,259.5,182.3,1.1,14.6,13.5,2.1,15.8,13.7,2.2,22.6,20.4,0,0,0,0.3,71.7,71.4,,,,0,0,0,0,0,0,1.4,16.8,15.4,24.6,91.6,67,,,,941.2,507.1,-434.1,10.8,13.3,2.5,70.3,128.9,58.6,20.7,33.9,13.2,17.7,16.4,-1.3,5.7,39.6,33.9,0.3,0.1,-0.2,370.8,176,-194.8,71.3,51.3,-20,5.7,0.3,-5.4,85.4,18,-67.4,83.1,16.4,-66.7,3.7,0.2,-3.5,667.1,528.3,-138.8,0,0.2,0.2,0.7,0,-0.7,0,3.9,3.9,740,355.4,-384.6,891.1,823.7,-67.4,411.7,194.1,-217.6,,,,1.7,6.1,4.4,396.2,237.5,-158.7,75.6,2.5,-73.1,0,0,0,2.7,0.4,-2.3,2503.8,438.8,-2065,0,0,0,0,0,0,1645.9,1227.6,-418.3,942.6,852.4,-90.2,2210.7,1114,-1096.7,8229.3,4194.7,-4034.6,312.5,677.6,365.1,0,0.1,0.1,0,0,0,0,0,0,0,0.1,0.1,1.4,7.6,6.2,118.5,86.1,-32.4,0,0,0,0.1,0,-0.1,0,0,0,0.1,0.9,0.8,0.1,0.1,0,0.2,0.1,-0.1,0,0,0,0.2,2.8,2.6,0,0,0,0.8,1.3,0.5,0,0,0,0.7,6.2,5.5,0.2,3.2,3,0.9,2,1.1,0,0.5,0.5,0,0,0,5.6,8.1,2.5,0.5,0.3,-0.2,13,44.1,31.1,141.3,49.1,-92.2,2.9,14.5,11.6,0,0,0,54.5,214.6,160.1,1.8,5.6,3.8,,,,0,0,0,0,1.2,1.2,0,24.7,24.7,20.7,4.4,-16.3,0.6,2.8,2.2,0.1,1.6,1.5,7.6,3.1,-4.5,10,0.8,-9.2,8.7,4.1,-4.6,5.6,7.8,2.2,0.1,1.6,1.5,0.6,0.7,0.1,0.3,1.2,0.9,573.3,35.7,-537.6,0.1,0.1,0,90.7,2,-88.7,0,0.1,0.1,0,0,0,0,0.4,0.4,0.2,3,2.8,276.9,9.5,-267.4,67.3,9.8,-57.5,0,1,1,0,1.3,1.3,0,0,0,0,1.6,1.6,16.5,2.6,-13.9,0.5,7.5,7,0,0.2,0.2,0,2.9,2.9,1,7.2,6.2,,,,0,0.5,0.5,0.4,1.1,0.7,4.2,4.4,0.2,0,0.1,0.1,0.2,0,-0.2,1.7,2.1,0.4,15.1,1.3,-13.8,1.7,14.1,12.4,9.8,0.9,-8.9,,,,1.9,0,-1.9,0,0.2,0.2,0,0,0,146.3,259.8,113.5,0.5,2.3,1.8,0.8,1.6,0.8,6.2,10.8,4.6,1.9,0,-1.9,10.1,3.7,-6.4,2.5,0.6,-1.9,6.4,0,-6.4,0,13.4,13.4,,,
1992-08-01,2996.4,1694,-1302.4,,,,45466.5,36444.8,-9021.7,,,,,,,6175,7943.4,1768.4,5586.9,3494.9,-2092,2784.1,2827.1,43,10884.1,10184.3,-699.800000000001,,,,,,,18397.2,9872.1,-8525.1,45055,34838.2,-10216.8,20589,11070.1,-9518.9,,,,427.2,777,349.8,1175.4,437.1,-738.3,1,0.2,-0.8,7888.1,7034.6,-853.5,0.1,0,-0.1,2996,3149.7,153.7,85,90.6,5.59999999999999,4.6,11,6.4,31.4,42.4,11,63.1,67.5,4.4,2,14.2,12.2,115.2,109.6,-5.60000000000001,16,83.3,67.3,0.6,19.4,18.8,64.3,61.4,-2.9,0,0.1,0.1,51,65.9,14.9,1.1,1.9,0.8,0.4,16.3,15.9,9.8,20,10.2,192.8,166.3,-26.5,0,0.7,0.7,0,1.9,1.9,1.2,2.9,1.7,1.3,4.6,3.3,0.1,2.7,2.6,0.8,2.1,1.3,2.2,5.2,3,0.3,2.7,2.4,0.4,1.8,1.4,2,7.9,5.9,78.3,30.6,-47.7,63,36.4,-26.6,,,,,,,17.7,17.9,0.199999999999999,0.1,3.6,3.5,0.1,1.8,1.7,222.5,278,55.5,683.5,509.1,-174.4,7.5,5.7,-1.8,3.3,9,5.7,0,1.1,1.1,127.5,89.3,-38.2,58,67.3,9.3,12.9,20.4,7.5,88.6,189.2,100.6,644.8,402.9,-241.9,1.6,33,31.4,19.2,16.5,-2.7,109.9,312.8,202.9,0,0.1,0.1,13.9,8.6,-5.3,272.4,213.5,-58.9,0,0,0,205.1,79.1,-126,88.2,54.8,-33.4,0.5,0,-0.5,115.6,98.4,-17.2,1640.7,1647.4,6.70000000000005,172.5,267.8,95.3,428.1,915.9,487.8,273.7,819.7,546,17.3,14.5,-2.8,0,2.2,2.2,1,0.4,-0.6,1104.7,1013.1,-91.6,2353.9,1646.7,-707.2,99.1,157,57.9,19.4,45.3,25.9,,,,,,,27.1,12.8,-14.3,2.4,0.4,-2,414.1,276.4,-137.7,1.7,2,0.3,0.2,1.1,0.9,0.2,1.2,1,30.5,30.9,0.399999999999999,0.5,31.9,31.4,48.4,263,214.6,1.3,0.1,-1.2,17,32.7,15.7,0.1,0.2,0.1,0,0,0,7,0.1,-6.9,0.6,0.1,-0.5,0.2,0,-0.2,0.1,0.1,0,0,0,0,0,0,0,0.1,6.6,6.5,240.1,383.2,143.1,71.7,68.2,-3.5,0,1,1,6.5,4,-2.5,0,0,0,0,0,0,1196.4,726.9,-469.5,0,0,0,3.3,12.7,9.4,15.6,3,-12.6,1.8,0.6,-1.2,7.8,0.2,-7.6,1.1,1.2,0.0999999999999999,,,,,,,,,,0.2,0.2,0,16.1,78.3,62.2,6.1,15.6,9.5,3.5,5.8,2.3,59,190.5,131.5,0.7,15.7,15,0.4,6.8,6.4,3.4,25.2,21.8,0,0,0,0,90.4,90.4,,,,0,0,0,0,0,0,0.7,29.6,28.9,31.1,83.2,52.1,,,,863.4,499.5,-363.9,5.9,11.4,5.5,84.4,118.8,34.4,3.4,34.4,31,32.5,17.2,-15.3,7.1,18.2,11.1,0.2,0.1,-0.1,315.7,155.9,-159.8,65.5,94.3,28.8,5,0.2,-4.8,84,17.4,-66.6,70.5,17.6,-52.9,2.9,0.2,-2.7,745.4,396.8,-348.6,0,0.5,0.5,0.4,0,-0.4,0,2.4,2.4,821,464.5,-356.5,993,699.7,-293.3,435.5,167,-268.5,,,,1.4,35.8,34.4,416.3,212,-204.3,73,1.8,-71.2,0,0,0,1.2,0,-1.2,2613,730.4,-1882.6,0.9,0,-0.9,0,0,0,1480.2,1029,-451.2,904.7,688,-216.7,2209,1078.2,-1130.8,8039.4,4013.2,-4026.2,310,649,339,0,0,0,0,0,0,0,0,0,0,0,0,1.2,5.6,4.4,99.4,98.1,-1.30000000000001,0,0.2,0.2,0.1,0.1,0,0,0,0,0.1,0.7,0.6,0.1,0.1,0,0,0.2,0.2,0,0,0,0,3,3,0,0,0,5.5,2.5,-3,0,0,0,3.4,5.9,2.5,0.2,2.7,2.5,1.2,3.2,2,0,1.1,1.1,0,0,0,5.6,4.1,-1.5,0.4,0.5,0.1,15.6,33.4,17.8,142.5,37.5,-105,1.8,18.7,16.9,0,0,0,45.2,272,226.8,1.4,1,-0.4,,,,0,0,0,0,0.6,0.6,1,0.5,-0.5,31.6,7,-24.6,0.4,5.7,5.3,0.1,0.4,0.3,7.1,4.1,-3,4.9,1.5,-3.4,12.6,7.9,-4.7,5.5,7,1.5,0,0.3,0.3,0.1,2.8,2.7,0.2,2.1,1.9,506.6,84.3,-422.3,0.1,0.1,0,116,3.4,-112.6,0.3,0.3,0,0.1,0,-0.1,0,0.6,0.6,0,2.2,2.2,220.4,19.1,-201.3,44,6.9,-37.1,0,0.2,0.2,0,0.2,0.2,0,0,0,1.4,1.4,0,28.5,4.1,-24.4,0.3,0.9,0.6,0,0.4,0.4,0.8,0,-0.8,1.4,19.2,17.8,,,,0,0.4,0.4,0.4,1.2,0.8,5.5,9.7,4.2,0.4,0.2,-0.2,0,0,0,0.7,1.7,1,12.1,2.3,-9.8,0.8,7.6,6.8,1.3,0.5,-0.8,,,,0,0,0,0,0.3,0.3,0,0,0,146.7,219.4,72.7,0.5,2,1.5,1.7,0.8,-0.9,0.3,7.6,7.3,0.9,0.1,-0.8,7,17.5,10.5,6.3,1,-5.3,7.5,0.1,-7.4,0,10.2,10.2,,,
1992-09-01,2868.9,1715.1,-1153.8,,,,45670.9,37469.5,-8201.4,,,,,,,6699,8870.8,2171.8,5569,3789.5,-1779.5,3080.5,2814,-266.5,11631.9,11381.8,-250.1,,,,,,,18667.5,10142.7,-8524.8,46502.8,36811.6,-9691.2,21002.4,10857.9,-10144.5,,,,375.2,1161.7,786.5,948.5,506.1,-442.4,2.3,0.1,-2.2,8624.2,7849.7,-774.500000000001,0,0.2,0.2,3007.7,3532.1,524.4,84.2,105.7,21.5,3.2,9.1,5.9,33.6,73.6,40,75.5,69.9,-5.59999999999999,7.4,15.6,8.2,129.3,110.2,-19.1,17.7,93.3,75.6,1.4,20.3,18.9,130.2,64.2,-66,0,0.1,0.1,54.4,79.5,25.1,0.7,2.5,1.8,0.2,11.5,11.3,11.6,19.5,7.9,236.9,191.4,-45.5,0,0.9,0.9,0.1,2.2,2.1,2.1,1.7,-0.4,0.2,3.7,3.5,0.1,2.4,2.3,0.6,1.7,1.1,2.8,6.6,3.8,0.3,2.5,2.2,0.5,1.6,1.1,2.6,10.4,7.8,63.9,32.9,-31,70.1,30.1,-40,,,,,,,23.8,16.7,-7.1,0.1,4,3.9,0.1,1.5,1.4,279.2,215.4,-63.8,824,453.9,-370.1,7.7,11,3.3,1.7,10.6,8.9,0,0.9,0.9,132,79.2,-52.8,58.1,94.3,36.2,16.4,20,3.6,115.5,205.2,89.7,567,417.6,-149.4,3.6,29.2,25.6,19.4,17.8,-1.6,102.3,273.6,171.3,0,0,0,6,7.3,1.3,408.7,220.9,-187.8,0,0.1,0.1,180.8,151.6,-29.2,90.2,66.2,-24,1.3,0.3,-1,156.4,130.6,-25.8,1748,1724.7,-23.3,166.4,281.9,115.5,472.9,1050.5,577.6,402,899.5,497.5,16.4,17.9,1.5,0,1.8,1.8,1,0.3,-0.7,1207.3,1261,53.7,2320.7,1605.2,-715.5,106.5,83.3,-23.2,21.3,29.8,8.5,,,,,,,22.5,19.7,-2.8,2.2,0.7,-1.5,532.8,328.3,-204.5,1.2,2.9,1.7,0.2,1.4,1.2,0.6,3.4,2.8,31,40.8,9.8,0.1,19.1,19,66.1,191.7,125.6,3,1.1,-1.9,26.3,10,-16.3,0.7,2.7,2,0,0,0,0,9.7,9.7,0,3.1,3.1,0,0,0,0.1,0.1,0,0,0,0,0,0.3,0.3,0.1,8.2,8.1,218.7,421.7,203,51.1,75.3,24.2,0.6,1,0.4,8.1,5.3,-2.8,0,0,0,0.1,0,-0.1,855.8,682.9,-172.9,0,0,0,8.7,14.7,6,15.6,5.3,-10.3,1.9,0.2,-1.7,6.8,0.4,-6.4,0.7,0.6,-0.1,,,,,,,,,,0.3,2.4,2.1,31.2,75.2,44,5.5,38.1,32.6,5,9.9,4.9,73.4,205.9,132.5,0.8,16.5,15.7,5,11.2,6.2,1.9,23.8,21.9,0,0,0,0,40.2,40.2,,,,0,0,0,0,0,0,1.4,30.4,29,18.9,109.7,90.8,,,,885.2,545.7,-339.5,4,15.3,11.3,60.1,124.3,64.2,5.1,6.2,1.1,15.2,12.3,-2.9,3.9,20,16.1,0,0.2,0.2,349.8,126.1,-223.7,74.4,106.8,32.4,4.6,0.5,-4.1,86.8,21.2,-65.6,75.5,11,-64.5,3.2,0.3,-2.9,749.1,271,-478.1,0,0.4,0.4,0.9,0.3,-0.6,0,1.7,1.7,758,391.1,-366.9,1066.5,769.4,-297.1,376.1,220.2,-155.9,,,,2.6,91.9,89.3,431.5,235.2,-196.3,86.7,0.9,-85.8,0,0,0,1.9,0.1,-1.8,2760.5,489.3,-2271.2,1.1,0,-1.1,0,0,0,1420.4,1063.3,-357.1,929.8,734.5,-195.3,2152.3,1222.3,-930,8319.3,3819.6,-4499.7,274.8,870.1,595.3,0,0,0,0,0,0,0,0,0,0,0,0,14.1,4.8,-9.3,74.8,230.1,155.3,0,0.2,0.2,0.1,0.1,0,0,0,0,0.1,32.8,32.7,0.2,0.1,-0.1,0,0.2,0.2,0,0,0,0.1,2.5,2.4,0,0,0,0,6.3,6.3,0,0,0,1.3,6.4,5.1,0.2,2.9,2.7,0.7,1.8,1.1,0,0.7,0.7,0.1,0,-0.1,8.5,2.1,-6.4,0.2,0.6,0.4,11.5,35.3,23.8,129.8,30.3,-99.5,4.7,16,11.3,0,0,0,37.5,247.7,210.2,1.1,1.7,0.6,,,,0,0,0,0,0.4,0.4,0.1,9,8.9,0.9,5,4.1,0.6,8.8,8.2,0.1,1.5,1.4,7,11.2,4.2,4.5,1.5,-3,11.3,4.6,-6.7,9.8,8.3,-1.5,0,0.8,0.8,0.1,1.7,1.6,3.7,1.8,-1.9,365.2,93,-272.2,0,0,0,73.6,3.2,-70.4,0,0.4,0.4,0,0,0,0,0.4,0.4,3.6,4.1,0.5,187.6,11.3,-176.3,47.1,1.9,-45.2,0,0,0,0,0.2,0.2,0.3,0.3,0,2.3,5.2,2.9,22.3,4.6,-17.7,0.8,0.1,-0.7,1.3,0.5,-0.8,0.7,1.6,0.9,1.4,12.4,11,,,,0,1.3,1.3,0.8,0.7,-0.1,5.3,21.2,15.9,0.2,0.3,0.1,0,0,0,1,2.9,1.9,11.2,3.4,-7.8,1.2,32.1,30.9,5.6,0.6,-5,,,,0.4,0,-0.4,0,0.5,0.5,0,0,0,155.7,209.7,54,2.9,1.7,-1.2,0.8,1.4,0.6,2.5,10,7.5,0.8,0.5,-0.3,7.4,33,25.6,4.2,4.2,0,4.5,0,-4.5,0,16.1,16.1,,,
1992-10-01,3219.4,2036.1,-1183.3,,,,46159.5,38931.7,-7227.8,,,,,,,6696.9,9517,2820.1,5806.7,4482.4,-1324.3,3025.2,3227.8,202.6,12498.7,11446.6,-1052.1,,,,,,,19668.6,11402.4,-8266.2,49820.2,40115.1,-9705.10000000001,21929.2,12586,-9343.2,,,,361.4,962.6,601.2,1273.7,578.9,-694.8,2.2,0.6,-1.6,9100.3,8009.4,-1090.9,0,0.1,0.1,3398.4,3437.2,38.7999999999997,82.3,109.8,27.5,3.8,8.8,5,33.2,87.4,54.2,72.2,74.3,2.09999999999999,5.5,25.6,20.1,125.8,126,0.200000000000003,16.2,101.4,85.2,1,20.2,19.2,40.8,57.3,16.5,0,0.1,0.1,55.7,89.1,33.4,0.6,3.2,2.6,1,10.6,9.6,10.8,23.6,12.8,206.6,206.4,-0.199999999999989,0,0.9,0.9,0.7,3.5,2.8,2.1,2.7,0.6,0.4,7.1,6.7,0.1,0.8,0.7,0.4,4.8,4.4,2,6.7,4.7,0.4,2.7,2.3,0.9,2.2,1.3,2.6,12.6,10,78.2,74.1,-4.10000000000001,59.2,49.1,-10.1,,,,,,,29.1,25.5,-3.6,0.2,4,3.8,0,3.6,3.6,309,321.2,12.2,864.5,489.7,-374.8,13.7,12.8,-0.899999999999999,3,12.8,9.8,0,0.9,0.9,106.6,96.7,-9.89999999999999,58.7,88.6,29.9,15,17.7,2.7,84,199.2,115.2,592.5,474.8,-117.7,2,38.7,36.7,20,22.1,2.1,124.4,308.5,184.1,0,0,0,21,10.2,-10.8,435,313,-122,0,0.1,0.1,242,98.8,-143.2,134,78.2,-55.8,3,0.1,-2.9,156.1,97.4,-58.7,1933.2,2184.3,251.1,187.5,211.2,23.7,528.1,1294.5,766.4,463.5,866.6,403.1,23.6,18,-5.6,0,2.2,2.2,0.9,0.3,-0.6,1333.7,1201.8,-131.9,2803.7,1946.1,-857.6,116.1,83.1,-33,25,22.3,-2.7,,,,,,,30.4,15.9,-14.5,4.2,1.2,-3,473.9,345.6,-128.3,1.3,11.2,9.9,0.7,8.4,7.7,1,7.6,6.6,32.5,58.8,26.3,0.1,16.7,16.6,49,257.7,208.7,0.3,8.8,8.5,9.1,14.8,5.7,0.4,4.6,4.2,0,0,0,0,4.3,4.3,0.8,6.2,5.4,0,0,0,0,0.2,0.2,0,0,0,0.2,0,-0.2,0.1,17.4,17.3,290.1,501.2,211.1,62,76.6,14.6,0.6,1.5,0.9,8.5,4.4,-4.1,0,0,0,0.1,0,-0.1,1011.9,638.7,-373.2,0,0,0,7.8,25.1,17.3,16.9,9.2,-7.7,1.1,0.1,-1,8.3,0.6,-7.7,0.1,0.1,0,,,,,,,,,,0.9,7.7,6.8,29.1,78.7,49.6,5.8,23.7,17.9,5.3,10.2,4.9,80.6,201.2,120.6,1,12.9,11.9,0.5,18.8,18.3,2.1,46.2,44.1,0,0,0,0,99.1,99.1,,,,0,0,0,0,0,0,3.1,17.8,14.7,62.8,92.8,30,,,,867.5,589.2,-278.3,4.9,16.9,12,35,133,98,0.9,27,26.1,9.3,19.3,10,4.5,23.7,19.2,0,0.2,0.2,367.1,185.9,-181.2,79.3,100.5,21.2,4.6,0.9,-3.7,83.2,17.5,-65.7,70.3,19.2,-51.1,3.9,0.2,-3.7,723.9,276.8,-447.1,0,0.4,0.4,1,0.3,-0.7,0,1.8,1.8,785.6,411.1,-374.5,983.9,950.6,-33.3,446.1,363.3,-82.8,,,,3,8.2,5.2,425,308.3,-116.7,76.6,2.2,-74.4,0,0.5,0.5,2.3,0,-2.3,2748.4,746.3,-2002.1,1.5,0,-1.5,0,0,0,1550.7,1179.6,-371.1,1046.1,887.1,-159,2226,1465.1,-760.9,9031.1,4143.8,-4887.3,272.6,820.4,547.8,0,0,0,0,0,0,0,0,0,0,0.1,0.1,2.8,5.6,2.8,70.8,110.7,39.9,0,0.5,0.5,0.1,0,-0.1,0,0,0,0.1,1,0.9,0.1,0.5,0.4,0,0.1,0.1,0,0,0,0,1.9,1.9,0,0,0,1.2,3.9,2.7,0,0,0,0.4,8.6,8.2,0.6,3.2,2.6,1.1,1.9,0.8,0.1,0.7,0.6,0.1,0.2,0.1,11.3,2.6,-8.7,0.1,0.7,0.6,15.6,56.7,41.1,129.5,75.5,-54,6.9,20.1,13.2,0,0,0,37.1,249.7,212.6,0.4,7.6,7.2,,,,0,0,0,0,0.2,0.2,0,0.6,0.6,1.1,6.5,5.4,3.3,4.5,1.2,0.2,2.9,2.7,7.6,6.3,-1.3,7,2.6,-4.4,6.5,7.6,1.1,8.9,14.6,5.7,0.1,1.9,1.8,0,0.7,0.7,0.3,0.9,0.6,606.1,69.9,-536.2,0,0.4,0.4,96.5,10,-86.5,0,0.2,0.2,0,0,0,0,1.7,1.7,0,1.5,1.5,238.1,12.1,-226,86.4,2.1,-84.3,0,0,0,0,0.6,0.6,0,0.4,0.4,1.1,2.2,1.1,23.5,3.9,-19.6,0.3,0.1,-0.2,0,0.2,0.2,0,2.5,2.5,0.2,68.7,68.5,,,,0,0.6,0.6,1.1,3.2,2.1,4.7,8,3.3,0,0.3,0.3,0,0,0,0.3,5,4.7,12.3,1.6,-10.7,0.9,2.8,1.9,3.6,0.8,-2.8,,,,0,0.1,0.1,0,0.5,0.5,0,0,0,143.6,352,208.4,1.1,2.6,1.5,1.7,3.3,1.6,4.2,3,-1.2,1.4,0.3,-1.1,3.9,29.3,25.4,3.7,0.7,-3,3.8,0.6,-3.2,0,41.8,41.8,,,
1992-11-01,2865.3,1641.3,-1224,,,,45971.2,37744.3,-8226.89999999999,,,,,,,6289.1,8451.3,2162.2,5338.5,4380.6,-957.9,2882.1,3125.9,243.8,11479,11063.4,-415.6,,,,,,,18250.5,10584.3,-7666.2,46313.2,37670.5,-8642.7,20401.6,11716.9,-8684.7,,,,442,887.2,445.2,990.3,496.8,-493.5,2.1,0.2,-1.9,8464.1,7662.5,-801.6,0,0.1,0.1,3014.9,3400.9,386,80,133.3,53.3,3.4,9,5.6,28.5,57,28.5,70.1,72.1,2,6.3,17.6,11.3,121.7,113,-8.7,14.9,100.1,85.2,0.4,19.2,18.8,23.8,61.5,37.7,0,0.1,0.1,49.1,82.4,33.3,0.5,4.5,4,0.1,11.8,11.7,10.3,19.5,9.2,198.2,180.6,-17.6,0,1,1,0.1,3.3,3.2,2.1,3.1,1,0.5,5.4,4.9,0.2,0.9,0.7,0.2,2.5,2.3,2.4,7.5,5.1,0.5,3.6,3.1,0.4,1.7,1.3,2.5,11.7,9.2,84.2,38.4,-45.8,63.1,48.2,-14.9,,,,,,,16.1,25.1,9,0.2,4.3,4.1,0,3.3,3.3,206.1,333.4,127.3,763.4,441.9,-321.5,7.7,8.5,0.8,0.6,12.7,12.1,0,2,2,98.2,66.6,-31.6,58.5,87.1,28.6,11.2,20.1,8.9,81.6,258.4,176.8,766.9,500.7,-266.2,1.9,36.2,34.3,15.6,24.6,9,90.6,292,201.4,0,0,0,8.7,7.9,-0.799999999999999,469.2,195.3,-273.9,0,0.4,0.4,150,98.7,-51.3,105.6,60.5,-45.1,2.5,0.2,-2.3,138,111.1,-26.9,1711.1,1890.2,179.1,187.8,224,36.2,420.3,1132.5,712.2,419.1,791.1,372,16.9,17.1,0.200000000000003,0,0.4,0.4,1.9,0.9,-1,1250.5,1099.1,-151.4,2646.8,1635.9,-1010.9,115.8,165.6,49.8,19.2,25.3,6.1,,,,,,,25.8,25.7,-0.100000000000001,8.3,0.6,-7.7,519,422,-97,0.7,6.9,6.2,0.2,11.8,11.6,0.4,3.5,3.1,32.7,79.9,47.2,0.1,11.3,11.2,49.5,243.1,193.6,8.1,9,0.9,1.8,108,106.2,0,4.7,4.7,0,0.2,0.2,0,0.6,0.6,0.8,0.7,-0.1,0.2,0.1,-0.1,0,7.2,7.2,0,8.2,8.2,0,33.5,33.5,0.1,1.2,1.1,282.6,432.1,149.5,54.5,79.1,24.6,0,2.1,2.1,9.9,9.2,-0.700000000000001,0,0,0,0,0,0,1128.2,605.2,-523,0,0,0,5.9,15.2,9.3,14.5,3.5,-11,0.8,1.6,0.8,5.1,1.1,-4,0,0.1,0.1,,,,,,,,,,0.8,7.1,6.3,30,69.5,39.5,7.4,25.8,18.4,3.2,7.8,4.6,70.7,162.8,92.1,0.7,15.8,15.1,0.5,11.6,11.1,2.4,39.4,37,0,0,0,0,67,67,,,,0,0,0,0,0,0,1.8,37,35.2,53.2,79.6,26.4,,,,841.7,447.4,-394.3,3.5,13,9.5,102.5,133.5,31,3,39.5,36.5,16.9,18.4,1.5,4.6,12.8,8.2,0,0.9,0.9,273.9,140.7,-133.2,68.1,91.3,23.2,2.9,0.3,-2.6,54.7,17.8,-36.9,65.6,13.5,-52.1,3.4,0.2,-3.2,705.1,508.1,-197,0,0.4,0.4,1,0.1,-0.9,0.1,5,4.9,761.4,396.7,-364.7,1085.5,727.4,-358.1,394.6,209.8,-184.8,,,,1.6,4.8,3.2,382.6,276.9,-105.7,47.9,2.9,-45,0,0.2,0.2,2,0.1,-1.9,2316,620.5,-1695.5,1,0.1,-0.9,0,0,0,1343.7,1128.5,-215.2,879.5,845.4,-34.1,2029.8,1679.3,-350.5,8574.1,3827.2,-4746.9,328.7,767.1,438.4,0.1,0.1,0,0,0,0,0,0,0,0,0,0,21.6,3.8,-17.8,83.5,94,10.5,0,0.1,0.1,0.2,0.3,0.1,0,0,0,0.1,0.5,0.4,0.1,0.5,0.4,0,0.1,0.1,0,0,0,0,1.9,1.9,0,0,0,0,2.8,2.8,0,0,0,0.3,7.3,7,0.6,2.5,1.9,2.9,2.3,-0.6,0,0.6,0.6,0,0,0,3.5,2.8,-0.7,0.4,0.5,0.1,18.2,61.8,43.6,137.8,60.5,-77.3,2.8,21.9,19.1,0,0,0,31.4,263.4,232,0.5,2.2,1.7,,,,0.1,0,-0.1,0,0.4,0.4,0,10.6,10.6,2.5,5.4,2.9,0.4,10.8,10.4,0.1,0.6,0.5,4.8,1.1,-3.7,9.6,3.2,-6.4,10.3,9.7,-0.600000000000001,9.8,17.1,7.3,0,1.4,1.4,0,0.6,0.6,0.2,4.7,4.5,391.8,116.3,-275.5,0.1,0.1,0,78.5,5.9,-72.6,0,0.5,0.5,0,0,0,0,1.7,1.7,0.2,1.9,1.7,220.7,13.4,-207.3,51.3,5.9,-45.4,0,0.1,0.1,0,1.1,1.1,0,0.6,0.6,0.2,1,0.8,21.7,2.5,-19.2,1.2,0.1,-1.1,0.1,0.1,0,0,1.5,1.5,0.4,6.7,6.3,,,,0,1.8,1.8,0.4,0.8,0.4,4.9,11.8,6.9,0,0.3,0.3,0,0,0,0.4,2.3,1.9,10.8,3.5,-7.3,0.9,0.4,-0.5,0.6,0.2,-0.4,,,,0.8,0,-0.8,0,0.2,0.2,0,0,0,142.1,237.9,95.8,1.5,6.4,4.9,0.4,3.9,3.5,0.3,2.2,1.9,7.8,0.2,-7.6,5,3.3,-1.7,6.9,0.6,-6.3,3.5,0.7,-2.8,0,93.1,93.1,,,
1992-12-01,2836.1,1805.2,-1030.9,,,,46238.6,38830.9,-7407.7,,,,,,,6806,9871.3,3065.3,5166.9,4505.9,-661,2811.3,3249.6,438.3,11068.5,10429.9,-638.6,,,,,,,18248.8,11394.6,-6854.2,45812.5,38536.7,-7275.8,20370.3,12543.4,-7826.9,,,,366.1,1112.5,746.4,861.1,425.4,-435.7,0.9,0.1,-0.8,8236.4,7060.9,-1175.5,0,0,0,2832.1,3369,536.9,93.9,150.3,56.4,2.8,10.1,7.3,27.9,57,29.1,70.5,70.1,-0.400000000000006,9.3,12.4,3.1,119.3,122.8,3.5,21.3,92.4,71.1,0.4,16.3,15.9,76.9,56.9,-20,0,0.1,0.1,51.3,87.8,36.5,0.7,3.8,3.1,0.5,26,25.5,11.7,19.8,8.1,204.6,155.6,-49,0,1,1,0.2,3.3,3.1,1.9,2.6,0.7,0.6,6.1,5.5,0,0.5,0.5,0.3,1.8,1.5,2.6,6.8,4.2,0.4,2.9,2.5,0.6,2.5,1.9,2.4,12.3,9.9,64.8,31.8,-33,55.4,39.2,-16.2,,,,,,,0.5,12.9,12.4,0.1,4,3.9,0,3.4,3.4,218.8,272.4,53.6,758.8,356.1,-402.7,4.1,13.5,9.4,5.7,17.4,11.7,0,0.8,0.8,116.7,80.2,-36.5,57.6,107,49.4,18.6,31.6,13,106.9,255.9,149,573.3,721.8,148.5,2.5,25.6,23.1,18.3,17.7,-0.600000000000001,109.1,337.1,228,0,0,0,16.1,6.5,-9.6,373.3,195.9,-177.4,0,0,0,182.2,97.7,-84.5,105.4,56,-49.4,3.9,0,-3.9,152.6,94.1,-58.5,1758.7,1910.7,152,287.1,209.4,-77.7,457.8,1240.4,782.6,394,838.1,444.1,19.3,16.9,-2.4,0,1.8,1.8,1,1.4,0.4,1357.3,1192.7,-164.6,2722.1,1756.3,-965.8,109.8,188.9,79.1,25.7,47.2,21.5,,,,,,,35.2,21.2,-14,6.6,0.6,-6,513.3,492.5,-20.8,1,2,1,3.4,4.9,1.5,0.8,6.1,5.3,39.6,178.8,139.2,0.1,13.1,13,63.4,142.7,79.3,4.2,5.8,1.6,11.3,41.2,29.9,0.1,0,-0.1,0,0,0,0,0.8,0.8,0.6,0.4,-0.2,0,0,0,0,0,0,0.7,0,-0.7,0,0,0,0.1,16.8,16.7,238.6,324.1,85.5,51.7,74.3,22.6,0.1,1.4,1.3,9,5.8,-3.2,0,0,0,0,0,0,1035.8,644.1,-391.7,0,0,0,7,10.9,3.9,16.9,4.2,-12.7,1.8,0.3,-1.5,11.8,0.4,-11.4,0,0,0,,,,,,,,,,1.7,3.6,1.9,31.5,92.7,61.2,4.9,26.6,21.7,13.5,7.6,-5.9,98.9,286.1,187.2,0.7,15.7,15,7.9,25,17.1,2.5,39.2,36.7,0,0,0,0,31.8,31.8,,,,0,0,0,0,0,0,3.2,14.9,11.7,85.8,135.6,49.8,,,,875.8,623.4,-252.4,4.7,17.7,13,35.5,156.4,120.9,1.1,14.7,13.6,20.9,45.3,24.4,8.7,15.8,7.1,0,0.8,0.8,263.6,161.6,-102,71.9,68.9,-3,5.1,0.3,-4.8,53,17.7,-35.3,68.3,19.7,-48.6,2.5,0.6,-1.9,635.7,467.8,-167.9,0,0.2,0.2,0.5,0.1,-0.4,0,0.1,0.1,768.1,468.4,-299.7,1051.3,977.5,-73.8,407.3,215.9,-191.4,,,,2.4,3.1,0.7,391.2,248.2,-143,44.4,3.9,-40.5,0,0.1,0.1,2.7,0.3,-2.4,2027,881.7,-1145.3,1.3,1.6,0.3,0,0,0,1296.1,1219.9,-76.1999999999998,789,890.9,101.9,2030.5,1417.6,-612.9,9084.2,3982.9,-5101.3,280.9,982.7,701.8,0,0.1,0.1,0,0,0,0.1,0,-0.1,0.1,0,-0.1,9.2,2.5,-6.7,67.2,99.4,32.2,0,0.2,0.2,0.1,0,-0.1,0,0,0,0.1,0.8,0.7,0.1,0.2,0.1,0,0.1,0.1,0,0,0,0,1.8,1.8,0,0,0,0.5,8,7.5,0,0,0,1,8.2,7.2,0.2,2.7,2.5,0.6,2.6,2,0,0.9,0.9,0.1,0,-0.1,5.6,1.8,-3.8,0.3,0.5,0.2,17,42.3,25.3,113.9,92.1,-21.8,2.6,14.5,11.9,0,0,0,29.8,265,235.2,0.1,3.1,3,,,,0,0,0,0.1,0,-0.1,0.1,2.9,2.8,0.5,3.9,3.4,0.2,10.6,10.4,0.5,0.8,0.3,4,2.8,-1.2,5,1.7,-3.3,20.1,16.6,-3.5,8.3,5.8,-2.5,0.2,0.6,0.4,0,0.5,0.5,0.1,0.4,0.3,352.3,93,-259.3,0,0,0,85.2,3,-82.2,0,1.4,1.4,0,0,0,0,0.7,0.7,0,2.1,2.1,132,5.8,-126.2,22.2,1.2,-21,0,0,0,0,0.1,0.1,0,0.4,0.4,0.3,0.1,-0.2,14.4,2.4,-12,0.3,0.1,-0.2,0,0.1,0.1,0.2,6.6,6.4,0.4,43.7,43.3,,,,0,0.8,0.8,1.2,0.5,-0.7,5.7,16.8,11.1,0.1,0.3,0.2,0,0,0,1.1,5.1,4,12.2,1.6,-10.6,1.1,2,0.9,8.4,0.6,-7.8,,,,0.9,0,-0.9,0,0.3,0.3,0,0,0,155.7,204.6,48.9,1.3,1,-0.3,0.5,2.3,1.8,4.8,6.9,2.1,1,0.4,-0.6,6.4,12.6,6.2,9.9,2.2,-7.7,4.7,1,-3.7,0,39.2,39.2,,,
1993-01-01,2733,1609.7,-1123.3,,,,45495,37616,-7879,,,,,,,5503.2,8349.7,2846.5,4975.1,4165.8,-809.3,2600.7,2717.2,116.5,10705.9,10070.9,-635,,,,,,,16744.8,10127.4,-6617.4,42057.7,35957.9,-6099.8,18967.1,11507.9,-7459.2,,,,434.7,695.6,260.9,1013.3,354,-659.3,1.3,0.1,-1.2,7909.8,6878.4,-1031.4,0,0,0,2796.1,3192.5,396.4,104.6,99.8,-4.8,3.8,10.6,6.8,30.3,54.6,24.3,54,65.9,11.9,5.5,13.2,7.7,90.4,122,31.6,14.6,100.7,86.1,0.3,18.9,18.6,10.4,47.3,36.9,0,0.1,0.1,48.2,89.1,40.9,0.4,2.1,1.7,1.1,11.7,10.6,7,15.2,8.2,118.7,150.5,31.8,0,1.2,1.2,0.1,3,2.9,1.5,2.6,1.1,0.9,5.9,5,0,0.5,0.5,0.3,2.1,1.8,1.8,6.4,4.6,0.2,2.8,2.6,0.7,1.8,1.1,1.7,12.1,10.4,59.5,52.3,-7.2,30.7,41.4,10.7,,,,,,,19.3,20.1,0.800000000000001,0.2,4.3,4.1,0.2,3.3,3.1,281.6,235.3,-46.3,686.2,407,-279.2,9.1,9.3,0.200000000000001,5.6,10.1,4.5,0,0.6,0.6,106.5,74.6,-31.9,64.4,70,5.59999999999999,13.4,18.3,4.9,144,220.9,76.9,536.7,437.3,-99.4,6.9,36.2,29.3,25.2,19.9,-5.3,114.7,216.2,101.5,0,0,0,13.6,6.4,-7.2,320,217.2,-102.8,0,0,0,126.2,105.5,-20.7,99.6,67.4,-32.2,1.4,0,-1.4,123.4,109.4,-14,1504.4,2339,834.6,189.2,256.4,67.2,423.4,1158.1,734.7,408.9,722.8,313.9,19.4,46.4,27,0,0.3,0.3,1.1,0.7,-0.4,1011.5,1290.3,278.8,1944.2,1748.3,-195.9,84,99.1,15.1,0,0,0,16.9,24.4,7.5,2.3,0.3,-2,36.6,18.3,-18.3,6.4,0.5,-5.9,345.1,358.5,13.4,1.4,1.8,0.4,0.6,6,5.4,1.1,0.8,-0.3,26.4,74,47.6,0,0,0,47.4,152,104.6,0.2,7.2,7,7.8,14.3,6.5,0,3,3,0,0.9,0.9,0,0.2,0.2,4.7,5.7,1,0.1,0,-0.1,0,0.1,0.1,0,0,0,0,0,0,0.2,18.2,18,236.8,375.1,138.3,51.1,65.1,14,0.1,1.9,1.8,5.9,5.8,-0.100000000000001,0,0.1,0.1,0,0,0,916.3,582.3,-334,0,0,0,9.1,6.6,-2.5,13.6,6.5,-7.1,1.2,0.3,-0.9,15.7,0.3,-15.4,0,1.1,1.1,,,,,,,,,,0.5,1.7,1.2,41.7,75.8,34.1,8,12.1,4.1,17.4,6.8,-10.6,84.2,231.6,147.4,0.4,16.5,16.1,3.6,14.9,11.3,2.4,39.2,36.8,0,0,0,0,50.9,50.9,0,0,0,0,0,0,0,0,0,1.3,36.9,35.6,64.3,93.6,29.3,0,0,0,880.7,551.3,-329.4,4.9,13.8,8.9,65.7,130.5,64.8,5.7,25.7,20,17.2,18.1,0.900000000000002,6.4,39.8,33.4,0,0,0,334.7,184.4,-150.3,70.8,117.2,46.4,5.3,0.3,-5,58.4,8.2,-50.2,76,21.2,-54.8,2.8,0.8,-2,650.6,302.9,-347.7,0,0.2,0.2,0.7,0,-0.7,0,0.4,0.4,705.7,450.4,-255.3,851.1,950.3,99.1999999999999,413,210.6,-202.4,,,,1.9,4.9,3,354.5,278.6,-75.9,52.3,2.4,-49.9,0,0,0,2.5,0,-2.5,2187.6,620.7,-1566.9,0.9,0.4,-0.5,0,0,0,1365.5,1201.9,-163.6,788.8,748.1,-40.6999999999999,1969.7,1265.5,-704.2,7636.6,3719.2,-3917.4,340.2,590.6,250.4,0,0.1,0.1,0,0.1,0.1,0,0,0,0,0,0,1.4,3.3,1.9,76.5,81,4.5,0,0.3,0.3,0.1,0,-0.1,0,0,0,0.1,2.3,2.2,0.3,0,-0.3,0,0,0,0,0,0,0,1.9,1.9,0,0,0,3.8,2.1,-1.7,0,0,0,0.9,4.8,3.9,0.4,2.4,2,2.5,2,-0.5,0,0.6,0.6,0,0,0,8.2,3.8,-4.4,0.3,0.3,0,15.2,36.7,21.5,112.8,74.7,-38.1,2.5,23.7,21.2,0,0,0,34.4,225.5,191.1,0.1,3.8,3.7,,,,0,0,0,0,0,0,0.1,0.7,0.6,0.6,4.6,4,0.1,5,4.9,0.2,1.3,1.1,7.6,2.6,-5,7.7,0.9,-6.8,29.2,6.4,-22.8,12.3,14.6,2.3,0.1,1.4,1.3,0.5,0.5,0,0.2,1.2,1,459.6,75,-384.6,0,0,0,45.7,2.4,-43.3,0,0.3,0.3,0,0,0,0,0.7,0.7,0,2,2,224.7,8.5,-216.2,8.1,1.5,-6.6,0,0,0,0,0.7,0.7,0,0.6,0.6,0.3,0.3,0,21.3,3.2,-18.1,0.4,0.1,-0.3,0.1,0.3,0.2,0,2.3,2.3,0.3,8.4,8.1,0,0,0,0,1.4,1.4,0.9,3,2.1,5.7,8.7,3,0.3,0.6,0.3,0,0,0,1,3.2,2.2,18.1,1.7,-16.4,0.5,9.1,8.6,3,0.7,-2.3,,,,0,0,0,0,0.1,0.1,0,0,0,137.5,168.4,30.9,2.8,2.9,0.1,0.3,1.8,1.5,0.6,6,5.4,1.3,0,-1.3,11.1,1.7,-9.4,4.7,3.1,-1.6,6.6,0.4,-6.2,0,0,0,,,
1993-02-01,2485.9,1511.9,-974,,,,45102,37064,-8038,,,,,,,5723.2,8291.5,2568.3,4215,3790.7,-424.3,2456.7,2705.6,248.9,11511.8,11035.2,-476.599999999999,,,,,,,15855.1,9807.4,-6047.7,41816.7,36070.4,-5746.3,17998.7,10907.9,-7090.8,,,,314.4,732.1,417.7,930.7,402.2,-528.5,0.5,0.2,-0.3,8520.3,7746.7,-773.599999999999,0,0,0,2991.5,3288.5,297,95.6,101.1,5.5,8.1,9.7,1.6,48.2,90.3,42.1,76.1,71.8,-4.3,10.7,12.2,1.5,129.6,136.3,6.70000000000002,19.8,99,79.2,9.5,19.7,10.2,15.5,53.3,37.8,0,0.2,0.2,51.1,83.3,32.2,0.3,1.4,1.1,0.5,10.5,10,11.1,17.4,6.3,190.9,167.4,-23.5,0.2,1,0.8,0.1,3.6,3.5,2.3,2.5,0.2,0.2,4.3,4.1,0.1,0.4,0.3,0.7,2.5,1.8,2.4,5.9,3.5,0.5,2.9,2.4,1,0.9,-0.1,2.8,11.1,8.3,73.6,35.7,-37.9,29.5,38.6,9.1,,,,,,,42.7,20.6,-22.1,0,3.6,3.6,0.1,1.9,1.8,262.9,235.1,-27.8,594.5,407.3,-187.2,5.7,7,1.3,3,9.4,6.4,0,0.5,0.5,90.7,83.7,-7,53.7,74.8,21.1,16,12.8,-3.2,147.3,188.6,41.3,376.3,409,32.7,2.7,36.6,33.9,9.6,15.8,6.2,71.1,215.9,144.8,0,0,0,12.4,6.2,-6.2,308.5,184.5,-124,0,0,0,86.8,111.6,24.8,106.5,154.7,48.2,0.5,0.1,-0.4,114.1,78.6,-35.5,1487.2,2045.2,558,166.2,253.5,87.3,370.7,1179,808.3,362.5,725.4,362.9,18.2,13.3,-4.9,0,1.9,1.9,0.9,0.2,-0.7,1120.5,1299.2,178.7,2202.2,1561.3,-640.9,95.7,147.1,51.4,0,0,0,21.2,22.3,1.1,1.1,1.9,0.8,22.5,24.4,1.9,5.1,1.2,-3.9,452.6,277.5,-175.1,1.2,5,3.8,0.7,10.6,9.9,0.3,1,0.7,24.9,72.6,47.7,0,0,0,78.9,138.9,60,0.4,2.5,2.1,9.9,22.3,12.4,0.1,2.5,2.4,0.1,1.4,1.3,0,0.4,0.4,1.8,1,-0.8,0,0.1,0.1,0,0.2,0.2,0,0,0,0.7,0,-0.7,0.1,6.6,6.5,204.1,385.7,181.6,54.4,69.8,15.4,0,1.4,1.4,8.5,6.1,-2.4,0,0.3,0.3,0,0,0,867.2,580.6,-286.6,0,0,0,12.6,7.7,-4.9,14.3,10.7,-3.6,0.8,0.4,-0.4,8.3,2,-6.3,0,0,0,,,,,,,,,,0.1,1.8,1.7,22.8,67.9,45.1,5.4,32.5,27.1,3.5,10.6,7.1,112.8,268.3,155.5,0.8,19,18.2,4.9,12.7,7.8,1.3,32.3,31,0,0,0,0,67.6,67.6,0,0,0,0,0,0,0,0,0,1.2,34.8,33.6,109.6,82.9,-26.7,0,0,0,705.3,503.9,-201.4,4.9,10.7,5.8,46.7,127.9,81.2,6.1,51.4,45.3,6,13.9,7.9,6.4,18.7,12.3,0,0.1,0.1,377.5,146.4,-231.1,77.5,35.4,-42.1,7.7,0.2,-7.5,86.4,11.9,-74.5,75.8,12.4,-63.4,2.5,0.5,-2,582.6,307.6,-275,0,0.2,0.2,0.8,0,-0.8,0.1,1,0.9,689.9,376.6,-313.3,823.3,882.3,59,372.9,159,-213.9,,,,1.3,6.7,5.4,361.8,219.9,-141.9,39.5,1.8,-37.7,0,0.1,0.1,1.8,0,-1.8,1862.4,683.8,-1178.6,0.9,6.4,5.5,0,0,0,1171.1,1119.1,-52,559.6,710,150.4,1661,1079.3,-581.7,8014.7,3858,-4156.7,208.2,627.1,418.9,0,0.3,0.3,0,0.1,0.1,0,0,0,0,0,0,3.2,4.7,1.5,86.2,79.2,-7,0,0,0,3.9,0,-3.9,0,0,0,0,0.7,0.7,0.2,0.2,0,1,0,-1,0,0,0,0.8,2.2,1.4,0,0,0,3.1,0.5,-2.6,0,0,0,0.1,6,5.9,2.7,3,0.3,1.5,2.4,0.9,0,1,1,0,0,0,3.2,4.2,1,0.3,0.5,0.2,14.7,60.4,45.7,159.4,63.7,-95.7,1.8,14.1,12.3,0,0,0,37.1,311.2,274.1,0.4,4.1,3.7,,,,0,0,0,0,0.2,0.2,1.2,0.9,-0.3,2.2,3.9,1.7,0.5,2.9,2.4,0.1,1.4,1.3,11.5,4.1,-7.4,2.8,1.8,-1,7.7,4,-3.7,13,6.1,-6.9,0.1,0.4,0.3,0.4,1.4,1,0.1,1,0.9,443.1,86.5,-356.6,0,0,0,49.5,2.4,-47.1,0,1,1,0,0,0,0,2.2,2.2,0,1.5,1.5,171.4,7,-164.4,43.2,1.8,-41.4,0,0,0,0,0.2,0.2,0,0.3,0.3,0.2,3.5,3.3,20.2,1.3,-18.9,0.1,0,-0.1,0,0.1,0.1,0,7.4,7.4,0.8,11.8,11,0,0,0,0,1,1,0.3,1.8,1.5,4.8,11.4,6.6,0.2,0.2,0,0,0,0,1.4,6.2,4.8,11.8,1.3,-10.5,1.7,0.9,-0.8,3.6,0.5,-3.1,,,,1.8,0,-1.8,0,0.2,0.2,0,0,0,120.2,199.3,79.1,1,6.3,5.3,0.5,2.1,1.6,0.3,8.4,8.1,0.2,0.2,0,8.1,11.9,3.8,4.3,3.2,-1.1,2.8,0.1,-2.7,0,6.8,6.8,,,
1993-03-01,2890.4,1841.2,-1049.2,,,,48969,39027,-9942,,,,,,,6889.8,9777.8,2888,5305.3,4275.3,-1030,3080.7,3043.5,-37.1999999999998,13628.5,13252.7,-375.799999999999,,,,,,,19175.3,11394.8,-7780.5,50744.6,41998.5,-8746.1,21637.9,12763.5,-8874.4,,,,402.9,868.1,465.2,1197.9,484.2,-713.7,0.8,0.4,-0.4,10173.5,9497.9,-675.6,0,0.2,0.2,3455,3754.8,299.8,115,127.3,12.3,8.4,10,1.6,45.2,66.2,21,83.9,77.4,-6.5,20,10,-10,149.5,126.9,-22.6,20.7,90.1,69.4,1,20.7,19.7,29.4,59.3,29.9,0,0.2,0.2,59.8,89.5,29.7,0.5,1.9,1.4,2.8,14.5,11.7,13.3,17.8,4.5,241.3,223.4,-17.9,0,1.5,1.5,1.2,3.9,2.7,2.5,2.9,0.4,0.4,4.9,4.5,0.2,0.8,0.6,0.5,3.7,3.2,2.9,6.7,3.8,0.3,5.1,4.8,1.2,2,0.8,3,9.6,6.6,84.2,29.7,-54.5,39.9,54.7,14.8,,,,,,,31.6,22.2,-9.4,1.5,4.2,2.7,0,2.6,2.6,293.1,305.1,12,697.1,412.2,-284.9,8,15.8,7.8,8.7,11.5,2.8,0,1.4,1.4,108.6,83.9,-24.7,58.5,81.1,22.6,14.6,17.6,3,180.1,207.6,27.5,630.4,473.7,-156.7,5.1,48.6,43.5,15.1,20.4,5.3,101.2,274.9,173.7,0,0,0,19.7,7.6,-12.1,438.8,199.8,-239,0,0,0,149.8,130.4,-19.4,130.1,65.7,-64.4,0.6,0.1,-0.5,146.7,91.6,-55.1,1931.8,2692.7,760.9,203.1,233.6,30.5,495.5,1252.4,756.9,433.7,793.2,359.5,21.3,48.8,27.5,0.1,0.4,0.3,0.8,1.5,0.7,1353.6,1347.9,-5.69999999999982,2555.1,1962.2,-592.9,133.9,120.5,-13.4,0,0,0,22,19.1,-2.9,4,1.1,-2.9,29.8,23.3,-6.5,10.1,0.6,-9.5,615.4,371.2,-244.2,1.2,10.7,9.5,1.6,8.6,7,0.7,3,2.3,40.2,122.6,82.4,0,0,0,120.1,148.4,28.3,1.6,4.3,2.7,5.4,42.3,36.9,0.1,12,11.9,0,0.1,0.1,0,0.9,0.9,5.6,0.7,-4.9,0.3,0,-0.3,0,14,14,0.3,0,-0.3,0.5,9.3,8.8,0.1,0.4,0.3,253.4,422.4,169,87.8,91.3,3.5,0,0.7,0.7,8.4,41.5,33.1,0,0,0,0,0,0,1171.6,573.5,-598.1,0,0,0,7.1,10.6,3.5,18,6.7,-11.3,1.1,0,-1.1,11.3,1.4,-9.9,0,0,0,,,,,,,,,,0.3,2.4,2.1,34.2,52.8,18.6,4.1,13.3,9.2,9.6,6.2,-3.4,123.6,274.3,150.7,0.9,10.3,9.4,9.9,17.2,7.3,2.6,45.8,43.2,0,0,0,0,75.2,75.2,0,0,0,0,0,0,0,0,0,0.9,41.7,40.8,128.3,98.7,-29.6,0,0,0,775.5,681.7,-93.8,7.5,16.8,9.3,63.5,129.7,66.2,11.9,24.2,12.3,16,16.3,0.300000000000001,12.3,23.1,10.8,1,0.1,-0.9,460.9,188.6,-272.3,82.9,56.3,-26.6,10.7,0.6,-10.1,84.6,12.7,-71.9,85.2,34.8,-50.4,3.9,2.9,-1,707.1,291.9,-415.2,0,0.5,0.5,0.9,0,-0.9,0,0.3,0.3,827.5,655.1,-172.4,1115.6,902.8,-212.8,454.8,230.2,-224.6,,,,5.5,93.2,87.7,399.3,274.1,-125.2,45,3,-42,0,0,0,2.4,0,-2.4,2083.2,621.6,-1461.6,1.6,3.6,2,0,0,0,1391.3,1119.9,-271.4,682.8,877.9,195.1,2115.6,1374.7,-740.9,9662.9,4395,-5267.9,250.3,746.5,496.2,0,0.1,0.1,0.1,0,-0.1,0,0,0,0,0,0,1.7,2.8,1.1,139.8,98.1,-41.7,0.1,0.2,0.1,0.1,0,-0.1,0,0,0,0.1,0.4,0.3,0.4,0.1,-0.3,0.5,0.1,-0.4,0,0,0,0.1,3.1,3,0,0,0,2.3,3.8,1.5,0,0,0,0.6,6.1,5.5,1.4,3.4,2,0.6,1.1,0.5,0,0.5,0.5,0,0,0,4.6,1.6,-3,0.2,0.2,0,16.7,60.1,43.4,134.6,86.6,-48,2.9,13.3,10.4,0,0,0,33.9,166.8,132.9,0.6,5.1,4.5,,,,0,0,0,0,0,0,0.1,2.2,2.1,2.6,4,1.4,0.9,6.4,5.5,0,3.7,3.7,8.1,5.5,-2.6,5.3,2.3,-3,11.7,6.2,-5.5,23.9,12.9,-11,0.3,0.9,0.6,0,1.8,1.8,0.1,0.2,0.1,543.4,107.3,-436.1,0.1,0,-0.1,85.7,2.7,-83,0,2.2,2.2,0.1,0,-0.1,0.2,0.3,0.1,3.9,2,-1.9,223.7,28.1,-195.6,34.4,4,-30.4,0,0.1,0.1,0,0.3,0.3,0,0.1,0.1,0.8,4.4,3.6,32.9,3.6,-29.3,0.4,0.1,-0.3,0.4,1.4,1,0,4.2,4.2,2.7,10.5,7.8,0,0,0,0,1.5,1.5,0.8,1.1,0.3,6.3,8,1.7,0.7,58.9,58.2,0,0,0,0.7,1.4,0.7,11.9,1.5,-10.4,1,3.7,2.7,1.2,0.3,-0.9,,,,1.1,0,-1.1,0,0.2,0.2,0,0,0,166.2,170.2,4,2.8,1,-1.8,0.4,1.9,1.5,5.3,8.9,3.6,1.5,0.7,-0.8,9.8,12.1,2.3,3.6,0.9,-2.7,5.1,0.1,-5,0,0,0,,,
1993-04-01,3056.1,1668.1,-1388,,,,48573,38717,-9856,,,,,,,6215.3,9041.9,2826.6,4938.1,4280.2,-657.900000000001,2846.8,3106.1,259.3,12914.9,12394.2,-520.699999999999,,,,,,,18231.5,10309.1,-7922.4,47850.0999999999,39420.5,-8429.59999999993,20472.8,11598.6,-8874.2,,,,376.9,753.1,376.2,1280.3,372.4,-907.9,0.4,0.3,-0.1,9560,8780.6,-779.4,0,0,0,3354.9,3613.6,258.7,100.1,106.1,6,5.5,10.2,4.7,37.9,75.3,37.4,69.3,70.9,1.60000000000001,9.1,9.8,0.700000000000001,119.4,134.8,15.4,16.6,96.4,79.8,1,24.8,23.8,12.7,49.8,37.1,0,0.2,0.2,50.8,97.9,47.1,0.3,2.2,1.9,8.3,12.6,4.3,13.7,25.2,11.5,224.5,210,-14.5,0,1.5,1.5,0.6,3.7,3.1,2.5,3,0.5,0.5,5,4.5,0,0.5,0.5,0.3,2.1,1.8,2.3,13.6,11.3,1.2,2,0.8,0.5,1.8,1.3,2.7,10.3,7.6,60.4,37.8,-22.6,40.3,51.6,11.3,,,,,,,40.7,19.4,-21.3,0.3,3.6,3.3,0.1,3.2,3.1,255.5,295.1,39.6,707.8,451.6,-256.2,5,9.5,4.5,5.1,11.9,6.8,0,1,1,102.1,91.9,-10.2,56,70,14,13.5,18.3,4.8,145.5,188.1,42.6,611.7,564.9,-46.8000000000001,3.7,43.4,39.7,12.3,18.3,6,107,256.8,149.8,0,0,0,24.3,7.7,-16.6,368.3,239.2,-129.1,0,0,0,166.4,94,-72.4,128.9,65.3,-63.6,1.1,0,-1.1,130.4,105.1,-25.3,1879,2046.9,167.9,179.1,242.5,63.4,437.1,1130.6,693.5,396.2,659.4,263.2,21.6,13.7,-7.9,0,1.8,1.8,1,0.9,-0.1,1269.3,1046.5,-222.8,2330,1637.5,-692.5,114.8,140.6,25.8,0,0,0,27.8,26.3,-1.5,6.9,1.2,-5.7,28.1,176.5,148.4,11.5,1.6,-9.9,515.4,789.1,273.7,0.9,8,7.1,0.2,6.3,6.1,0.2,4.9,4.7,39.6,114.4,74.8,0,0,0,131.3,223.5,92.2,3.9,25.1,21.2,15.1,79.1,64,0,4.1,4.1,0,2.4,2.4,0.1,4.3,4.2,2.7,12.5,9.8,0,15.6,15.6,0,1.4,1.4,1.7,0,-1.7,0,1.3,1.3,0.2,0.2,0,250.6,344.1,93.5,61.2,69.6,8.39999999999999,0,0.6,0.6,7.1,38.9,31.8,0,0.3,0.3,0.2,0,-0.2,974.2,679.7,-294.5,0,0,0,10.3,11.1,0.799999999999999,21.1,6.4,-14.7,1.1,1.3,0.2,10.7,0.7,-10,0,0,0,,,,,,,,,,0.4,4.1,3.7,39,57.1,18.1,4,11.1,7.1,14.2,9.6,-4.6,98.6,494.9,396.3,1.5,6.2,4.7,17.4,9.1,-8.3,2,18.8,16.8,0,0.6,0.6,0.1,23.5,23.4,0,0,0,0,0,0,0,0,0,1.2,29.4,28.2,141.1,81.2,-59.9,0,0,0,836.7,634.7,-202,5.5,10.5,5,82.1,154.9,72.8,10.7,48.7,38,9.7,17.4,7.7,6.4,17.9,11.5,0.1,0.4,0.3,388.3,250.1,-138.2,68.2,49.7,-18.5,7.2,0.7,-6.5,55.1,6.9,-48.2,71.4,14,-57.4,3,0.6,-2.4,601.2,303.8,-297.4,0,1.6,1.6,0.9,0.1,-0.8,0,0.8,0.8,732.9,443.4,-289.5,921.9,825.1,-96.8,377.1,176.2,-200.9,,,,1.9,18,16.1,352.9,248.6,-104.3,37,2.4,-34.6,0,0.1,0.1,1.8,0.2,-1.6,2226.3,728.4,-1497.9,2.5,0.1,-2.4,0,0,0,1354.9,1258.7,-96.2,658.7,871.2,212.5,2002.6,1325.2,-677.4,9196.1,3683.3,-5512.8,251.4,644.3,392.9,0,0,0,0,0,0,0.1,0,-0.1,0,0,0,1.2,3.3,2.1,116.7,80.9,-35.8,0.2,0.6,0.4,0,0,0,0,0,0,0.1,0.9,0.8,0.1,0.1,0,0,0.3,0.3,0,0,0,0.1,2.7,2.6,0,0,0,2.7,2.1,-0.6,0,0,0,0.1,6.7,6.6,0.3,2.4,2.1,0.5,1.8,1.3,0,0.8,0.8,0,4.4,4.4,3,1,-2,0.4,0.8,0.4,15,92.4,77.4,169.2,68.1,-101.1,7,24.7,17.7,0,0,0,38.6,262.5,223.9,0.9,6.9,6,,,,0,0,0,0,1.8,1.8,0,1.1,1.1,9.6,4.2,-5.4,0.5,8.9,8.4,0.1,5.3,5.2,13.7,3.2,-10.5,1.4,2.2,0.8,11.8,6.2,-5.6,13.6,8.3,-5.3,0.1,0.5,0.4,0.5,0.6,0.1,0.2,0.5,0.3,664.8,59.5,-605.3,0.1,0.3,0.2,71.6,7.4,-64.2,0.2,1.8,1.6,0,0,0,0.2,0.6,0.4,0,1,1,170.7,15.5,-155.2,67.7,1.4,-66.3,0,0,0,0,0.3,0.3,0.5,0.3,-0.2,0,4.1,4.1,30.8,0.8,-30,0.7,0,-0.7,1.7,0.7,-1,0,2.5,2.5,0.9,17.3,16.4,0,0,0,0,1.2,1.2,1.6,0.8,-0.8,6.2,13.5,7.3,0.7,0.5,-0.2,0,0.2,0.2,1,3.6,2.6,9.9,1.9,-8,0.3,7.6,7.3,4.8,2.1,-2.7,,,,0,0,0,0,0.2,0.2,0,0,0,165.2,178.1,12.9,0.8,0.7,-0.1,0.7,1.2,0.5,7,2.6,-4.4,1.2,0.5,-0.7,8,11.1,3.1,6.8,0.8,-6,4.7,0.3,-4.4,0,65.2,65.2,,,
1993-05-01,2708.9,1688.3,-1020.6,,,,47942,39592,-8350,,,,,,,6174.8,8817.7,2642.9,5114.5,4606.1,-508.4,2887.2,3209.9,322.7,12879.9,12295.5,-584.4,,,,,,,17256.1,11119.4,-6136.7,46330,39869.7,-6460.3,19286.7,12462.9,-6823.8,,,,408.6,837.4,428.8,1095.1,373.1,-722,0.3,0.3,0,9616.3,8791.6,-824.699999999999,0,0.1,0.1,3263.6,3503.9,240.3,104.2,119.4,15.2,6,12.9,6.9,37.6,159,121.4,73.4,80.1,6.69999999999999,8.9,15.2,6.3,122.6,119.4,-3.19999999999999,21.7,98,76.3,0.2,24.5,24.3,41.3,55.8,14.5,0,0.2,0.2,54.9,86.4,31.5,0.4,1.8,1.4,3.1,10.1,7,13.2,22,8.8,220.9,186.4,-34.5,0,0.8,0.8,0.2,3.7,3.5,2,4,2,0.2,5.2,5,0,0.4,0.4,0.2,3.5,3.3,2.2,8.3,6.1,0.3,3.3,3,0.7,2.5,1.8,3.2,11.4,8.2,89.7,40.7,-49,45.5,44.8,-0.700000000000003,,,,,,,44.7,33.4,-11.3,0.6,3,2.4,0,2.3,2.3,233.4,273.2,39.8,692.4,396.7,-295.7,7.1,8.9,1.8,8.7,9.3,0.600000000000001,0,76.2,76.2,121,99.5,-21.5,47.9,80.8,32.9,15.2,19.2,4,119.4,239.7,120.3,591.4,475.9,-115.5,4.5,46.9,42.4,50.1,23.2,-26.9,98.2,301.9,203.7,0,0,0,20.3,39.1,18.8,388.4,211.2,-177.2,0,0,0,210.8,94.8,-116,123,73.8,-49.2,0.4,0,-0.4,124.5,86.2,-38.3,1851.4,1861,9.59999999999991,177.5,193.7,16.2,432.3,1057.8,625.5,414.9,717.8,302.9,19.5,15.3,-4.2,0,1.7,1.7,1.6,0.3,-1.3,1216.6,1224.5,7.90000000000009,2344.2,1643,-701.2,113.5,109.3,-4.2,0,0,0,20.3,20.4,0.0999999999999979,4.6,3.1,-1.5,31,31.2,0.199999999999999,7.8,0.4,-7.4,454.9,909.8,454.9,0.4,3.7,3.3,0.2,8.1,7.9,0.3,9.5,9.2,33.8,76.8,43,0,0,0,132.7,312.7,180,5,14.6,9.6,6.4,19,12.6,0,8.9,8.9,0,2.6,2.6,0.1,5.1,5,1.5,2.2,0.7,0,0,0,0,0.1,0.1,1.3,0,-1.3,0,6,6,3,0.8,-2.2,251.7,315.8,64.1,55.6,64.5,8.9,0.4,0.3,-0.1,16.6,40.1,23.5,0,0,0,0,0,0,963.4,556.2,-407.2,0,0,0,11.5,4.9,-6.6,15.6,5.1,-10.5,0.6,0.2,-0.4,3.5,0.9,-2.6,0,0,0,,,,,,,,,,0.3,0.2,-0.1,29.3,85.6,56.3,5.7,33.2,27.5,16.1,7.7,-8.4,66.3,302,235.7,0.5,8.9,8.4,16.7,40,23.3,1.8,19.6,17.8,0,0.1,0.1,0,146,146,0,0,0,0,0,0,0,0,0,1.5,15.2,13.7,111,71.2,-39.8,0,0,0,751.3,578.6,-172.7,5.9,12,6.1,74.7,162.2,87.5,7.2,31.8,24.6,10,19.5,9.5,7.2,23.7,16.5,0.2,0.4,0.2,329.6,254.1,-75.5,62.3,59.9,-2.4,6,1.1,-4.9,52.4,3.3,-49.1,51.7,8.7,-43,2.2,0.7,-1.5,599,323.3,-275.7,0,0.2,0.2,0.8,0.5,-0.3,0,5.7,5.7,804.1,575,-229.1,985.5,934.2,-51.3,365.2,171.4,-193.8,,,,1.7,10.3,8.6,363.5,261.4,-102.1,43.8,1.8,-42,0,0,0,1.7,0.1,-1.6,2376.3,586.2,-1790.1,1.2,0.2,-1,0,0,0,1412.1,1172.1,-240,731.3,1019.4,288.1,1985.6,1480.4,-505.2,7792.4,4091.5,-3700.9,255.3,721.1,465.8,0,0.1,0.1,0,0,0,0,0,0,0,0,0,1.9,4.3,2.4,137.4,90.4,-47,0.1,0.2,0.1,0.1,0,-0.1,0,0,0,0.1,0.9,0.8,0,0.6,0.6,0,0.2,0.2,0,0,0,0.2,2.3,2.1,0,0,0,3.4,1.2,-2.2,0,0,0,0.4,6.5,6.1,0.6,3.4,2.8,1.7,3.2,1.5,0,0.9,0.9,0,0.2,0.2,7.1,1.4,-5.7,0.3,0.5,0.2,15,78.7,63.7,139,77.1,-61.9,1.6,60.1,58.5,0,0,0,32.3,244.1,211.8,1.1,1.8,0.7,,,,0,0,0,0,0.2,0.2,1.6,1.3,-0.3,11,4.8,-6.2,0.4,3.6,3.2,0.1,2.7,2.6,10.9,6,-4.9,6.6,2.3,-4.3,16,8.4,-7.6,15.9,5.3,-10.6,0.4,0.9,0.5,0.8,1.6,0.8,0.3,1.9,1.6,452.3,69.7,-382.6,0.1,0.1,0,117,3.3,-113.7,0,0.5,0.5,0,0,0,0,1.6,1.6,4.1,0.9,-3.2,195.7,14.9,-180.8,21.5,1.8,-19.7,0.1,0.1,0,0,0,0,0,0.2,0.2,0,5.9,5.9,24.3,2.9,-21.4,0.2,0.1,-0.1,0.4,0.7,0.3,0,9.8,9.8,5,8.2,3.2,0,0,0,0,1.1,1.1,0.7,1.2,0.5,7.1,23,15.9,0.8,0.7,-0.1,0,0,0,0.5,3.1,2.6,13,0.9,-12.1,0.8,5.1,4.3,1.4,0.9,-0.5,,,,2.4,0,-2.4,0,0.2,0.2,0,0,0,156.8,159.3,2.5,4.5,0.9,-3.6,0.5,1.3,0.8,3.2,2.4,-0.8,0.9,0.2,-0.7,8.3,5.7,-2.6,9.3,11.3,2,4.1,2.7,-1.4,0,32,32,,,
1993-06-01,2793.8,1422.1,-1371.7,,,,49189,37932,-11257,,,,,,,7197.1,9372.7,2175.6,5691.4,4550.8,-1140.6,3067.7,2942.9,-124.8,13621.8,12718.2,-903.599999999999,,,,,,,19262.3,11199,-8063.3,50361.4,38623.3,-11738.1,21445,12361.7,-9083.3,,,,411.2,881.8,470.6,1070.3,325.2,-745.1,1.2,0.3,-0.9,10094.6,9070,-1024.6,0,0,0,3527.2,3648.2,121,111.9,116.5,4.59999999999999,3.5,13.1,9.6,39.4,65.6,26.2,81.9,74.3,-7.60000000000001,7.5,16.2,8.7,129.4,127.3,-2.10000000000001,28.5,89.1,60.6,0.5,26.3,25.8,28.4,63.5,35.1,0,0.2,0.2,65.9,97.8,31.9,0.3,1.5,1.2,5.2,8.2,3,17.4,21.2,3.8,242.9,200,-42.9,0.1,0.8,0.7,0.4,4,3.6,1.9,3,1.1,0.4,7.2,6.8,0.1,0.3,0.2,0.3,2.7,2.4,3.3,8.5,5.2,0.3,2.1,1.8,0.8,1.9,1.1,3.3,11.5,8.2,77,68.1,-8.90000000000001,31.6,40.7,9.1,,,,,,,40.7,14,-26.7,0,3.9,3.9,0.2,2.4,2.2,244.3,273,28.7,792.3,337.9,-454.4,7.8,8.4,0.600000000000001,6.3,7.6,1.3,0,1.6,1.6,104.8,108.1,3.3,55.4,107.4,52,11.3,14.4,3.1,115.9,220.3,104.4,652.8,442.4,-210.4,3.5,41.8,38.3,56,20.3,-35.7,94.2,267.8,173.6,0,0,0,26.8,13.9,-12.9,422,172.5,-249.5,0,0,0,183.3,79.9,-103.4,168.9,51,-117.9,0.6,0,-0.6,143.9,80.6,-63.3,1919.5,1783.7,-135.8,211.4,198.5,-12.9,502.3,969.5,467.2,448.2,708.3,260.1,20.7,12.4,-8.3,0,0.4,0.4,1.6,0.2,-1.4,1340.3,1074.4,-265.9,2428.9,1456.1,-972.8,119,98.3,-20.7,0,0,0,26.2,34.1,7.9,5.9,1.2,-4.7,33.1,16.9,-16.2,9.7,0.6,-9.1,516.8,366.1,-150.7,1.7,1.9,0.2,6.8,8,1.2,0.7,9.4,8.7,36,110.1,74.1,0,0,0,193.3,180.2,-13.1,1.3,6.5,5.2,11.1,15.1,4,0,8.8,8.8,0.1,4.9,4.8,0,7.9,7.9,0.6,5.2,4.6,0.9,0,-0.9,0.1,6.1,6,0.5,0.3,-0.2,0.2,0.2,0,0.2,1.8,1.6,278.9,355.3,76.4,64.7,58,-6.7,2.4,0.3,-2.1,8.2,6.3,-1.9,0,0,0,0,0,0,1202.7,576,-626.7,0,0,0,8.9,8.1,-0.800000000000001,22.7,10.8,-11.9,0.6,0.2,-0.4,8,0.4,-7.6,0,0,0,,,,,,,,,,0.1,0.8,0.7,31.8,109,77.2,5.1,28.1,23,16.2,8.5,-7.7,91.7,326.3,234.6,0.9,11.6,10.7,5.6,11.7,6.1,3.3,27,23.7,0,0.1,0.1,0,50.1,50.1,0,0,0,0,0,0,0,0,0,1,42.2,41.2,113.6,77.2,-36.4,0,0,0,678.4,490.6,-187.8,4.4,16.5,12.1,81.2,124,42.8,8.5,15.3,6.8,31.7,20,-11.7,6.6,206.7,200.1,0.2,0.3,0.1,364.1,228.4,-135.7,74.7,51.1,-23.6,7.3,0.6,-6.7,82.1,3.8,-78.3,71.8,5.7,-66.1,3.9,2,-1.9,677.2,272.5,-404.7,0,0.2,0.2,1,0.1,-0.9,0,3,3,870.6,411.5,-459.1,1158.8,1017.7,-141.1,440,153.4,-286.6,,,,1.8,13,11.2,417.3,219.1,-198.2,62.4,2.2,-60.2,0,0,0,2,0,-2,2754.2,754.8,-1999.4,10.7,0,-10.7,0,0,0,1549.9,1274.4,-275.5,821.4,775.7,-45.6999999999999,2161.3,1483,-678.3,8623.8,4274.2,-4349.6,258.3,706.5,448.2,0,0.3,0.3,0,0,0,0,1.2,1.2,0,0,0,2,12.6,10.6,140.5,101,-39.5,0,0.1,0.1,0,0,0,0,0,0,0.2,1.2,1,0.1,0.5,0.4,0,0,0,0,0,0,0.1,2.2,2.1,0,0,0,0,1.8,1.8,0,0,0,0.4,7.6,7.2,3.6,2.2,-1.4,0.8,1.6,0.8,0.3,0.7,0.4,0,39.7,39.7,4.7,2.3,-2.4,0.2,0.3,0.1,16,40.3,24.3,103.6,122,18.4,8.3,18.5,10.2,0,0.2,0.2,88.3,208.2,119.9,1.4,2.1,0.7,,,,0,0,0,0,0,0,0,4.2,4.2,27.6,1.8,-25.8,0.3,1.9,1.6,0.2,1.3,1.1,10.8,7.7,-3.1,1.7,1,-0.7,19.2,5.8,-13.4,21.3,5.7,-15.6,0.2,0.6,0.4,0,0.2,0.2,0.2,1.4,1.2,535.6,47.4,-488.2,0.6,1.4,0.8,44.6,2.5,-42.1,0,0.5,0.5,0,0.2,0.2,0,0.5,0.5,0.2,1.6,1.4,116.6,10.1,-106.5,61.1,1.9,-59.2,0.1,0,-0.1,0,1.8,1.8,0,0,0,0,7.3,7.3,17.6,3.1,-14.5,0.2,0.1,-0.1,0.2,0.2,0,0.1,4.6,4.5,2.5,7.2,4.7,0,0,0,0,1.3,1.3,1.6,4.2,2.6,7.1,9.7,2.6,0.2,0.2,0,0,0,0,0.8,2.1,1.3,16.7,1.9,-14.8,0.7,5,4.3,7.4,1.3,-6.1,,,,0.6,0,-0.6,0,0.3,0.3,0,0,0,151.6,165.6,14,0.8,2.4,1.6,0.6,1.3,0.7,0.3,2.5,2.2,1.4,0.1,-1.3,11,8.3,-2.7,2.8,0.6,-2.2,6.9,0.5,-6.4,0,11.6,11.6,,,
1993-07-01,2710.9,1333.9,-1377,,,,48112,37422,-10690,,,,,,,6911.9,7774.8,862.900000000001,5699.1,4289.5,-1409.6,2994,3138.7,144.7,10928.9,10237.9,-691,,,,,,,19831.3,10900.8,-8930.5,48316.8,35464.2,-12852.6,22161.3,11902.4,-10258.9,,,,440.8,811.7,370.9,1179.1,377.7,-801.4,1.7,0.2,-1.5,7845.1,7057.9,-787.200000000001,0,0,0,3083.8,3180,96.1999999999998,93.3,106.6,13.3,2.9,14.5,11.6,43.6,54.2,10.6,79.6,78.6,-1,7.1,15.7,8.6,134.7,138.7,4,26.3,105.7,79.4,0.4,23,22.6,18.5,70.1,51.6,0,0.2,0.2,61.3,112.6,51.3,0.4,1.6,1.2,0.6,10.2,9.6,14,14.7,0.699999999999999,247.3,208.5,-38.8,0,1,1,1.7,3.7,2,2.2,4,1.8,0.4,6.7,6.3,0.1,0.6,0.5,0.9,2.8,1.9,3.1,10.5,7.4,0.2,4.1,3.9,0.8,2.4,1.6,2.5,14.2,11.7,65.3,49.7,-15.6,33.5,41.6,8.1,,,,,,,10.6,17.7,7.1,0,4.4,4.4,0.2,3,2.8,253.4,250.9,-2.5,741.1,373.3,-367.8,7.7,8.6,0.899999999999999,3.2,9.9,6.7,0.1,0.8,0.7,130.4,93,-37.4,57.8,94.5,36.7,15.2,23.6,8.4,104.5,216.2,111.7,709.5,474.1,-235.4,2.6,41.9,39.3,16.8,18,1.2,100.2,412.6,312.4,0,0,0,18.3,8.2,-10.1,377.2,148,-229.2,0,0,0,242.2,81.6,-160.6,153.3,59.3,-94,0.4,0.1,-0.3,149.4,78.6,-70.8,1804,1801.8,-2.20000000000005,224.8,196.2,-28.6,486.7,902.7,416,493.3,659.7,166.4,19.8,11.7,-8.1,0,0.1,0.1,0.9,0.7,-0.2,1212.4,948.9,-263.5,2433.2,1335,-1098.2,128,77.6,-50.4,0,0,0,26.3,16.3,-10,5.3,2.5,-2.8,38.7,16.8,-21.9,9.8,0.8,-9,502.5,710.2,207.7,2.2,1.8,-0.4,0.4,4.6,4.2,5.5,8.8,3.3,41.6,82.1,40.5,0,0,0,194.4,241.6,47.2,2.9,3,0.1,22.2,30.4,8.2,0,17.5,17.5,0,17.6,17.6,0,13.7,13.7,0.6,2.5,1.9,0,0,0,0,0.1,0.1,2.2,0,-2.2,0.1,3.7,3.6,0,0.5,0.5,265.2,290.3,25.1,72.3,41.8,-30.5,0.2,0.2,0,7.4,3.6,-3.8,0.1,0,-0.1,0,0,0,1247,427.5,-819.5,0,0,0,8,8.4,0.4,23,6.5,-16.5,0.2,0.7,0.5,9.2,0.7,-8.5,0,0.3,0.3,,,,,,,,,,0.1,0.3,0.2,22.8,54.3,31.5,7.4,18.7,11.3,13,14.1,1.1,92.9,288.2,195.3,1.9,10.9,9,0.6,14.4,13.8,2,29.9,27.9,0,0,0,0,33.1,33.1,0,0,0,0,0,0,0,0,0,1.1,15.6,14.5,166.8,52.6,-114.2,0,0,0,541.1,454.6,-86.5,4.9,11.4,6.5,67.8,112.1,44.3,3.7,24.7,21,16.7,23.1,6.4,9.6,18.8,9.2,0.2,6.9,6.7,407.2,186.3,-220.9,77.6,57,-20.6,8.6,0.6,-8,100.3,126.8,26.5,97.4,18.2,-79.2,3.3,1.2,-2.1,845.4,258.6,-586.8,0,0.2,0.2,0.8,0,-0.8,0,0.6,0.6,896.1,489.5,-406.6,1138.1,949.9,-188.2,460.1,177.3,-282.8,,,,2.6,38.1,35.5,436.8,269.2,-167.6,63.5,5.8,-57.7,0,0,0,2.9,0,-2.9,2981.1,711.6,-2269.5,3.2,0.1,-3.1,0,0,0,1558.7,1341.9,-216.8,892.9,714.7,-178.2,2109.4,1283,-826.4,8864.9,4126.7,-4738.2,297.7,685.1,387.4,0,0,0,0,0.1,0.1,0,0.1,0.1,0,0,0,23.2,2.6,-20.6,106.3,105.3,-1,0,0,0,0.7,0,-0.7,0,0,0,0.1,0.6,0.5,0.1,0.6,0.5,0.7,0.1,-0.6,0,0,0,0,3.1,3.1,0,0,0,2.1,0.8,-1.3,0,0,0,0.3,5.5,5.2,0.9,2.9,2,1.2,1.5,0.3,0.2,0.8,0.6,0,0,0,7,2.2,-4.8,0.3,0.4,0.1,18.8,31.4,12.6,133.2,46.6,-86.6,6.4,10.2,3.8,0,0,0,83.3,244.5,161.2,1,3.5,2.5,,,,0,0,0,0,0,0,0,0.8,0.8,15.5,4.6,-10.9,0.4,9,8.6,0.1,2.7,2.6,16.2,1.4,-14.8,1.9,2.5,0.6,11.3,7.5,-3.8,18.2,7.7,-10.5,0.2,2.1,1.9,0.2,0.6,0.4,0.2,0.4,0.2,521.3,67.9,-453.4,0,0.7,0.7,74.6,5,-69.6,0,0.4,0.4,0,0.2,0.2,0,0.3,0.3,0,1.5,1.5,194.7,18,-176.7,60.6,3.5,-57.1,0,0,0,0,1,1,0,0.1,0.1,0,1.3,1.3,9.8,5.6,-4.2,0.2,0.2,0,0,0.1,0.1,0,3.1,3.1,0,0,0,0,0,0,0,0.8,0.8,1.1,1.1,0,7.1,9.7,2.6,0.4,0.5,0.1,0,0,0,1,1.6,0.6,19.5,1.5,-18,0.6,2.4,1.8,5,1.6,-3.4,,,,0,0,0,0,0.1,0.1,0,0,0,185.1,161.5,-23.6,1.1,0.4,-0.7,0.5,1.3,0.8,2.3,2,-0.3,1.4,0.2,-1.2,14.5,5.7,-8.8,2,1.7,-0.3,6.3,0.2,-6.1,0,11.4,11.4,,,
1993-08-01,2565.6,1374.3,-1191.3,,,,47901,37833,-10068,,,,,,,6834.6,8830.9,1996.3,5795.6,4263.9,-1531.7,2925.9,3024.1,98.1999999999998,11938.5,11580.6,-357.9,,,,,,,20554.9,10690.8,-9864.1,48610.1,36876.3,-11733.8,22806.8,11781.6,-11025.2,,,,438.7,957.2,518.5,891.2,405.6,-485.6,1.1,0.1,-1,8780.9,8327,-453.9,0,0,0,3157.6,3253.6,96,99.5,111.2,11.7,4.4,12.1,7.7,37.1,51.8,14.7,82.6,70.3,-12.3,14.5,15.8,1.3,135.1,123.4,-11.7,24.8,109.1,84.3,0.4,20.2,19.8,38.6,72.3,33.7,0,0.6,0.6,67.8,95.8,28,0.6,1.6,1,0.5,30.7,30.2,14.2,19.3,5.1,263.3,201.1,-62.2,0,1.4,1.4,1.3,4.2,2.9,1.4,3.9,2.5,0.2,7.5,7.3,0,0.4,0.4,0.5,1.1,0.6,3.1,7.6,4.5,0.4,2.5,2.1,0.3,2,1.7,2.4,12.7,10.3,47.6,50,2.4,26.1,33.5,7.4,,,,,,,34.1,15.5,-18.6,0.1,4.4,4.3,0.1,2,1.9,209.5,233,23.5,685.3,351.7,-333.6,6.7,11.1,4.4,3.6,7.9,4.3,0,1.6,1.6,135.8,99.6,-36.2,61.4,91,29.6,16.6,33.6,17,101.3,227.3,126,697.7,487.9,-209.8,3.9,43.9,40,16.4,20,3.6,86.7,331.5,244.8,0,0,0,19.6,12.4,-7.2,280.6,185.6,-95,0,0,0,151.2,81.6,-69.6,140.9,56.3,-84.6,0.8,0,-0.8,115.5,85.7,-29.8,1709,1977.9,268.9,217.8,231.8,14,490.4,869.2,378.8,298.5,717.4,418.9,26.8,19.1,-7.7,0,1.8,1.8,3,0.3,-2.7,1187.9,924.4,-263.5,2241.9,1370.6,-871.3,106.4,97.5,-8.90000000000001,0,0,0,21.8,28.5,6.7,6.6,1,-5.6,34.6,38.6,4,5.3,1.1,-4.2,455.8,525.1,69.3,2.8,0.7,-2.1,0.3,8.5,8.2,0.4,7.8,7.4,40.7,41.4,0.699999999999996,0,0,0,113.3,203,89.7,4.5,1,-3.5,28.5,13.1,-15.4,0.3,9.8,9.5,0,0.5,0.5,0,4.3,4.3,3.2,3.9,0.7,0,0.2,0.2,0.2,0.5,0.3,1.9,0.6,-1.3,0,4.2,4.2,0.3,16.5,16.2,276.3,342.3,66,74.9,51.2,-23.7,0,0.3,0.3,6.1,5.8,-0.3,0.1,0.1,0,0,0,0,1146.2,367.4,-778.8,0,0,0,6.2,8.1,1.9,21.3,6.8,-14.5,0.2,9.3,9.1,10,0.8,-9.2,0,0,0,,,,,,,,,,0.2,5.3,5.1,24,83.9,59.9,6.3,13.7,7.4,9.5,9.1,-0.4,98,287.5,189.5,2.4,12.5,10.1,16,8.5,-7.5,2.1,29.7,27.6,0,0,0,0,29.9,29.9,0,0,0,0,0,0,0,0,0,2,23.3,21.3,184.5,59.7,-124.8,0,0,0,531.9,446.5,-85.4,6,10.7,4.7,50.4,214.8,164.4,0.8,17.5,16.7,41.1,27.2,-13.9,5.9,14,8.1,0.1,0.1,0,409.6,327,-82.6,84.1,58.6,-25.5,7.3,0.7,-6.6,103.2,10.7,-92.5,110.7,20.1,-90.6,4.5,1.1,-3.4,774.2,281.3,-492.9,0,0.2,0.2,1.3,0.1,-1.2,0,0.5,0.5,1022.4,501.3,-521.1,1120.2,1108,-12.2,503.3,146.2,-357.1,,,,2.5,92.2,89.7,467.6,291.6,-176,66.1,3.7,-62.4,0,0,0,1.8,0.1,-1.7,3223.3,766.5,-2456.8,3.4,3.5,0.1,0,0,0,1474.3,1188.9,-285.4,870.8,882.5,11.7,2330.3,1084.5,-1245.8,9050.2,3731.7,-5318.5,298.3,686.9,388.6,0.2,0,-0.2,0,0.1,0.1,0,0,0,0,0,0,32.4,2.1,-30.3,93,204.8,111.8,0.1,0.1,0,0.1,0.1,0,0,0,0,0.1,0.6,0.5,0,0.3,0.3,0.1,0.1,0,0,0,0,0.1,2.8,2.7,0,0,0,2.3,1.8,-0.5,0,0,0,3.9,7.7,3.8,0.6,2.8,2.2,1.6,2.9,1.3,0,1.1,1.1,0,39.9,39.9,5.6,2.6,-3,0.3,0.5,0.2,14,27.3,13.3,149.2,43.5,-105.7,1.9,8.9,7,0,0,0,50.3,266.9,216.6,0.9,3.6,2.7,,,,0,0,0,0,0.4,0.4,1.3,0.4,-0.9,9.7,4.3,-5.4,1.2,7.4,6.2,0.1,2.5,2.4,9.1,3.5,-5.6,3.5,2.1,-1.4,14.5,6.7,-7.8,11.1,10,-1.1,0,0.3,0.3,0.1,0.8,0.7,0.2,2.2,2,368,67.6,-300.4,0,0.6,0.6,87,3.7,-83.3,0,0.4,0.4,0,0,0,0,0.2,0.2,3.7,2.2,-1.5,113,16.3,-96.7,43.4,2,-41.4,0,0.4,0.4,0,0.1,0.1,0,0.1,0.1,0,4.7,4.7,13.8,4.1,-9.7,0.2,0.9,0.7,0.2,0.4,0.2,0,0.6,0.6,0,0,0,0,0,0,0,1.5,1.5,0.1,0.7,0.6,11,12.5,1.5,0.2,0.9,0.7,0,0,0,0.3,2.8,2.5,18.1,1.5,-16.6,0.5,0.9,0.4,4.8,0.6,-4.2,,,,0,0,0,0,0.2,0.2,0,0,0,151,222,71,0.3,0.5,0.2,1.6,1.3,-0.3,4,1.7,-2.3,1.8,0.2,-1.6,8.9,4.8,-4.1,3.1,1,-2.1,3.9,0,-3.9,0,34.3,34.3,,,
1993-09-01,2494.7,1446.3,-1048.4,,,,49083,38413,-10670,,,,,,,7176.9,8446,1269.1,5945.2,4375.4,-1569.8,2983.3,3043.7,60.3999999999996,13190.2,11963.5,-1226.7,,,,,,,20946.3,10936.9,-10009.4,50526.8,37955.5,-12571.3,23219.3,11942.3,-11277,,,,409.6,832.6,423,935.9,458,-477.9,1.8,0.1,-1.7,9717.5,8571.5,-1146,0,0,0,3472.7,3392,-80.6999999999998,103,115.3,12.3,3,10.7,7.7,51.7,61,9.3,78.7,79.5,0.799999999999997,10.6,14.3,3.7,141.6,126.7,-14.9,35.4,93.7,58.3,0.6,22.8,22.2,12.1,50.1,38,0,0.1,0.1,74.8,93.4,18.6,0.4,1.3,0.9,1.6,17.7,16.1,14.8,31,16.2,232.5,209.8,-22.7,0,1,1,2.9,3.2,0.3,2,2.9,0.9,10.3,6.4,-3.9,0.1,0.3,0.2,0.4,0.8,0.4,2.6,7.6,5,0.3,3.1,2.8,0.6,1.8,1.2,3.1,14.3,11.2,58.4,43.1,-15.3,15.7,35.8,20.1,,,,,,,53.2,34,-19.2,0.7,4.9,4.2,0.1,2.9,2.8,236,248.4,12.4,707.3,385.8,-321.5,6.8,12.4,5.6,3.7,8.2,4.5,0,1.5,1.5,98.1,89.3,-8.8,75.5,104.7,29.2,11.5,14,2.5,89,213.5,124.5,715.6,487.8,-227.8,3.6,41.1,37.5,15.4,20.7,5.3,109.6,326.8,217.2,0,0,0,11.6,10.1,-1.5,389.1,179.2,-209.9,0,0.1,0.1,160.6,126.1,-34.5,134.8,53.4,-81.4,1,0,-1,156.9,88.9,-68,1785.2,2275.6,490.4,244.1,210.3,-33.8,431.5,1028,596.5,452.9,752.6,299.7,16.1,11.2,-4.9,0,1.5,1.5,1.5,0.3,-1.2,1210.9,967,-243.9,2291.4,1419.4,-872,128.3,114.5,-13.8,0,0,0,20.3,18.4,-1.9,5.3,1.6,-3.7,30.7,27.6,-3.1,6.8,0.4,-6.4,492.7,644.2,151.5,1.7,2.3,0.6,3.3,3.9,0.6,0.6,3.4,2.8,42.4,45.8,3.4,0,0,0,157.7,189.4,31.7,1.9,9,7.1,5.8,19.1,13.3,0,5.8,5.8,0,0.2,0.2,0,0.2,0.2,9.7,5.3,-4.4,0.3,2.1,1.8,0.1,0.6,0.5,2.3,0.3,-2,0,1.6,1.6,2.7,13.1,10.4,213.7,285.1,71.4,56.8,42.5,-14.3,0.3,0.6,0.3,7.3,4.5,-2.8,0,0,0,0.1,0.1,0,935.3,435.7,-499.6,0,0,0,7,7.5,0.5,21,11.5,-9.5,0.2,4.1,3.9,6.9,0.6,-6.3,0,0,0,,,,,,,,,,0.2,4.6,4.4,26.5,74.4,47.9,6.2,29.1,22.9,13.6,11.6,-2,98.6,219.4,120.8,1.3,8.7,7.4,11,13.9,2.9,1.7,33.7,32,0,1.1,1.1,0,29.4,29.4,0,0,0,0,0,0,0,0,0,2.7,36.4,33.7,192.1,74,-118.1,0,0,0,529.4,483.6,-45.8,6.2,8.7,2.5,76.9,132.7,55.8,0.4,18.2,17.8,13.2,17.2,4,7.9,16.8,8.9,0.1,0.2,0.1,407,205.2,-201.8,82.9,88.7,5.8,7,0.8,-6.2,83.9,12,-71.9,92,18.2,-73.8,5.5,0.4,-5.1,753,319,-434,0,0.6,0.6,0.3,0.4,0.1,0,0.7,0.7,985.1,399.4,-585.7,1225.7,967.1,-258.6,448.9,157,-291.9,,,,1.8,86,84.2,467.4,273.5,-193.9,80.6,1,-79.6,0,0,0,1.3,0.2,-1.1,3338.7,836.2,-2502.5,1.9,0.1,-1.8,0,0,0,1541.3,1237,-304.3,920.6,783.3,-137.3,2257.6,1388,-869.6,9280.2,3993.8,-5286.4,300.9,712.7,411.8,0,0.1,0.1,0,0,0,0,0,0,0,0,0,13.6,5.3,-8.3,83.9,96.7,12.8,0,0.2,0.2,0.1,0.1,0,0,0,0,0.1,0.4,0.3,0.1,0.1,0,0.7,0.1,-0.6,0,0,0,0,2.9,2.9,0,0,0,2.3,1.2,-1.1,0,0,0,0.8,5,4.2,0.3,2.5,2.2,1.1,2.2,1.1,0.1,0.6,0.5,0,0,0,5.2,2,-3.2,0.4,0.5,0.1,12.3,43.4,31.1,114.4,75.2,-39.2,2,20,18,0,0,0,62.8,185.3,122.5,1,2.1,1.1,,,,0,0,0,0,0.1,0.1,0,1.5,1.5,15.6,3.2,-12.4,2.5,6.3,3.8,0.1,3.7,3.6,5.1,5.2,0.100000000000001,1.3,2.2,0.9,6.5,8.4,1.9,16.9,92,75.1,0.3,0.8,0.5,0.2,1.8,1.6,0.5,0.8,0.3,319.6,95.5,-224.1,0,0.6,0.6,99.9,3.2,-96.7,0,0.3,0.3,0,1.8,1.8,0,5.2,5.2,0.1,4.2,4.1,168.7,16.6,-152.1,51.3,2.1,-49.2,0,0,0,0,0.3,0.3,0,0.1,0.1,0,5.2,5.2,22,3.1,-18.9,0,0.6,0.6,0.2,3.4,3.2,0,0.8,0.8,0,0,0,0,0.4,0.4,0,1.1,1.1,1.2,0.9,-0.3,9.1,4.9,-4.2,0.2,0.1,-0.1,0,0,0,1.3,1.5,0.2,16.8,1.6,-15.2,1.2,4.2,3,1.2,0.3,-0.9,,,,1.7,0.1,-1.6,0,0.2,0.2,0,0,0,153,153.4,0.400000000000006,0.5,1.2,0.7,0.7,2.3,1.6,6.9,2.8,-4.1,7.6,0.3,-7.3,9.8,6.3,-3.5,7.8,0.8,-7,3.3,0,-3.3,0,16.9,16.9,,,
1993-10-01,2681.7,1958.1,-723.6,,,,50820,40006,-10814,,,,,,,7223.7,9775.2,2551.5,5879.1,4634.4,-1244.7,2994.1,3366.1,372,13997.4,12252.4,-1745,,,,,,,21915.9,11590.8,-10325.1,53889.3,41147.6,-12741.7,24249.4,12988,-11261.4,,,,420.4,889.8,469.4,992.3,567.1,-425.2,0.4,0.3,-0.1,10249.2,8906.2,-1343,0,0,0,3748.2,3346.2,-402,95,105.4,10.4,2.7,12.5,9.8,42.5,65.4,22.9,75.9,77.4,1.5,10.5,9.8,-0.699999999999999,136,135.3,-0.699999999999989,23.6,107.6,84,0.2,24.4,24.2,22.6,54,31.4,0,0.2,0.2,63.7,104.2,40.5,0.3,2,1.7,1.5,11.7,10.2,10.8,24.2,13.4,230.4,210.5,-19.9,0,1.2,1.2,0.7,4.4,3.7,1.8,4.5,2.7,0.6,6.8,6.2,0.1,0.5,0.4,0.6,2,1.4,2.2,7.4,5.2,0.3,2.3,2,0.5,2.4,1.9,3.2,12,8.8,64.4,46.4,-18,43,46.3,3.3,,,,,,,40.5,22.3,-18.2,0,4.4,4.4,0,2.2,2.2,249.3,303,53.7,665.2,378.4,-286.8,9.1,9.7,0.6,3.3,10.3,7,2.2,90.9,88.7,139.2,88.3,-50.9,76.9,106.2,29.3,21,15.9,-5.1,108.4,221.6,113.2,712.9,556.4,-156.5,3.4,61.3,57.9,19,26.7,7.7,110.6,387.7,277.1,0,0,0,20.4,8.4,-12,423.6,226.8,-196.8,0,0,0,175,119.4,-55.6,151.7,76.2,-75.5,1.2,0.1,-1.1,162.5,100.7,-61.8,1878,2507.6,629.6,244.4,242.6,-1.80000000000001,485.2,1133.5,648.3,489,818.5,329.5,23,28.4,5.4,0,2.3,2.3,1.7,0.3,-1.4,1315.5,1012.4,-303.1,2559.1,1703.9,-855.2,125.5,112.6,-12.9,0,0,0,24.7,19.2,-5.5,10.4,1.4,-9,33.9,17.9,-16,8.6,0.8,-7.8,589.5,717.3,127.8,1.3,1.8,0.5,0.3,10.2,9.9,1.1,4.4,3.3,41.5,60,18.5,0,0,0,201.7,366.3,164.6,5.8,13.8,8,16.8,15.9,-0.9,0,1,1,0,4.9,4.9,0,0.1,0.1,1,6.1,5.1,0.1,0.2,0.1,0,8,8,2.2,0,-2.2,0,12.1,12.1,0.1,4.6,4.5,238.8,347.2,108.4,58,53.2,-4.8,0.1,0.9,0.8,8.4,4.8,-3.6,0.1,0.5,0.4,0,0,0,1532.6,539.7,-992.9,0,0,0,9.2,11.8,2.6,20.3,5.9,-14.4,0.6,0.1,-0.5,6.1,0.5,-5.6,0,0,0,,,,,,,,,,2,6.5,4.5,28,78.9,50.9,5.7,89.9,84.2,8.6,5.9,-2.7,95.3,222.5,127.2,1.5,12.9,11.4,18.1,19.7,1.6,3,26,23,0,2.1,2.1,0,23.9,23.9,0,0,0,0,0,0,0,0,0,2.7,24.9,22.2,238.3,104.9,-133.4,0,0,0,512.6,639.4,126.8,6.9,10.4,3.5,15.5,175.3,159.8,19.3,24.9,5.6,23.5,20.7,-2.8,10.1,24.3,14.2,0.1,0.4,0.3,411.4,167.9,-243.5,78.3,59.9,-18.4,9.4,0.3,-9.1,77.2,18.4,-58.8,100,19.3,-80.7,8.5,0.4,-8.1,809.2,465.1,-344.1,0,2.5,2.5,0.7,0.1,-0.6,0.1,0.9,0.8,1096.9,705.9,-391,1200.3,1116.3,-84,619.1,472.2,-146.9,,,,2.8,6.8,4,449.3,287.4,-161.9,72.2,0.6,-71.6,0,0,0,1.5,0.2,-1.3,3277.6,623.8,-2653.8,3.3,1.2,-2.1,0,0,0,1481.6,1222.3,-259.3,958.4,806,-152.4,2238.8,1489.8,-749,10113.3,4000.7,-6112.6,307.3,751,443.7,0,0,0,0.1,0,-0.1,0,0.2,0.2,0,0,0,14.1,3,-11.1,84,104.8,20.8,0,0.1,0.1,0.2,0,-0.2,0,0,0,0.1,1.1,1,1.4,0.1,-1.3,0.7,0.1,-0.6,0,0,0,0,2.7,2.7,0,0,0,1,4.3,3.3,0,0,0,0.1,12.9,12.8,0.2,4.2,4,0.7,1.4,0.7,0.1,0.5,0.4,0.1,0,-0.1,9.9,2.8,-7.1,0.4,0.6,0.2,15.4,36.4,21,157.4,62.4,-95,1.7,8,6.3,0,0,0,50.7,210.9,160.2,1.6,11.8,10.2,,,,0,0,0,0,0,0,0,2.6,2.6,1.1,4.8,3.7,0.3,5.6,5.3,0.1,3.3,3.2,4.6,8,3.4,2.8,2.1,-0.7,6.1,11.2,5.1,27.5,24.1,-3.4,0.2,0.7,0.5,0,5.2,5.2,0.2,1,0.8,330.5,85.5,-245,0,0.2,0.2,136.4,3.6,-132.8,0,0.1,0.1,0,0,0,0,0.7,0.7,3.5,1.2,-2.3,202,12.4,-189.6,46.5,1.9,-44.6,0,0.1,0.1,0,0.4,0.4,0.1,0.5,0.4,0.3,0.6,0.3,14.4,3.1,-11.3,0,0.1,0.1,0.3,0.1,-0.2,0,2.6,2.6,0,0,0,0,0,0,0,0.5,0.5,0.6,2.5,1.9,12.5,10.5,-2,0.2,0.5,0.3,0,0,0,0.9,2.6,1.7,21.4,1,-20.4,0.4,7.3,6.9,3.9,1,-2.9,,,,0.1,0,-0.1,0,0.1,0.1,0,0,0,145.5,312.6,167.1,4.3,3.3,-1,1,2.8,1.8,2.1,1.8,-0.3,1.8,0.1,-1.7,7.9,5.1,-2.8,6.2,0.4,-5.8,3.9,2.2,-1.7,0,25.2,25.2,,,
1993-11-01,2459.4,1732.9,-726.5,,,,49939,40049,-9890,,,,,,,7435.4,8952.9,1517.5,5564.1,4271.1,-1293,2855,3181.6,326.6,13746.3,12867,-879.299999999999,,,,,,,20221.2,10951,-9270.2,51433.5,40293.8,-11139.7,22493.1,12360.2,-10132.9,,,,358.9,806.8,447.9,944.1,340.1,-604,1.3,0.1,-1.2,9971.5,8910.7,-1060.8,0,0,0,3774.8,3956.3,181.5,78,96.3,18.3,2.6,8.9,6.3,35.2,60.8,25.6,79.3,77.9,-1.39999999999999,11.9,8.8,-3.1,128.1,133.8,5.70000000000002,20.2,97.6,77.4,0.2,20.8,20.6,46.6,62.5,15.9,0,0.1,0.1,57.4,81.5,24.1,0.1,2.2,2.1,5.9,13.6,7.7,12.1,7.6,-4.5,236.6,195,-41.6,0,1.2,1.2,3.3,4.4,1.1,2.2,3.6,1.4,0.2,5.8,5.6,0.2,0.4,0.2,0.8,2.3,1.5,2.7,8,5.3,0.5,3.4,2.9,0.5,2.5,2,3.5,13.8,10.3,54.6,36.4,-18.2,25.1,39.7,14.6,,,,,,,44.3,22.9,-21.4,0,4.5,4.5,0,2.6,2.6,288.1,297.1,9,640.4,382.5,-257.9,8.6,9.7,1.1,3.6,7.5,3.9,0.3,145.1,144.8,142.5,93.3,-49.2,70.7,96.6,25.9,19.2,16.5,-2.7,82.7,221.1,138.4,621.4,442.6,-178.8,4.5,43,38.5,17.9,24.4,6.5,103,383.3,280.3,0,0,0,24.4,16.7,-7.7,445.1,197,-248.1,0,0,0,176.9,94.4,-82.5,151.9,53.5,-98.4,0.3,0,-0.3,151.4,97,-54.4,1990,2655.4,665.4,250.5,225.6,-24.9,399.4,950.9,551.5,493,842.8,349.8,23.1,171.4,148.3,0,0.2,0.2,1.2,0.3,-0.9,1401.5,1003.5,-398,2598.6,1487,-1111.6,134.3,100.9,-33.4,0,0,0,24.2,16.2,-8,4.4,2.8,-1.6,39.5,17.7,-21.8,9.5,2.5,-7,502.4,511.6,9.20000000000005,3.5,12.8,9.3,3.4,9.4,6,4.6,2.2,-2.4,37.8,57.7,19.9,0,0,0,181.4,416,234.6,1.3,2.9,1.6,21.1,9.8,-11.3,0.1,1.2,1.1,0,0.4,0.4,9.1,5.5,-3.6,6.3,12.3,6,0.2,0.2,0,0,0.2,0.2,2.7,9.7,7,0.4,4.3,3.9,0.2,8.9,8.7,253.4,339.7,86.3,74.9,57.9,-17,0.1,0.6,0.5,10.9,7,-3.9,0,0.5,0.5,0,0,0,1132.7,537.4,-595.3,0,0,0,9,9.7,0.699999999999999,17.8,7.4,-10.4,0.3,2.8,2.5,13.9,2.3,-11.6,0,0,0,,,,,,,,,,1.3,3.3,2,22.4,73.1,50.7,5.6,22.9,17.3,21.4,16.9,-4.5,147.1,221.7,74.6,1.9,6.1,4.2,17.2,10.7,-6.5,2.5,45.5,43,0,0,0,0,40.8,40.8,0,0,0,0,0,0,0,0,0,1.5,34.1,32.6,183.8,102.5,-81.3,0,0,0,489.2,558.5,69.3,5.2,25.9,20.7,75.2,177.5,102.3,0.3,16.2,15.9,54,24.9,-29.1,12,110.4,98.4,0.4,0.3,-0.1,343.2,297.7,-45.5,69.8,106.1,36.3,8.2,0.2,-8,55.8,17.2,-38.6,83.6,7.9,-75.7,3.2,0.7,-2.5,758.4,285.4,-473,0,0.2,0.2,0.2,0,-0.2,0.2,1.6,1.4,985,590.1,-394.9,1076.7,879.8,-196.9,480.2,259.1,-221.1,,,,4.3,61.9,57.6,410.8,458.1,47.3,60.4,0.9,-59.5,0,0,0,2.4,0,-2.4,2899.6,781.8,-2117.8,2,0.9,-1.1,0,2,2,1454.9,1232.8,-222.1,888.8,743.8,-145,2143.7,1414.7,-729,9466.8,3760.8,-5706,275,665.4,390.4,0,0,0,0,0,0,0,0.1,0.1,0,0.1,0.1,1.2,3.5,2.3,74,98.3,24.3,0,0.1,0.1,0.1,0.6,0.5,0.1,0,-0.1,0.1,0.7,0.6,0.2,0.1,-0.1,0,0.1,0.1,0,0,0,0.1,2.4,2.3,0,0,0,1.3,1.2,-0.1,0,0,0,0.4,23.9,23.5,0.3,3.1,2.8,1.1,3.8,2.7,0.3,1.3,1,0,0,0,4.2,1.7,-2.5,0.5,0.4,-0.1,13.4,55.5,42.1,152.3,107.9,-44.4,2.6,9.5,6.9,0,0,0,60.1,196.3,136.2,1.3,6.2,4.9,,,,0,0,0,0,0.4,0.4,2,1.8,-0.2,4.8,3.5,-1.3,0.1,4.1,4,0.1,2.7,2.6,7.8,10.5,2.7,9.9,0.9,-9,13.8,10.5,-3.3,27.7,21,-6.7,0.3,0.3,0,0.2,0.8,0.6,0.3,0.8,0.5,348,70.3,-277.7,0,0.6,0.6,85.1,7.7,-77.4,0,0.1,0.1,0,0,0,0,1.5,1.5,0.2,2.1,1.9,181.2,12.1,-169.1,47.2,2.5,-44.7,0,0.5,0.5,0,0.2,0.2,0,0.5,0.5,1.3,0.4,-0.9,12.6,3,-9.6,0.4,0,-0.4,0.1,0.1,0,0.1,4.1,4,0,0,0,0,0,0,0,1.4,1.4,0.6,2.9,2.3,7.5,6.7,-0.8,0.1,0.8,0.7,0,0,0,1.2,2.2,1,23.1,1.3,-21.8,0.3,6.4,6.1,5.3,0.9,-4.4,,,,1.2,0.1,-1.1,0,0.1,0.1,0,0,0,140.7,131.9,-8.79999999999998,2.3,0.9,-1.4,0.8,4.4,3.6,5.2,1.2,-4,0.6,0.1,-0.5,4.8,3.9,-0.9,2,0.3,-1.7,3.4,0.3,-3.1,0,58.5,58.5,,,
1993-12-01,2158.8,1912.8,-246,,,,49534,41420,-8114,,,,,,,7947.1,10925.4,2978.3,5449.7,4998.2,-451.5,2763.4,3362.9,599.5,12069.8,11356.9,-712.9,,,,,,,19557.3,12568.1,-6989.2,48719.2,41412.2,-7307,21685.2,14147.7,-7537.49999999999,,,,334.3,872.8,538.5,832.4,362.1,-470.3,2.3,0.3,-2,8777.7,7905.7,-872.000000000001,0,0,0,3292.1,3451.2,159.1,94,107.2,13.2,2.9,10.2,7.3,39.1,69,29.9,79.3,74.9,-4.39999999999999,12,9.3,-2.7,124.9,117.6,-7.30000000000001,27.5,100.4,72.9,0.3,18.7,18.4,52.4,66.6,14.2,0,0.1,0.1,63.9,84.8,20.9,0.1,2.3,2.2,3.5,12.9,9.4,12.5,13,0.5,222.4,187.2,-35.2,0,1.7,1.7,1.5,4.3,2.8,1.6,4.3,2.7,0.3,7.1,6.8,0.5,0.4,-0.1,0.4,1.9,1.5,2.7,8.5,5.8,0.3,4.2,3.9,0.6,2,1.4,2.6,12.6,10,68.1,38.7,-29.4,35.5,50.6,15.1,,,,,,,54.6,23.6,-31,1.3,3.5,2.2,0,4,4,224.6,285.2,60.6,530.2,305.7,-224.5,9,11.9,2.9,3.5,10.8,7.3,0.1,2.2,2.1,119.7,94.8,-24.9,75.7,94.7,19,23.1,14,-9.1,124,233.5,109.5,622.4,806,183.6,5.4,36.3,30.9,11.7,25.8,14.1,109.2,400.4,291.2,0,0,0,21.2,10.3,-10.9,372.1,192.8,-179.3,0,0,0,128.2,93,-35.2,118.7,71.3,-47.4,0.3,0,-0.3,145.3,89.3,-56,1990.8,2451.4,460.6,211.2,243.7,32.5,488.6,1206.9,718.3,458.1,760.4,302.3,23.4,168.7,145.3,0,2.1,2.1,0.9,0.2,-0.7,1639.1,1127.6,-511.5,2633.2,1608,-1025.2,127.5,107.6,-19.9,0,0,0,25.4,21.8,-3.6,7.7,15.8,8.1,42,25.6,-16.4,9.6,0.4,-9.2,529.9,626,96.1,1.9,3.7,1.8,4.6,5.4,0.800000000000001,0.5,1.8,1.3,48.9,54,5.1,0,0,0,191.2,398.3,207.1,5.1,2.1,-3,15.4,29.8,14.4,0.1,3.1,3,0.1,0.9,0.8,11.6,5.3,-6.3,3.5,10.6,7.1,0.1,0,-0.1,0,0,0,2.6,0.7,-1.9,0,2.8,2.8,0.1,1.5,1.4,269.1,365.2,96.1,73.5,61.5,-12,0.2,0.6,0.4,8.9,7.3,-1.6,0,0,0,0.1,0,-0.1,1126.3,607.7,-518.6,0,0,0,7,8.8,1.8,20.8,8.3,-12.5,0.4,5.4,5,7.8,0.8,-7,0,0.1,0.1,,,,,,,,,,2,3.3,1.3,25.1,67.5,42.4,5.7,18.9,13.2,15.8,8,-7.8,88.5,292.2,203.7,1.7,14.3,12.6,9.3,13.6,4.3,2,29.7,27.7,0,0,0,0,45.8,45.8,0,0,0,0,0,0,0,0,0,1.7,26.1,24.4,185.1,100.9,-84.2,0,0,0,475.7,637.8,162.1,3,18.8,15.8,26.9,168.9,142,23.5,23.5,0,38.3,33.2,-5.09999999999999,6.5,121.8,115.3,0.4,0.2,-0.2,320.1,341.8,21.7,68.2,71.5,3.3,6.4,0.1,-6.3,47,22.6,-24.4,86.1,22.7,-63.4,3,0.5,-2.5,783.7,354.7,-429,0,0.4,0.4,0.1,0.1,0,0.1,0.4,0.3,946.8,466.2,-480.6,1181,1144.5,-36.5,500.9,457.8,-43.1,,,,2.1,41.5,39.4,412.3,447.6,35.3,45.8,1.8,-44,0,0,0,1.5,0.1,-1.4,2329.6,1047.5,-1282.1,1.9,0.1,-1.8,0,0,0,1362.5,1412.9,50.4000000000001,780.3,941.1,160.8,2125.9,1499.7,-626.2,9544.5,4256.6,-5287.9,254.4,739.5,485.1,0,0.1,0.1,0,0,0,0,0,0,0,0,0,1.9,3,1.1,69.2,108.3,39.1,0,0.1,0.1,0,0,0,0,0,0,0.1,0.7,0.6,0.4,0,-0.4,0,0.1,0.1,0,0,0,0.1,2.4,2.3,0,0,0,0,1.8,1.8,0,0,0,0.6,9.6,9,0.2,3.3,3.1,0.7,1.3,0.6,0.1,0.6,0.5,0,0.3,0.3,5.9,1.3,-4.6,0.7,0.4,-0.3,18.3,37.6,19.3,57.9,110.2,52.3,2,21.3,19.3,0,0,0,41.1,245.7,204.6,1.3,7.5,6.2,,,,0,0,0,0,0,0,0.2,2.3,2.1,0.9,4.8,3.9,0.2,9.1,8.9,0.1,1.9,1.8,11.9,1.8,-10.1,2.4,1.9,-0.5,30.5,7.4,-23.1,14.1,7.5,-6.6,0.1,0.9,0.8,0,1.1,1.1,1,1.4,0.4,315.2,62.5,-252.7,0,0.5,0.5,64,4.4,-59.6,0.1,0.2,0.1,0.7,0,-0.7,0,3.9,3.9,0.1,2.2,2.1,129.8,14.3,-115.5,15.1,3.1,-12,0,0.4,0.4,0,0.3,0.3,0,0.1,0.1,0.1,1.4,1.3,18.3,1.5,-16.8,0,0.1,0.1,0.3,1.8,1.5,0,4.4,4.4,0,0,0,0,0.5,0.5,0,0.5,0.5,0.4,0.8,0.4,7.8,12.6,4.8,0.4,0.7,0.3,0,0,0,1.3,2.3,1,17.6,2,-15.6,0.7,6.4,5.7,1.1,0.7,-0.4,,,,0.6,0,-0.6,0,0.1,0.1,0,0,0,172,166.1,-5.90000000000001,0.8,1,0.2,0.6,3.2,2.6,3.7,2.1,-1.6,1.6,0.4,-1.2,7.5,7.9,0.4,5.1,1.5,-3.6,4.5,0.4,-4.1,0,81.8,81.8,,,
1994-01-01,2085.8,1725.6,-360.2,,,,50027,39843,-10184,1725.6,0,-1725.6,3446.3,2859.1,-587.2,6635.3,9525.5,2890.2,5534.1,4772.6,-761.5,2641.3,2983.3,342,12108.8,11377.1,-731.699999999999,,,,,,,19186.9,11365.7,-7821.2,46514.1,37560.5,-8953.6,21338.6,12435.2,-8903.4,,,,426.7,826.8,400.1,770.6,337.7,-432.9,1.6,0.1,-1.5,8612.6,7578.1,-1034.5,0.1,0,-0.1,3496.2,3799,302.8,81.6,80.8,-0.799999999999997,2,8.5,6.5,38,53.5,15.5,64.5,66.6,2.09999999999999,9.8,10.2,0.399999999999999,101.5,135,33.5,20.2,94.8,74.6,0.3,20.2,19.9,15,56,41,0,0,0,52,69,17,0.1,2.3,2.2,1.8,11.6,9.8,7,14.9,7.9,130.4,149.2,18.8,0,0.9,0.9,2.7,4.8,2.1,1.2,3.4,2.2,0.5,5,4.5,0,0.4,0.4,0.4,0.8,0.4,1.8,5.9,4.1,0.2,2.4,2.2,0.8,1.1,0.3,2.1,10.6,8.5,86.9,45.6,-41.3,50.8,39,-11.8,,,,,,,44.6,17.3,-27.3,0.2,3.3,3.1,0,2.3,2.3,197.2,248.2,51,528.6,344.5,-184.1,5.6,9.6,4,3.2,10.3,7.1,0,1.4,1.4,131.1,91.1,-40,60,85.3,25.3,19.1,11.1,-8,157.7,181.3,23.6,686.2,647.2,-39,3.3,54.5,51.2,10.9,18.9,8,122,364.5,242.5,0,0,0,14.5,7.4,-7.1,336.2,177.9,-158.3,0,0,0,131.1,98.7,-32.4,131,73.1,-57.9,0,0,0,127.5,86.9,-40.6,1653.2,1791.7,138.5,183.1,298.8,115.7,442.7,1223.2,780.5,496.7,726,229.3,20.7,20.4,-0.300000000000001,0,0.1,0.1,1.2,0.3,-0.9,1038.5,1043.4,4.90000000000009,2070.6,1453.6,-617,127.6,98.9,-28.7,0,0,0,24.6,14.4,-10.2,5.3,4.2,-1.1,38.2,16.2,-22,6,0.4,-5.6,411.5,347.9,-63.6,2.2,0.8,-1.4,2.7,5.4,2.7,0.5,1.8,1.3,47.7,36.3,-11.4,0,0,0,138.5,188.4,49.9,2.5,2,-0.5,19.8,19.3,-0.5,0,6.5,6.5,0,1.9,1.9,0.1,8,7.9,4.1,3.9,-0.2,0,0,0,0,0.2,0.2,2,0,-2,0.1,5.7,5.6,0.1,2.7,2.6,233.2,356.9,123.7,53.7,55.7,2,0.6,0.6,0,5.7,7.5,1.8,0.1,0.6,0.5,0.4,0,-0.4,1038.6,535,-503.6,0,0,0,9.8,15.1,5.3,18.8,10.7,-8.1,0.5,15,14.5,10.1,0.6,-9.5,0,0.3,0.3,,,,,,,,,,0.2,0.1,-0.1,42,78.2,36.2,5.8,19.1,13.3,13.4,9,-4.4,113.8,267.8,154,1.1,9.8,8.7,5.2,15.3,10.1,2.1,27,24.9,0,0.1,0.1,0.2,21,20.8,0,0,0,0,0,0,0,0,0,4.5,19.1,14.6,102.8,64.2,-38.6,0,0,0,480.6,552.1,71.5,6.8,12.4,5.6,55.1,138.9,83.8,4.7,19.3,14.6,29.1,17.8,-11.3,7.9,19.2,11.3,0.9,0.1,-0.8,383.2,169.5,-213.7,76.5,69.9,-6.59999999999999,9.3,1.5,-7.8,61.3,23.8,-37.5,98.1,6.1,-92,6.6,0.4,-6.2,748.7,339.1,-409.6,0,0.4,0.4,0.3,0,-0.3,0,0.3,0.3,992.1,625.5,-366.6,1116.8,1069.6,-47.2,528.4,380.6,-147.8,,,,3.1,95.4,92.3,451.5,296.9,-154.6,57.7,1,-56.7,0,0,0,1.7,0,-1.7,2763.1,551,-2212.1,3,0.2,-2.8,0,0,0,1392.9,1392.1,-0.800000000000182,876.2,751.5,-124.7,2148.2,1559.4,-588.8,8469.9,3839,-4630.9,264.8,702.3,437.5,0,0.4,0.4,0.1,0,-0.1,0,0,0,0.1,0,-0.1,10.7,3.1,-7.6,111.5,98.2,-13.3,0,0.1,0.1,2.6,0.2,-2.4,0,0,0,0,1.1,1.1,0.1,0,-0.1,0,0.1,0.1,0,0,0,0,2.9,2.9,0,0,0,2.4,1.7,-0.7,0,0,0,1,5.7,4.7,0.7,2.3,1.6,1.1,2.6,1.5,0.1,1.5,1.4,0,0,0,31,4.2,-26.8,0.5,0.4,-0.1,14.7,33.7,19,118,155.5,37.5,1.5,22.2,20.7,0,0,0,63.1,238.6,175.5,1.1,2.1,1,,,,0.1,1.8,1.7,0,0.1,0.1,0,1.5,1.5,0.5,7,6.5,0.3,2.9,2.6,0.3,1.2,0.9,8.2,3.4,-4.8,6.8,1.5,-5.3,24.6,4.2,-20.4,20.3,12.5,-7.8,0.3,0.1,-0.2,0,1.7,1.7,0.7,0.5,-0.2,182.3,52.8,-129.5,0,0.4,0.4,83,3.5,-79.5,0,0,0,0,0,0,0.1,0.3,0.2,0.3,1,0.7,177.1,6.8,-170.3,18.3,5.1,-13.2,0,0.1,0.1,0,0.8,0.8,0,0,0,0,6.1,6.1,21.9,2.3,-19.6,0.2,0.2,0,0.5,0.1,-0.4,0,2,2,0,0,0,0,0.2,0.2,0,1,1,0.3,0.9,0.6,9.5,18.5,9,0.3,0.8,0.5,0.7,0,-0.7,1.4,1.9,0.5,16,1.5,-14.5,0.4,4.6,4.2,2,0.4,-1.6,,,,1.8,0.1,-1.7,0,0.1,0.1,0,0,0,166.9,159.9,-7,1,1.6,0.6,0.3,1.7,1.4,5.2,6.1,0.899999999999999,1.8,0.1,-1.7,3.8,6.5,2.7,6,0.6,-5.4,5.7,0.1,-5.6,0,0,0,0,0,0
1994-02-01,2025.9,1378.6,-647.3,,,,50399,38293,-12106,1960.8,0,-1960.8,3262.4,2995,-267.4,6705.2,8862.1,2156.9,4780.9,3912.2,-868.7,2719,2862.8,143.8,12688.1,11864.7,-823.4,,,,,,,18315.6,10780.6,-7535,46653.7,37125.6,-9528.10000000001,20276.6,11801.4,-8475.2,,,,341.2,777.7,436.5,763.1,288.6,-474.5,0.2,0.1,-0.1,9074.6,8182.6,-892,0.1,0,-0.1,3613.5,3682.1,68.5999999999999,90.2,91.4,1.2,8.7,11.3,2.6,42.1,54,11.9,75,66,-9,16.5,8,-8.5,124.6,114,-10.6,21.9,84,62.1,0.4,19.1,18.7,30.5,60,29.5,0,0,0,54.6,86.2,31.6,0.1,2.8,2.7,1.9,16.1,14.2,8.2,13.5,5.3,207.2,202,-5.19999999999999,0,1.2,1.2,1.4,4.3,2.9,1.8,2.6,0.8,0.5,5.6,5.1,0,0.4,0.4,0.8,1.8,1,1.8,7,5.2,0.6,2.7,2.1,1.3,2.5,1.2,2.9,14.3,11.4,81.9,53.6,-28.3,44.7,42.8,-1.90000000000001,,,,,,,51.9,15,-36.9,0.1,4.2,4.1,0,2.4,2.4,251.8,242.5,-9.30000000000001,558.9,310,-248.9,7.5,8,0.5,2.9,6.5,3.6,0,0.8,0.8,113.4,78,-35.4,64.5,88.8,24.3,13.2,11,-2.2,161.7,186.3,24.6,568.7,495.9,-72.8000000000001,4.5,48.1,43.6,8.9,17.7,8.8,91.4,380.4,289,0,0,0,16.7,7.7,-9,368,181,-187,0,0,0,134.6,122,-12.6,122.5,63.8,-58.7,0.3,0,-0.3,140.2,77.8,-62.4,1751.1,2373.2,622.1,280.2,267,-13.2,454.9,984,529.1,499.9,711.6,211.7,22,37.9,15.9,0,0.2,0.2,1.2,0.6,-0.6,1178,998,-180,2259.9,1461.3,-798.6,123.2,91.4,-31.8,0,0,0,19.1,26.1,7,13.5,2.3,-11.2,30.6,17.5,-13.1,6.1,0.9,-5.2,472.1,283.3,-188.8,1.5,0.5,-1,3.2,17.2,14,0.6,1.3,0.7,43.5,44.5,1,0,0,0,193.5,142.5,-51,2.9,0.9,-2,17.6,13,-4.6,0,5.3,5.3,0.1,1.2,1.1,0,0.1,0.1,0.8,29,28.2,0.4,0.3,-0.1,0,12.3,12.3,4.4,1.1,-3.3,0.2,0.8,0.6,0.2,12.5,12.3,255.6,328.6,73,64.2,52,-12.2,1.3,0.5,-0.8,9.1,5.5,-3.6,0,0,0,0.2,0,-0.2,982.7,501.1,-481.6,0,0,0,7.7,9,1.3,16.9,6,-10.9,0.3,0.4,0.1,8.1,1.3,-6.8,0,0,0,,,,,,,,,,2,0.1,-1.9,44.8,55.5,10.7,9.4,11.3,1.9,8.6,6.4,-2.2,99.9,158,58.1,1.1,13.5,12.4,0.5,15.2,14.7,1.1,32.4,31.3,0,0.5,0.5,0,21,21,0,0,0,0,0,0,0,0,0,1.6,17.7,16.1,117.4,77.6,-39.8,0,0,0,348.5,517.4,168.9,7.4,14.4,7,43.8,129.7,85.9,3.4,14.8,11.4,8.9,16.5,7.6,9.7,18.2,8.5,0.1,0.2,0.1,405,168.3,-236.7,86,45.5,-40.5,11.4,0.3,-11.1,74.2,3.7,-70.5,84.5,5.9,-78.6,5.7,0.3,-5.4,690.6,324.7,-365.9,0,0.6,0.6,0.1,4,3.9,0,0.1,0.1,932.7,486.3,-446.4,928.9,844.6,-84.3,435.3,148.9,-286.4,,,,1.4,5.5,4.1,400,279.6,-120.4,45.9,0.8,-45.1,0,0,0,1.4,0,-1.4,2499.2,877.9,-1621.3,2.5,0,-2.5,0,0,0,1291.4,1210.7,-80.7,612.7,726.9,114.2,1947.9,1130,-817.9,8887.6,4309.4,-4578.2,225.9,667.6,441.7,0,0.2,0.2,0,0,0,0,0,0,0,0,0,1.5,4.2,2.7,105.4,88.3,-17.1,0,0,0,0.1,0,-0.1,0,0,0,0,0.3,0.3,0.1,0,-0.1,0,0.1,0.1,0,0,0,0,2.3,2.3,0,0,0,1.1,1.4,0.3,0,0,0,0.4,5.4,5,0.7,2.5,1.8,1.2,1.8,0.6,0,0.7,0.7,0,0,0,4.5,2.5,-2,0.3,0.4,0.1,15.4,30.6,15.2,139,122.5,-16.5,2.1,15.3,13.2,0,0,0,33.4,220.5,187.1,1.2,5,3.8,,,,0,0,0,0,0,0,0.1,0.5,0.4,4.7,1.4,-3.3,1.3,1.4,0.0999999999999999,0.2,0.9,0.7,5.4,3.4,-2,2.7,1.4,-1.3,25.1,5.6,-19.5,11.5,7,-4.5,0,0.3,0.3,0.2,0.8,0.6,0.7,0.6,-0.1,305.3,32.6,-272.7,0,0.2,0.2,70.4,4,-66.4,0.1,0.5,0.4,0,0,0,0,0.3,0.3,0.2,1,0.8,118.6,21.3,-97.3,44.9,3.9,-41,0,0.1,0.1,0,0.4,0.4,0,0.2,0.2,0.2,9.9,9.7,5,2.6,-2.4,1.1,0,-1.1,0.5,0.1,-0.4,0,0.5,0.5,0,0,0,0,0.1,0.1,0,0.4,0.4,0,0.4,0.4,8.2,16.4,8.2,0.1,0.7,0.6,0,0,0,1.7,1.9,0.2,13.5,0.9,-12.6,0.9,1.1,0.2,4.5,0.8,-3.7,,,,0.6,0,-0.6,0.6,0.2,-0.4,0,0,0,107.8,144.5,36.7,0.7,1,0.3,0.9,1.5,0.6,8.2,2.3,-5.9,1.1,0.2,-0.9,6.2,4.8,-1.4,4.6,0.4,-4.2,3.9,0,-3.9,0,0,0,0,1.9,1.9
1994-03-01,2228.9,1545.5,-683.4,,,,52267,42487,-9780,2425.1,0,-2425.1,3886.5,3886,-0.5,8325.3,11036.5,2711.2,5386.8,5087.2,-299.6,3288.3,3341.4,53.0999999999999,15136.7,14787.6,-349.1,,,,,,,20562.5,12820.7,-7741.8,54662.7,46138.6,-8524.1,22908.4,13947,-8961.4,,,,386.8,886.3,499.5,766,400.3,-365.7,2,0.3,-1.7,10929.7,10409.4,-520.300000000001,0,0,0,4207,4378.2,171.2,103.8,109.8,6,6.5,10.5,4,55.5,74.5,19,94,83.9,-10.1,16.1,12.2,-3.9,153.9,159.6,5.69999999999999,25.3,117.6,92.3,1,21.3,20.3,32.3,54.8,22.5,0,2.6,2.6,64.2,87.7,23.5,0.2,2.9,2.7,14.1,10.8,-3.3,10.8,18.1,7.3,264.3,224,-40.3,0,1,1,1.4,4.3,2.9,2,3.7,1.7,0.3,5.4,5.1,0,0.4,0.4,0.7,2,1.3,2.6,7,4.4,0.4,2.4,2,0.9,2.3,1.4,3,15.1,12.1,80.3,40.3,-40,31.8,47,15.2,,,,,,,31.1,25.4,-5.7,0.5,5,4.5,0,2.8,2.8,253,325.1,72.1,666.1,360.1,-306,8.2,13.4,5.2,3.5,12.7,9.2,0,5.4,5.4,128.6,96.3,-32.3,65.3,87.3,22,18,17.2,-0.800000000000001,198.8,234.3,35.5,740.9,583.2,-157.7,39.4,52,12.6,12.3,20.6,8.3,157.2,379.4,222.2,0,0,0,24.4,8.3,-16.1,466.4,223.5,-242.9,0,0,0,163.9,110.9,-53,152.2,80.2,-72,0.6,0,-0.6,165.5,168.5,3,2168.6,3254,1085.4,283.5,284.8,1.30000000000001,687.1,1295.2,608.1,580.5,911.9,331.4,27.5,19,-8.5,0,0.4,0.4,1.2,0.3,-0.9,1481.7,1299.5,-182.2,2744.2,1827.4,-916.8,143.6,114.9,-28.7,0,0,0,28.1,25.2,-2.9,10,5.7,-4.3,43.7,22,-21.7,10.1,0.6,-9.5,539,809.4,270.4,1.5,1.3,-0.2,5.8,6.7,0.9,1.9,2.2,0.3,69.3,102.4,33.1,0,0,0,213.2,209,-4.19999999999999,2.5,1.5,-1,18.5,14.4,-4.1,0,6.4,6.4,0,1.9,1.9,0.1,3.7,3.6,6,10.2,4.2,0.4,0.2,-0.2,0,0.4,0.4,6.4,0.1,-6.3,0.3,7.8,7.5,0.2,13,12.8,315.2,434.2,119,83,81.5,-1.5,0.4,1,0.6,8.2,7.3,-0.899999999999999,0,0,0,0.1,0,-0.1,1249.2,584.5,-664.7,0,0,0,11.9,8.7,-3.2,19.4,7.9,-11.5,1.3,0.3,-1,10.7,0.6,-10.1,0,0,0,,,,,,,,,,0.2,0.3,0.1,26.8,64,37.2,7,18,11,17.6,8.9,-8.7,137,268.8,131.8,4.4,6.9,2.5,8,13,5,3.1,34.7,31.6,0,0.1,0.1,0,26.5,26.5,0,0,0,0,1.2,1.2,0,0,0,3,37,34,149.3,101.8,-47.5,0,0,0,436.9,514.5,77.6,11.2,15.2,4,35.8,134.5,98.7,5,14.8,9.8,11.6,18.9,7.3,11,23.6,12.6,0.7,1,0.3,510.3,158.1,-352.2,81.2,64.1,-17.1,15,0.5,-14.5,110.8,10.5,-100.3,93.8,36.3,-57.5,5.2,1.6,-3.6,799,399.3,-399.7,0.5,2.3,1.8,0.5,0,-0.5,0,0.4,0.4,1023.9,717.7,-306.2,1295,1176.3,-118.7,485.7,202.3,-283.4,,,,2.2,6.3,4.1,473.6,313,-160.6,34.2,1,-33.2,0,0,0,1.3,0,-1.3,2183,783.7,-1399.3,1.9,0,-1.9,0,0,0,1503.4,1420.1,-83.3000000000002,580.7,885.8,305.1,2007.7,1605,-402.7,10595.4,4842.7,-5752.7,235.7,755.7,520,0,0,0,0,0,0,0,0,0,0,0,0,1.7,7.3,5.6,140.3,103.8,-36.5,0,0.1,0.1,0.1,0,-0.1,0,0,0,0,0.6,0.6,0.1,0,-0.1,0,0,0,0.1,0,-0.1,0.1,4.3,4.2,0,0,0,2.4,2.6,0.2,0,0,0,0.6,5.7,5.1,0.6,2.2,1.6,0.3,2,1.7,0.3,0.6,0.3,0,0,0,4.2,0.9,-3.3,0.3,0.5,0.2,15.2,24.9,9.7,156.8,135.9,-20.9,7.2,58.8,51.6,0,0,0,54.8,219.9,165.1,3,13.7,10.7,,,,0.2,0,-0.2,0,0.7,0.7,0,1.1,1.1,3.9,3.2,-0.7,0.5,2.1,1.6,0,0.5,0.5,5.9,3.6,-2.3,5.1,2.5,-2.6,13.3,6.8,-6.5,18.5,8.7,-9.8,0.2,0.4,0.2,0,1.6,1.6,0.2,0.9,0.7,261.7,50,-211.7,0,0.5,0.5,25.4,4.5,-20.9,0.2,0.2,0,0,0,0,0,1.2,1.2,0.2,1.5,1.3,147.1,28.2,-118.9,32.5,2.6,-29.9,0,0.2,0.2,0,0.1,0.1,0,0,0,0.6,4,3.4,15.6,3.4,-12.2,0.4,0.4,0,0,1.9,1.9,0,1.9,1.9,0,0,0,0,2.1,2.1,0,0.6,0.6,0.3,0.9,0.6,7.9,15.3,7.4,0,0.3,0.3,0,0,0,1.1,4.5,3.4,19.1,1.8,-17.3,0.4,3.4,3,2.3,0.3,-2,,,,0,0,0,0,0.4,0.4,0,0,0,174.3,199.4,25.1,1,1.1,0.1,1.6,2.1,0.5,4.1,2.8,-1.3,1.8,0.3,-1.5,7.4,7.1,-0.300000000000001,3.3,0.7,-2.6,6.1,0,-6.1,0,0,0,0,0,0
1994-04-01,2413.1,1337.7,-1075.4,,,,52936,41251,-11685,2340.2,0,-2340.2,3557.9,3390.4,-167.5,7325.6,9881.1,2555.5,5255.2,4645.8,-609.4,2860.8,3300.8,440,14184.8,13205.5,-979.299999999999,,,,,,,19787.9,11451.7,-8336.2,51471.7,41586.9,-9884.8,21928.1,12513.1,-9415,,,,389.9,865.8,475.9,982.5,356.8,-625.7,1.1,0.3,-0.8,10356.8,9383.2,-973.599999999999,0,0.1,0.1,3828,3822.3,-5.69999999999982,85.9,89.8,3.89999999999999,5,8.4,3.4,42.1,68.4,26.3,70.7,78.5,7.8,14.7,12.4,-2.3,124,128.4,4.40000000000001,21.8,95.9,74.1,1.8,50.3,48.5,12.6,50.3,37.7,0,0.1,0.1,57.3,89.4,32.1,0.1,2,1.9,1.1,20.4,19.3,8.2,14.3,6.1,228.6,286.9,58.3,0,0.9,0.9,2.2,3.5,1.3,1.7,3.1,1.4,0.3,6.1,5.8,0,0.6,0.6,0.5,3.1,2.6,1.6,5.8,4.2,0.4,4.3,3.9,0.5,1.8,1.3,2.7,11.2,8.5,105.5,48.1,-57.4,18.7,40.5,21.8,,,,,,,41.4,23,-18.4,0.2,4.8,4.6,0.2,2.5,2.3,256,355.7,99.7,597.6,356.9,-240.7,8,8.5,0.5,4.3,7.4,3.1,0,1,1,128.8,93.6,-35.2,64.8,107.2,42.4,13.4,11.3,-2.1,175.7,222.3,46.6,644.6,528.3,-116.3,4.9,46.9,42,13.3,20.7,7.4,99.6,386.2,286.6,0,0,0,19,9.4,-9.6,402.8,251.3,-151.5,0,0,0,174.9,88.8,-86.1,144.9,179.5,34.6,0.8,0,-0.8,155.1,93,-62.1,1916.3,2442.6,526.3,205.4,307.4,102,513.4,1081.8,568.4,543.8,869.8,326,28.8,16,-12.8,0,0,0,0.8,0.2,-0.6,1449.7,1044.2,-405.5,2541.5,1656.7,-884.8,145.7,115.5,-30.2,0,0,0,22.3,23.3,1,6.5,3.8,-2.7,35.3,24.5,-10.8,9.3,0.4,-8.9,527.1,687.4,160.3,1.3,1.3,0,3.6,9.3,5.7,0.7,2.6,1.9,51.6,45.8,-5.8,0,0,0,295.8,388.9,93.1,5.7,7.3,1.6,25.6,14.6,-11,0,6.7,6.7,0,0.3,0.3,0,7.5,7.5,1.2,13.4,12.2,0,0.1,0.1,0.1,0.2,0.1,2.1,0,-2.1,0.1,4.6,4.5,0.2,14.6,14.4,282.3,349.1,66.8,74.6,66.4,-8.19999999999999,0.1,1.6,1.5,7.6,9,1.4,0.1,0.1,0,0.3,0,-0.3,1124.4,610.6,-513.8,0,0,0,6.2,12.7,6.5,18.6,8.7,-9.9,0.4,0,-0.4,2.8,0.6,-2.2,0,0,0,,,,,,,,,,0.3,0.6,0.3,44.1,81.1,37,9.3,9.6,0.299999999999999,11.5,11.2,-0.300000000000001,148.2,303.7,155.5,1.2,11.5,10.3,5,20.4,15.4,1.1,36.5,35.4,0,0,0,0.2,22.7,22.5,0,0,0,0,0,0,0,0,0,1.4,16.3,14.9,95.9,102.5,6.59999999999999,0,0,0,635.3,424.1,-211.2,6.7,11.6,4.9,31.5,114.3,82.8,1.7,9.6,7.9,7.3,20.9,13.6,10.2,21.5,11.3,0.3,0.1,-0.2,403.3,164.4,-238.9,64.3,60.7,-3.59999999999999,10.9,0.6,-10.3,58.7,11.7,-47,74.9,9.2,-65.7,5.5,0.5,-5,703.6,360.6,-343,2.9,8.3,5.4,0.4,0.5,0.1,0,0.4,0.4,988,484.3,-503.7,1160.9,931.8,-229.1,447.3,196.6,-250.7,,,,2.8,7.3,4.5,402.1,299.2,-102.9,38,1.3,-36.7,0,0,0,0.9,0.1,-0.8,2491.6,712.7,-1778.9,0.5,0.1,-0.4,0,0,0,1461.1,1333.8,-127.3,615,916.4,301.4,2018.2,1463.8,-554.4,9780.3,4260.2,-5520.1,244.4,746.4,502,0,0,0,0,0,0,0,0,0,0,0,0,11.3,2.5,-8.8,126.7,95.2,-31.5,0,0.1,0.1,0.1,0.3,0.2,0,0,0,0,0.7,0.7,0,0.1,0.1,0,0,0,0,0,0,0,3.8,3.8,0,0,0,1.3,1.7,0.4,0,0,0,0.3,6.6,6.3,0.7,3.2,2.5,1.4,2.4,1,0.1,1,0.9,0,0,0,3.4,1.5,-1.9,0.2,0.3,0.1,15.9,18.1,2.2,106,63.8,-42.2,2.9,9.6,6.7,0,0,0,36.1,330.5,294.4,7.3,5.1,-2.2,,,,0.2,0,-0.2,0,0,0,1.2,1.2,0,0.7,3.5,2.8,4.1,6,1.9,0.1,1.3,1.2,7.5,3.8,-3.7,3.2,1.6,-1.6,17.1,15.1,-2,27.4,6.4,-21,0.3,0.2,-0.1,0.3,0.8,0.5,0.4,0.4,0,363.9,42.5,-321.4,0,0.2,0.2,128.8,2.5,-126.3,0.2,0.3,0.1,0,0,0,0,0.5,0.5,0.2,2.4,2.2,151.6,20.1,-131.5,27.2,2,-25.2,0,0.2,0.2,0,0.1,0.1,0,4.1,4.1,0.1,4.1,4,12.7,1.5,-11.2,0.4,0.1,-0.3,0.3,0.1,-0.2,0,6.4,6.4,0,0,0,0,0.4,0.4,0,0.9,0.9,0.3,3.2,2.9,8.9,15.6,6.7,0.5,0.4,-0.1,0,0,0,1.1,4.3,3.2,12.3,4.3,-8,6.4,1.5,-4.9,8.4,0.9,-7.5,,,,0.7,0,-0.7,0,0.3,0.3,0,0,0,167,164.8,-2.19999999999999,2.2,2,-0.2,0.8,2.1,1.3,6.9,2.9,-4,1.3,0.6,-0.7,3.4,6.9,3.5,2,2,0,2.9,0.1,-2.8,0,32.9,32.9,0,0,0
1994-05-01,2562.1,1528.6,-1033.5,,,,53830,41379,-12451,2425,0,-2425,3645.4,3738.5,93.0999999999999,7456.2,9357.4,1901.2,5820.7,4672,-1148.7,3136.3,3214.8,78.5,14694.7,14399.1,-295.6,,,,,,,19700.1,11759.3,-7940.8,52986.7,42215.3,-10771.4,22064.9,12921.8,-9143.1,,,,418.3,925.1,506.8,969.1,353.9,-615.2,0.5,0.3,-0.2,10662,10018.2,-643.799999999999,0,0,0,4032.7,4380.9,348.2,103.6,108.7,5.10000000000001,3.9,9.1,5.2,40.4,75.5,35.1,86.5,96.5,10,11.5,14.1,2.6,141.4,139.3,-2.09999999999999,32.7,102.3,69.6,0.8,26.5,25.7,15.1,56,40.9,0,0,0,61.2,86,24.8,0.1,1.4,1.3,5,19.9,14.9,12.6,8.4,-4.2,243.4,248.6,5.19999999999999,0,0.9,0.9,1.3,3.4,2.1,3.3,4.5,1.2,0.5,4.3,3.8,0,0.6,0.6,0.4,2.6,2.2,2,6.9,4.9,0.5,3.4,2.9,0.6,1.9,1.3,3,13.6,10.6,99.2,42.5,-56.7,35.8,37.8,2,,,,,,,36.3,19.3,-17,0,4.3,4.3,0.2,2.1,1.9,197.2,283.5,86.3,695.1,350.7,-344.4,6.5,9.1,2.6,1.8,6.9,5.1,0,1.4,1.4,137.2,112.4,-24.8,60.2,94.3,34.1,18.1,12.2,-5.9,157.2,211.3,54.1,738.6,541.7,-196.9,2.7,56.3,53.6,12.6,24.8,12.2,167.5,369.8,202.3,0.3,0,-0.3,21.2,11.4,-9.8,396.2,206.3,-189.9,0.1,0.2,0.1,179.2,93.5,-85.7,139.9,72.2,-67.7,1.2,0,-1.2,156.3,98.6,-57.7,2157.4,2359.8,202.4,308.9,274.9,-34,519.5,991.1,471.6,551.6,785.9,234.3,25.1,19,-6.1,0,0.3,0.3,1.5,0.2,-1.3,1361.3,1039.5,-321.8,2804.2,1564.8,-1239.4,148.3,116.9,-31.4,0,0,0,25.4,22.6,-2.8,9.1,2.9,-6.2,41.7,23,-18.7,10.3,1.6,-8.7,502.4,372,-130.4,1.8,1.8,0,0.7,5.3,4.6,1.1,1,-0.1,53.2,74.4,21.2,0,0,0,296.3,203.9,-92.4,6.5,4.5,-2,22.6,13.5,-9.1,0.2,12.4,12.2,0,0.8,0.8,0,10,10,4.2,7.6,3.4,0.5,1.4,0.9,0.2,0.6,0.4,4.4,0,-4.4,0.1,22.6,22.5,0.1,2.5,2.4,319.8,367.5,47.7,63.5,160,96.5,0.1,2.1,2,7.8,8.7,0.899999999999999,0,0.2,0.2,0.4,0,-0.4,1136.7,733.4,-403.3,0,0,0,13.3,13.6,0.299999999999999,24.3,9.9,-14.4,0,0,0,9.9,0.4,-9.5,0,0,0,,,,,,,,,,0,0.2,0.2,35.6,67.9,32.3,9.8,13.9,4.1,19.6,8.9,-10.7,104.4,206.8,102.4,0.7,8.2,7.5,11.2,18.5,7.3,2,40.6,38.6,0,0,0,0,16.8,16.8,0,0,0,0,0,0,0,0,0,1.6,20.2,18.6,137.1,83.6,-53.5,0,0,0,630.1,436,-194.1,4,12.8,8.8,24.3,121.3,97,30.5,2.6,-27.9,47,48.2,1.2,19,111.7,92.7,0.4,0.4,0,416.1,178,-238.1,74.9,76,1.09999999999999,10.3,0.4,-9.9,64.5,19.1,-45.4,67,16.3,-50.7,2.9,0.2,-2.7,793.6,363.8,-429.8,4.6,8.3,3.7,1.4,0.1,-1.3,0.1,0.5,0.4,1053,520.2,-532.8,1268.4,1143.9,-124.5,445,393,-52,,,,1.7,142.5,140.8,428.4,302.7,-125.7,53.7,1.2,-52.5,0,0.1,0.1,0.5,0.1,-0.4,2979,757.3,-2221.7,2.7,2.1,-0.6,0,0,0,1645.8,1337.2,-308.6,704.2,943.7,239.5,2202.3,1247.2,-955.1,8509,4069.3,-4439.7,262.4,779.4,517,0,0,0,0,0,0,0.4,0,-0.4,0,0,0,0.8,10.5,9.7,146.4,111.1,-35.3,0.5,0.1,-0.4,0,0,0,0,0,0,0,0.7,0.7,0,0.1,0.1,0.1,0,-0.1,0,0,0,0.1,2.7,2.6,0,0,0,1.1,5.6,4.5,0,0,0,1.6,5.6,4,0.4,3.1,2.7,1.2,2.4,1.2,0,0.6,0.6,0,0.1,0.1,3.1,2.7,-0.4,0.2,0.4,0.2,16.7,104.1,87.4,139.9,65.6,-74.3,3.5,27.6,24.1,0,0,0,43.5,159.8,116.3,6,1,-5,,,,0.6,0,-0.6,0,0,0,1,0.8,-0.2,1.3,1.4,0.0999999999999999,0.7,1.9,1.2,0.1,0.9,0.8,9.7,3.4,-6.3,5.8,4.5,-1.3,7.6,9.6,2,18.4,10.9,-7.5,0,0.6,0.6,0.4,1,0.6,0.4,0.5,0.1,397.5,46.4,-351.1,0,0.2,0.2,89,2.3,-86.7,0.1,3.1,3,0,0,0,0,0.2,0.2,0.2,2.6,2.4,151.4,8.4,-143,40.2,1.5,-38.7,0,0,0,0,0.3,0.3,0,1.2,1.2,0,9.2,9.2,14.7,2.5,-12.2,0.1,0.1,0,0.1,0,-0.1,0,2.8,2.8,0,0,0,0,0.9,0.9,0,0.3,0.3,0.1,4,3.9,8.1,8.6,0.5,0.2,0.3,0.1,0,0,0,1.8,7,5.2,15.4,1.4,-14,0.1,2.5,2.4,1.9,1.1,-0.8,,,,0,0,0,0.1,0.4,0.3,0,0,0,169.4,183.2,13.8,0.4,1.6,1.2,1,1.3,0.3,4.7,2.4,-2.3,0.9,0.1,-0.8,3.9,11.8,7.9,6.7,0.6,-6.1,4.7,0,-4.7,0,22.1,22.1,0,0,0
1994-06-01,2949.2,1292.8,-1656.4,,,,55731,42850,-12881,2609.1,0,-2609.1,4191.1,3872,-319.1,8244.5,10454.5,2210,5975.2,4993.8,-981.4,3421.7,3470.2,48.5,15539.6,14604.6,-935,,,,,,,22194.1,12648.6,-9545.5,57138.9,43424,-13714.9,24656.6,13664.1,-10992.5,,,,459.3,956.8,497.5,1111.4,366.2,-745.2,0.8,0.5,-0.3,11346,10187.7,-1158.3,0,0,0,4193.6,4416.9,223.299999999999,112.3,128.3,16,3.5,9.8,6.3,51.2,68.1,16.9,95.2,86.8,-8.40000000000001,15.5,12,-3.5,145.8,290.1,144.3,38.7,105.5,66.8,0.8,24.4,23.6,15,52.8,37.8,0,0.1,0.1,62.7,84.4,21.7,0.3,1.9,1.6,10.9,11.1,0.199999999999999,1.7,7,5.3,297.6,240.2,-57.4,0,1.1,1.1,1.8,3,1.2,1.7,2.7,1,0.2,4.4,4.2,0,0.6,0.6,0.8,1.7,0.9,2.3,6.9,4.6,0.6,3.1,2.5,0.8,1.9,1.1,4.1,11.4,7.3,98.7,38.5,-60.2,32.2,40,7.8,,,,,,,12.4,23.3,10.9,0.3,4.1,3.8,0.2,2.9,2.7,243.3,310.4,67.1,806,335.7,-470.3,8.2,8.3,0.100000000000001,5.4,12.1,6.7,1.8,63,61.2,135.1,102.8,-32.3,64.6,122.2,57.6,26,13.3,-12.7,150,237.5,87.5,761.8,567.5,-194.3,5.3,56.8,51.5,13.9,22.8,8.9,193,349.7,156.7,0,0,0,28.1,9.7,-18.4,409.1,199.2,-209.9,0,0,0,235.1,78.7,-156.4,161.4,62.4,-99,0.9,0,-0.9,212.6,93.2,-119.4,2115.8,2101.2,-14.6000000000004,242.8,276.2,33.4,534.8,1089.5,554.7,553.8,934.2,380.4,21.3,14.9,-6.4,0,0.9,0.9,1.2,0.1,-1.1,1401.6,1172.6,-229,2684,1454.3,-1229.7,153.5,110.9,-42.6,0,0,0,27,21.2,-5.8,7.1,2.9,-4.2,33.3,21.9,-11.4,8.1,0.5,-7.6,578.3,480.2,-98.1,2.6,2.3,-0.3,1.3,6,4.7,0.9,4.9,4,47.9,38.2,-9.7,0,0,0,241.3,174.9,-66.4,7.6,5.7,-1.9,20.5,8,-12.5,0.3,6.2,5.9,0,4,4,0,5.7,5.7,6.5,7.9,1.4,0.5,0.1,-0.4,0.3,2.2,1.9,3.5,0.1,-3.4,0,23.7,23.7,0.1,1.6,1.5,332,390.4,58.4,77.6,61.6,-16,0.2,3.8,3.6,5.5,4.6,-0.9,0,0.1,0.1,0.3,0.1,-0.2,1344.9,709,-635.9,0,0,0,11.1,13.1,2,26.8,5.7,-21.1,0.5,1.2,0.7,6.4,0.5,-5.9,0,0,0,,,,,,,,,,1.5,0.3,-1.2,44.2,58.4,14.2,14.7,18.9,4.2,21.1,3.1,-18,109.9,261.1,151.2,0.9,17,16.1,12.9,14.6,1.7,2.8,37.8,35,0,0,0,0,17.8,17.8,0,0,0,0,0,0,0,0,0,1.7,25.7,24,135.8,68.4,-67.4,0,0,0,716,414.5,-301.5,5.6,11.2,5.6,27.1,109.6,82.5,12,5.6,-6.4,55.1,12,-43.1,8.7,117,108.3,0.5,0.8,0.3,426.8,327.5,-99.3,80.5,39.8,-40.7,8.7,0.5,-8.2,92.5,11.8,-80.7,77.2,8.3,-68.9,4.8,0.5,-4.3,825,381.6,-443.4,2.5,10.2,7.7,1.8,0,-1.8,0.2,0.6,0.4,1108.5,537.8,-570.7,1304.9,1034.9,-270,518.3,206.4,-311.9,,,,18.3,52.4,34.1,487.5,340.4,-147.1,61.9,0.9,-61,0,0.1,0.1,0.9,0.1,-0.8,3463.3,1009.4,-2453.9,2.4,0.1,-2.3,0,0.2,0.2,1633.3,1341.2,-292.1,813.2,1231.3,418.1,2223.8,1386.4,-837.4,10111.7,4571,-5540.7,277.7,822.8,545.1,0,0,0,0,0.1,0.1,0.1,0,-0.1,0,0,0,18.2,10.2,-8,153.6,103.6,-50,0.3,0.1,-0.2,0.1,0,-0.1,0,0,0,0,0.5,0.5,0,0.1,0.1,0,0,0,0,0,0,0.1,2.7,2.6,0,0.1,0.1,1.9,2.5,0.6,0,0,0,0.6,5.4,4.8,0.7,2.4,1.7,0.5,2.5,2,0,0.8,0.8,0,0,0,5.3,2.3,-3,0.2,0.7,0.5,12.3,32.1,19.8,139.7,87.5,-52.2,12,21.5,9.5,0,0,0,44.5,244.2,199.7,1.5,2.3,0.8,,,,0.1,0,-0.1,0,0.1,0.1,0,1.2,1.2,6.6,4.3,-2.3,0.5,1.7,1.2,0.1,0.6,0.5,5.9,3.3,-2.6,3.6,1.6,-2,7.2,6,-1.2,21.9,9.2,-12.7,0,0.6,0.6,0.1,1,0.9,0.3,1.3,1,474.5,38.4,-436.1,0.2,0.1,-0.1,126.2,3.1,-123.1,0.1,1,0.9,0,0,0,0.2,0.4,0.2,4.8,1.5,-3.3,160,8.3,-151.7,33.3,1.6,-31.7,0,0.1,0.1,0,1,1,0,0.8,0.8,0,1.3,1.3,13.7,2.3,-11.4,0.4,5.7,5.3,0,0.6,0.6,0,0.5,0.5,0,0,0,0,0.5,0.5,0,0.5,0.5,0.6,6.6,6,9.1,15.5,6.4,0.1,0.3,0.2,0,0,0,1.2,2.7,1.5,15.6,1.3,-14.3,0.5,2.8,2.3,4.2,3.1,-1.1,,,,2.3,0,-2.3,0.2,0.4,0.2,0,0,0,191.7,193.7,2,1.6,0.7,-0.9,1.4,2.2,0.8,4.5,1.8,-2.7,1.4,0.1,-1.3,3.6,7.7,4.1,2.6,0.6,-2,5.1,0.9,-4.2,0,10.8,10.8,0,0,0
1994-07-01,3099.4,1316.9,-1782.5,,,,56096,41955,-14141,2379.7,0,-2379.7,3632.8,3358.4,-274.4,7781.1,9080.1,1299,6108.7,4805,-1303.7,3237.3,3325.3,88,12673.2,11849.1,-824.1,,,,,,,22613.1,12263.6,-10349.5,54806.9,39218.1,-15588.8,25532.9,13220.6,-12312.3,,,,420.4,1067.8,647.4,1092.4,333.5,-758.9,0.6,0.1,-0.5,9058.9,7642.1,-1416.8,0,0,0,3614.3,4207,592.7,118.4,103.7,-14.7,4.4,9.1,4.7,52.5,62.8,10.3,93.4,81.6,-11.8,10.4,16.6,6.2,132.3,137,4.69999999999999,30.1,109,78.9,0.4,21.2,20.8,9.6,70.3,60.7,0,0,0,51.6,80.5,28.9,0.1,3.1,3,0.8,10.5,9.7,0.1,4.2,4.1,290.5,218.1,-72.4,0,1.7,1.7,0.8,3.9,3.1,1.5,3.2,1.7,0.5,5.1,4.6,0.1,0.5,0.4,0.5,2,1.5,2.7,6,3.3,0.5,3.4,2.9,0.3,2,1.7,2.8,16.9,14.1,88.6,45,-43.6,40.1,41.8,1.7,,,,,,,42.7,24.7,-18,0.3,4.2,3.9,0.2,2.3,2.1,260.8,349,88.2,703.9,289.3,-414.6,5.6,9.7,4.1,4.3,9,4.7,0,0.9,0.9,154.6,109.1,-45.5,68.3,137.2,68.9,17.7,14.6,-3.1,131.8,234.4,102.6,767.9,673.3,-94.6,2.1,50.6,48.5,16.2,25.7,9.5,127.9,332.1,204.2,0,0,0,21.2,10.3,-10.9,368.3,156.1,-212.2,0,0,0,227.1,105.2,-121.9,160.4,66.9,-93.5,1.2,0.1,-1.1,162.8,106.7,-56.1,2080.9,1894,-186.9,201.3,247.2,45.9,480,893,413,570.9,797,226.1,23.9,14.6,-9.3,0,2.1,2.1,1.6,1.8,0.2,1364.9,1093.6,-271.3,2771.8,1433.3,-1338.5,157.6,96,-61.6,0,0,0,27.1,21.4,-5.7,13.8,3.7,-10.1,42.4,57.9,15.5,6.8,1.1,-5.7,530.5,529.8,-0.700000000000045,1.9,1.6,-0.3,1.5,5.8,4.3,0.7,7.1,6.4,61.3,47.7,-13.6,0,0,0,279.8,154.7,-125.1,4.6,6.9,2.3,25.6,11.7,-13.9,0,7.9,7.9,0,0.8,0.8,0.1,12.1,12,2.7,5.8,3.1,0.8,0.1,-0.7,0.8,5.3,4.5,0.9,2.6,1.7,0,5.2,5.2,0.2,6.9,6.7,306.2,397.6,91.4,77.9,48.2,-29.7,0.1,2.5,2.4,6,4.8,-1.2,0,0.6,0.6,0.3,0,-0.3,1418.5,526.1,-892.4,0,0,0,9.6,15.5,5.9,22.8,8.2,-14.6,0.2,0.1,-0.1,5,0.7,-4.3,0,0.1,0.1,,,,,,,,,,0.2,0.2,0,36.9,73.2,36.3,14.7,20.5,5.8,17.3,8.4,-8.9,110.6,165.7,55.1,0.7,20.2,19.5,0.3,14.6,14.3,2.2,33.2,31,0,0,0,0,24,24,0,0,0,0,0,0,0,0,0,2.1,24.2,22.1,159.7,68.9,-90.8,0,0,0,783.4,452.7,-330.7,5.8,12.2,6.4,55.7,142.9,87.2,37.4,23.7,-13.7,121.6,12,-109.6,20.2,20.4,0.199999999999999,0.1,0.4,0.3,473.6,166.1,-307.5,79.2,34.9,-44.3,11.9,0.3,-11.6,92.3,8,-84.3,110.8,21.2,-89.6,5,0.8,-4.2,889,430,-459,2.6,6,3.4,0.6,0.1,-0.5,0,1.7,1.7,1205.1,565.9,-639.2,1270.4,969.4,-301,689.7,209.2,-480.5,,,,3.2,12.1,8.9,489.2,296.6,-192.6,77.7,0.9,-76.8,0,0,0,0.8,0.1,-0.7,3645.4,970.4,-2675,2.1,0.2,-1.9,0,0,0,1795.3,1566.1,-229.2,880,977.6,97.6,2163,1291.9,-871.1,9989.6,4358.3,-5631.3,280.7,915,634.3,0,0.1,0.1,0.2,0,-0.2,0,0,0,0,0,0,12.2,3.9,-8.3,111.6,126.3,14.7,0.2,0.1,-0.1,0.1,0,-0.1,0,0,0,0,0.5,0.5,0,0.3,0.3,2.5,0.1,-2.4,0,0,0,0.1,3,2.9,0,0,0,2,3.4,1.4,0,0,0,1.1,7.4,6.3,0.5,2.5,2,0.6,1.5,0.9,0.2,0.6,0.4,0,0,0,7.8,2.3,-5.5,0.6,0.8,0.2,17.9,26.3,8.4,157.7,83.4,-74.3,2.8,25.6,22.8,0,0,0,49.3,171.2,121.9,4.1,1.4,-2.7,,,,0,0,0,0,0.1,0.1,0,0.6,0.6,18.8,1.8,-17,0.3,7,6.7,0.2,0.6,0.4,10.4,4.1,-6.3,5.1,0.8,-4.3,15.4,4.7,-10.7,14.2,9,-5.2,0.2,0.2,0,0.3,0.6,0.3,0.1,1.2,1.1,447.3,29.9,-417.4,0,0.2,0.2,96,4.5,-91.5,0.4,0.9,0.5,0,0,0,0,1.3,1.3,0.2,1.6,1.4,169.7,16.5,-153.2,30.1,2.4,-27.7,0,0,0,0.1,0.2,0.1,0,0.9,0.9,0.1,1.1,1,11.8,4.1,-7.7,1.5,0.6,-0.9,0,1.6,1.6,0,5.2,5.2,0,0,0,0,0.6,0.6,0,0.6,0.6,0.3,1,0.7,8.5,9,0.5,0.1,1.4,1.3,0,0,0,0.9,3.4,2.5,19.9,1.8,-18.1,0.3,2.6,2.3,8.2,2,-6.2,,,,0,0,0,0,0.3,0.3,0,0,0,187,178.9,-8.09999999999999,6.1,0.2,-5.9,0.9,2.8,1.9,8.8,3.9,-4.9,2.2,0.1,-2.1,6.1,11,4.9,3.4,2.9,-0.5,7.3,1.6,-5.7,0,8.3,8.3,0,0,0
1994-08-01,3138.5,1396.1,-1742.4,,,,57396,44377,-13019,2775.8,0,-2775.8,4096.6,3821.2,-275.400000000001,8327.9,9964.7,1636.8,6555.9,5247.2,-1308.7,3637.9,3430.4,-207.5,15310.1,14367.5,-942.6,,,,,,,24317.9,13332.1,-10985.8,59303.5,43589,-15714.5,27232.8,14224.1,-13008.7,,,,413.5,1181.8,768.3,1250,374.6,-875.4,0.7,0.4,-0.3,10954.7,9912.4,-1042.3,0,0,0,4355.4,4455.1,99.7000000000007,126.6,129,2.40000000000001,3.2,8.9,5.7,59.9,78.7,18.8,108.5,88.7,-19.8,14.7,13.8,-0.899999999999999,145.5,143.1,-2.40000000000001,29.7,112.2,82.5,0.5,21.8,21.3,19.3,65.7,46.4,0,0.5,0.5,65,91.1,26.1,0.8,2.9,2.1,1.4,11,9.6,0.2,2.7,2.5,284.7,255.3,-29.4,0.1,0.7,0.6,1.3,2.9,1.6,1.3,4.6,3.3,0.7,6.8,6.1,0,0.4,0.4,0.7,2.5,1.8,2.4,6,3.6,0.4,3.3,2.9,0.4,2.2,1.8,2.4,13.1,10.7,90.8,43.6,-47.2,65.4,33.3,-32.1,,,,,,,51.3,21,-30.3,0.1,4.3,4.2,1.3,2.4,1.1,351.6,353.9,2.29999999999995,847.4,314.9,-532.5,8.4,8.6,0.199999999999999,3.8,9.2,5.4,0,0.9,0.9,185.7,93.8,-91.9,78.8,107.8,29,21.7,19.1,-2.6,109.6,216.4,106.8,783.2,656.7,-126.5,3.7,83.8,80.1,18.3,28.8,10.5,147.1,364,216.9,0,0,0,20.4,9.1,-11.3,306.8,185.5,-121.3,0.2,1.3,1.1,207.1,102.2,-104.9,171.1,100.2,-70.9,0.8,0.1,-0.7,134.1,110.5,-23.6,2063.8,2001.9,-61.9000000000001,214,261.3,47.3,474.5,950.2,475.7,434.6,929,494.4,24.2,13.1,-11.1,0,0.2,0.2,1.1,0.3,-0.8,1301.6,1062.2,-239.4,2632.2,1423.5,-1208.7,146.7,109,-37.7,0,0,0,31.5,34.6,3.1,11.1,6.1,-5,39.8,34.6,-5.2,6,1.5,-4.5,488,445.7,-42.3,2.7,2.7,0,2.2,10.1,7.9,2,3.1,1.1,53.9,40.4,-13.5,0,0,0,295.5,176.3,-119.2,2.9,2.3,-0.6,24.5,10.4,-14.1,0.1,10.7,10.6,0,2.7,2.7,0,13.8,13.8,7.5,27.6,20.1,1.2,0.1,-1.1,0.1,0.6,0.5,4.8,0,-4.8,0,62.4,62.4,0.2,18.2,18,331.8,471.6,139.8,108.9,131.9,23,0.1,2.7,2.6,7.5,7.6,0.0999999999999996,0.4,0,-0.4,0.2,0,-0.2,1367.6,467.4,-900.2,0,0,0,12.8,18.6,5.8,26.7,6,-20.7,0.5,4.8,4.3,6.5,0.8,-5.7,0,0,0,,,,,,,,,,0.1,5,4.9,22.6,65.3,42.7,46.1,22.9,-23.2,14.7,8,-6.7,170.6,239.4,68.8,1.1,23.8,22.7,4.8,12.1,7.3,2.8,39,36.2,0,0,0,0,19.1,19.1,0,0,0,0,0,0,0,0,0,3.8,27.3,23.5,125.9,60.4,-65.5,0,0,0,714.7,546.7,-168,6.8,15.7,8.9,26.8,112.3,85.5,25.9,14.5,-11.4,62.8,14.4,-48.4,9.6,24.7,15.1,0.3,0.4,0.1,510.6,193.9,-316.7,91.7,30,-61.7,12,0.7,-11.3,127.4,10.6,-116.8,119,23.9,-95.1,6.8,1.6,-5.2,1014.4,460.5,-553.9,12.1,17.7,5.6,1.1,0,-1.1,0,0.6,0.6,1261.6,533.9,-727.7,1320.6,1119.7,-200.9,612.2,194.8,-417.4,,,,3.7,25.9,22.2,536.3,338.3,-198,88.1,3.2,-84.9,0,0,0,0.7,0.1,-0.6,4165.8,926.4,-3239.4,1.7,0,-1.7,0,0,0,1826.9,1603.9,-223,958.8,1054.3,95.5,2449.6,1469.3,-980.3,10697.2,4895.4,-5801.8,297.6,1029.3,731.7,0,0,0,0,0,0,0,0,0,0,0.1,0.1,3.4,8.9,5.5,96.1,128.9,32.8,0.1,0,-0.1,0.1,0,-0.1,0,0,0,0,0.4,0.4,0,0.2,0.2,0,0,0,0,0,0,0.1,1.1,1,0,0,0,0.8,2.4,1.6,0,0,0,5.8,3.4,-2.4,0.4,2,1.6,1.3,1.2,-0.1,0.3,0.6,0.3,0,0,0,6.6,2.6,-4,0.9,0.7,-0.2,18,24.9,6.9,171,106.7,-64.3,6.1,17.5,11.4,0,0,0,37.9,209.7,171.8,2.4,4.3,1.9,,,,0,0,0,0,0.1,0.1,0.1,2,1.9,7,3.4,-3.6,0.3,7.1,6.8,0.8,0.8,0,10.4,4.2,-6.2,8.1,2.6,-5.5,29.2,8.2,-21,12.2,9.8,-2.4,0,0.1,0.1,0,0.6,0.6,0.3,1.4,1.1,545.5,24.1,-521.4,0,0.2,0.2,88.2,1.4,-86.8,0.2,0.6,0.4,0,0.2,0.2,0,0.3,0.3,0.1,1.3,1.2,208.1,17.6,-190.5,48.8,1.9,-46.9,0,0.1,0.1,0,0.9,0.9,0,0.4,0.4,0,4.6,4.6,21.4,2.6,-18.8,0,2.8,2.8,0,7.3,7.3,0,0.7,0.7,0,0,0,0,0.6,0.6,0,0.3,0.3,6,1.1,-4.9,11.3,27.9,16.6,0.5,0.5,0,0.1,0.6,0.5,1,3,2,22.1,1.5,-20.6,5.7,3.6,-2.1,3.5,1.3,-2.2,,,,0.5,0,-0.5,0,0.4,0.4,0,0,0,172.8,200.8,28,6.6,0.6,-6,1.3,2.5,1.2,1,1.7,0.7,2.5,0.1,-2.4,17.2,6.2,-11,3.4,1.9,-1.5,7.1,0.3,-6.8,0,10.9,10.9,0,0,0
1994-09-01,2814.3,1355.5,-1458.8,,,,57640,44002,-13638,2868.3,0,-2868.3,4421.3,3832.8,-588.5,9247.3,10588.3,1341,6585,5289.1,-1295.9,3566.1,3669.5,103.4,15887.2,14601,-1286.2,,,,,,,23564.9,12675.5,-10889.4,58879.4,43766.5,-15112.9,26419.6,13615.7,-12803.9,,,,380.1,1043.9,663.8,1104.5,444.9,-659.6,0.3,0.2,-0.1,11510.7,10219.8,-1290.9,0.2,0.1,-0.1,4376.5,4381.2,4.69999999999982,109.6,128.2,18.6,3,8.2,5.2,58.3,72.3,14,103.5,86.1,-17.4,17.4,22.9,5.5,147.2,140.1,-7.09999999999999,33.6,111.6,78,0.7,22.5,21.8,10,49.6,39.6,0,0.2,0.2,75.7,103.6,27.9,0.8,2.3,1.5,11.5,17.6,6.1,0,5,5,299.4,240.7,-58.7,0.1,0.7,0.6,0.7,3.5,2.8,1.6,4,2.4,0.2,5.1,4.9,0.2,1.1,0.9,0.4,2,1.6,2.3,6.9,4.6,0.5,3,2.5,0.4,1.7,1.3,2.8,12.3,9.5,113,43.8,-69.2,26.4,56.2,29.8,,,,,,,36.9,26.1,-10.8,0,3,3,0.3,2.6,2.3,298.2,431.6,133.4,732.8,311.6,-421.2,7.5,10.8,3.3,3.7,10.2,6.5,0,114.5,114.5,168.3,114,-54.3,73.4,125.8,52.4,27.6,21.2,-6.4,151,217.8,66.8,842.2,643.6,-198.6,4.1,88,83.9,16.6,28.5,11.9,184.2,369,184.8,0,0,0,14.3,10.1,-4.2,398.1,216.6,-181.5,0,0,0,288.4,146.7,-141.7,143.2,87.7,-55.5,0.6,0,-0.6,377.2,88.9,-288.3,2360.8,2041.5,-319.3,256.3,279.8,23.5,468,1138.2,670.2,489.2,1061.2,572,22.7,18.5,-4.2,0,0.3,0.3,3.6,0.5,-3.1,1384,1087.1,-296.9,2454.3,1594.3,-860,143.4,112.7,-30.7,0,0,0,24.3,24.6,0.300000000000001,6.8,2.9,-3.9,36.5,23.1,-13.4,7.3,2.4,-4.9,582.3,318.7,-263.6,3.5,8.9,5.4,4.7,12,7.3,0.9,5.5,4.6,46.8,49.3,2.5,0,0,0,186.5,350.1,163.6,5.2,2.4,-2.8,40.8,28.1,-12.7,0.1,7,6.9,0,4.9,4.9,0.2,10.3,10.1,1.5,8.1,6.6,0.3,0.2,-0.1,0.4,0.4,0,3,0,-3,0.4,1.1,0.7,0.6,8.4,7.8,271.2,315.4,44.2,70.6,55.7,-14.9,0.2,2.1,1.9,10.4,10,-0.4,0.2,0.2,0,0.2,0.2,0,1012.7,575.1,-437.6,0,0,0,6.4,9.8,3.4,24,6.9,-17.1,0.3,5.7,5.4,8.7,0.7,-8,0,0,0,,,,,,,,,,0.1,0.7,0.6,40.2,60.4,20.2,17.7,11.2,-6.5,23.4,11.8,-11.6,126.4,190.4,64,1.1,24.7,23.6,1.3,8.7,7.4,2,37.3,35.3,0,0,0,0,16.3,16.3,0,0,0,0,0,0,0,0,0,3.8,27.3,23.5,140.9,61.3,-79.6,0,0,0,714.3,468.6,-245.7,5.1,11.1,6,45.6,128.9,83.3,16.4,18.2,1.8,76.4,9,-67.4,9.6,22.7,13.1,0.2,0.5,0.3,490.4,189.9,-300.5,91.3,51,-40.3,8.3,0.4,-7.9,125,31.2,-93.8,82.8,12.3,-70.5,5.9,0.4,-5.5,986,393.4,-592.6,7.3,12.3,5,1.4,0.1,-1.3,0.1,1.2,1.1,1335,689.6,-645.4,1452.4,1289.6,-162.8,596.8,190.9,-405.9,,,,2.7,8.4,5.7,545,375,-170,93.8,3.6,-90.2,0,0,0,0.9,0,-0.9,4134.4,628.5,-3505.9,1.5,0.2,-1.3,0,0,0,1741.3,1615.9,-125.4,946.3,978.4,32.1,2445,1405.2,-1039.8,9908.8,4556.2,-5352.6,279.3,805.9,526.6,0,0.1,0.1,0,0,0,0,0.1,0.1,0,0,0,3.5,2.6,-0.9,80.6,125.8,45.2,0.2,0.1,-0.1,0.1,0,-0.1,0,0,0,0,0.7,0.7,0,0,0,0.8,0.1,-0.7,0,0,0,0.1,0.1,0,0,0,0,0.2,1.5,1.3,0,0,0,0.3,6.2,5.9,0.9,4.4,3.5,0.3,2.1,1.8,0.4,0.5,0.1,0,0,0,12.3,93.1,80.8,1.1,0.6,-0.5,16.3,16.6,0.300000000000001,76.7,90.9,14.2,6.6,51.4,44.8,0,0,0,51.8,174.8,123,2.4,5.6,3.2,,,,0,0,0,0.2,0.1,-0.1,1.1,1.5,0.4,5.6,2.5,-3.1,0.9,1.8,0.9,0.2,1.3,1.1,10,3.8,-6.2,1.7,2.9,1.2,12.2,9.2,-3,12.9,7.9,-5,0.1,0.3,0.2,0.1,1.1,1,0.2,1.1,0.9,432.9,71.8,-361.1,0,0.1,0.1,68.9,4.2,-64.7,0.2,0.5,0.3,0,0,0,0,0.2,0.2,3.5,5.9,2.4,227.2,24.7,-202.5,30.3,2.8,-27.5,0,0,0,0,0.2,0.2,0,0.1,0.1,1.2,2.6,1.4,17.4,4.1,-13.3,0,5.4,5.4,0,10.1,10.1,0,3.3,3.3,0,0,0,0,1.4,1.4,0,0.2,0.2,10.8,2.2,-8.6,9.6,13,3.4,0.1,0.3,0.2,0,0,0,0.7,9.1,8.4,25.3,3.5,-21.8,0.1,4.9,4.8,12.2,35.9,23.7,,,,0,0,0,0,0.2,0.2,0,0,0,171,166.3,-4.69999999999999,0.9,1,0.1,0.9,2.2,1.3,1.7,1.9,0.2,19.3,0.8,-18.5,8.2,6.8,-1.4,6.3,1.3,-5,6.1,0,-6.1,0,23.8,23.8,0,0,0
1994-10-01,2807.3,1592.6,-1214.7,,,,57950,44203,-13747,3005.8,0,-3005.8,4603.9,4060.9,-543,9360.6,10033.9,673.299999999999,6682.4,5131,-1551.4,3381.7,3821.1,439.4,16631,14990,-1641,,,,,,,25176.4,12680.6,-12495.8,61969.8,45313.6,-16656.2,28125.4,13906.7,-14218.7,,,,410.6,1095.5,684.9,898.7,380.6,-518.1,0.9,0.4,-0.5,12049.7,10490.3,-1559.4,0,0.1,0.1,4581.3,4499.7,-81.6000000000004,113.5,122.5,9,3.6,10.2,6.6,58.9,78.3,19.4,98.9,94.1,-4.80000000000001,12.1,20.8,8.7,151.3,142.1,-9.20000000000002,24.7,129.9,105.2,0.5,21.7,21.2,15.1,57.4,42.3,0,0.3,0.3,68.8,97.2,28.4,0.6,2.2,1.6,1.7,13.4,11.7,0.9,20.9,20,300.3,262.6,-37.7,0,1.1,1.1,0.1,5,4.9,1.7,3.9,2.2,0.9,5.4,4.5,0.2,0.7,0.5,0.4,2,1.6,2.5,6.5,4,0.4,3.3,2.9,0.4,2.3,1.9,3,14.1,11.1,76.3,46.1,-30.2,25.7,36.5,10.8,,,,,,,40,19.3,-20.7,0.1,4.3,4.2,0.3,2.8,2.5,277.4,444.8,167.4,728.7,343.4,-385.3,17.3,8.1,-9.2,3.6,11,7.4,1.2,2.7,1.5,162.3,89.7,-72.6,76.8,130.3,53.5,24.2,15.5,-8.7,134.8,243.1,108.3,800.7,756,-44.7,3,103.7,100.7,14.6,36.2,21.6,134.2,409.7,275.5,0,0,0,28.3,9.3,-19,486.6,230.4,-256.2,0,0,0,276.5,112.4,-164.1,146.3,99.9,-46.4,1.2,0,-1.2,164.6,102.6,-62,2130.8,2227.2,96.3999999999996,217.9,290.6,72.7,489.9,1156.1,666.2,589.4,1075,485.6,25.4,19.4,-6,0,0.1,0.1,1.8,0.2,-1.6,1714.2,1145,-569.2,2783.1,1678.2,-1104.9,150.4,125.6,-24.8,0,0,0,28.3,26,-2.3,19.8,2.6,-17.2,45.1,21.4,-23.7,10.5,0.9,-9.6,565.8,385.8,-180,2.3,1.3,-1,3.2,7.4,4.2,1.6,3.5,1.9,65.7,48,-17.7,0,0,0,344.1,182.1,-162,5.1,4.9,-0.199999999999999,26.4,28.2,1.8,0.1,1.4,1.3,0,3.1,3.1,0.3,1.5,1.2,11.8,4.4,-7.4,1.6,1.9,0.3,0.2,0.2,0,3.1,9.9,6.8,0.1,0.7,0.6,0.2,2.8,2.6,304.1,381.3,77.2,72,202.2,130.2,0.1,3.3,3.2,10.3,5.1,-5.2,0,0,0,0.3,0,-0.3,1309.3,580.1,-729.2,0,0,0,7.4,6,-1.4,23.4,6.9,-16.5,0.3,9.5,9.2,2.7,2,-0.7,0,0,0,,,,,,,,,,0.3,3.1,2.8,47.5,76.1,28.6,24.1,20.8,-3.3,29.5,8.2,-21.3,149.6,243,93.4,1.3,22.4,21.1,6.8,18.9,12.1,2,41.9,39.9,0,0,0,0,25.1,25.1,0,0,0,0,0.1,0.1,0,0,0,2.4,23.6,21.2,76.7,111.1,34.4,0,0,0,762.4,627,-135.4,10.1,17.6,7.5,54.8,137.5,82.7,31.6,9.3,-22.3,17.3,15.9,-1.4,13,24.2,11.2,0.2,0.8,0.6,534.4,185.2,-349.2,95,54.5,-40.5,7.1,0.8,-6.3,111.3,40.5,-70.8,106.4,20,-86.4,7.8,3.2,-4.6,994.4,405,-589.4,4.6,78.8,74.2,0.8,0.6,-0.2,0.1,0.9,0.8,1412.2,593.7,-818.5,1395.2,1212.4,-182.8,618,205,-413,,,,3.6,5.1,1.5,550.8,334.6,-216.2,95.1,3,-92.1,0,0,0,0.9,0.1,-0.8,4101.2,618.4,-3482.8,2.5,0,-2.5,0,0,0,1756.2,1621.6,-134.6,1078.1,1006.5,-71.5999999999999,2452.9,1290.5,-1162.4,11315.5,4711.6,-6603.9,298.9,859.8,560.9,0,0,0,0,0,0,0,0.3,0.3,0,0,0,15.6,2.9,-12.7,83.4,215.4,132,0,0.2,0.2,0.2,0,-0.2,0,0,0,0,0.5,0.5,0.4,0.1,-0.3,0,0.3,0.3,0,0,0,0.1,0.2,0.1,0,0,0,1,2.1,1.1,0,0,0,0.6,6.5,5.9,0.7,2.9,2.2,2.7,1.9,-0.8,0.5,0.6,0.1,0,0,0,5.9,1.3,-4.6,0.6,0.5,-0.1,14.7,37.8,23.1,127.9,89.8,-38.1,2.1,13.5,11.4,0,0,0,52.9,332.8,279.9,1.1,3.8,2.7,,,,0,0,0,0,0.1,0.1,0,0.9,0.9,1.8,4.8,3,0.3,5.3,5,1,2.4,1.4,8.3,8.4,0.0999999999999996,2.8,1.4,-1.4,9.2,14.9,5.7,14.4,21.5,7.1,0.9,0.4,-0.5,0.1,0.8,0.7,0.3,1,0.7,293.2,34.1,-259.1,0,0.1,0.1,135.3,2.2,-133.1,0.2,0.1,-0.1,0,0,0,0,0.7,0.7,0.1,0.9,0.8,173.8,13.1,-160.7,34,7.2,-26.8,0,0.1,0.1,0,0.1,0.1,0,0.3,0.3,0.3,1.5,1.2,19.6,6.4,-13.2,1.5,1.8,0.3,0.1,6.1,6,0,0.4,0.4,0,0,0,0,0.2,0.2,0,0.7,0.7,2.5,0.6,-1.9,9.7,8,-1.7,0.3,0.5,0.2,0,0,0,1.5,6,4.5,22,1.5,-20.5,0.2,3.1,2.9,2.6,0.9,-1.7,,,,0.1,0,-0.1,0,0.2,0.2,0,0,0,130.5,198.4,67.9,0.5,2,1.5,1.6,1.6,0,8.4,1.4,-7,2.1,0.3,-1.8,9.3,4.2,-5.1,1.9,3.9,2,3.3,0.1,-3.2,0,65.1,65.1,0,0,0
1994-11-01,2833.9,1668.2,-1165.7,,,,59778,45042,-14736,3431.3,0,-3431.3,4875.7,3887,-988.7,9416.4,10440.4,1024,6536.7,5309.3,-1227.4,3285,3955.8,670.8,17341.8,15147.2,-2194.6,,,,,,,23707,12593.1,-11113.9,61334,45673.6999999999,-15660.3000000001,26246.8,14092.8,-12154,,,,502.1,1021.2,519.1,1037.2,364.8,-672.4,0.5,0.3,-0.2,12411.9,10590.1,-1821.8,0,0,0,4929.9,4557.1,-372.799999999999,109.1,124.4,15.3,3.1,8.6,5.5,57.2,160,102.8,107.9,89.1,-18.8,15,17,2,143.1,182.5,39.4,22.4,98.6,76.2,0.6,19.7,19.1,11.5,56.4,44.9,0,0.4,0.4,71.5,84.5,13,0.6,2.3,1.7,0.4,29.1,28.7,4.2,45.3,41.1,289,229.5,-59.5,0,0.9,0.9,0.3,4.6,4.3,2.4,5.5,3.1,0.4,6.1,5.7,0.2,0.5,0.3,0.4,2.5,2.1,2.7,8.6,5.9,0.5,3,2.5,0.3,1.7,1.4,3.1,14.1,11,91.1,45.9,-45.2,27.7,41.4,13.7,,,,,,,51.1,30.3,-20.8,0,5.4,5.4,0.5,3.4,2.9,283.4,351.3,67.9,776.3,313.3,-463,6.3,7.8,1.5,5.8,15.5,9.7,0,2.4,2.4,121.3,92.6,-28.7,79.7,141.5,61.8,29.8,18.4,-11.4,124.7,255.3,130.6,676.9,965.6,288.7,4.7,84.3,79.6,17.4,30.2,12.8,142.4,356.3,213.9,0,0,0,21.3,9.9,-11.4,553.5,253.7,-299.8,0,0,0,176.8,94.3,-82.5,174.1,93.2,-80.9,0.9,0,-0.9,162,89.9,-72.1,2374.3,1934.2,-440.1,282.5,319.8,37.3,445.7,1219.4,773.7,554.9,1102.2,547.3,21.3,16,-5.3,0.1,0.2,0.1,1.3,0.5,-0.8,1540.3,1309.6,-230.7,2935.7,1743.2,-1192.5,153.4,140.1,-13.3,0,0,0,28.9,26.4,-2.5,11.3,2.6,-8.7,42.6,22,-20.6,9.5,2.1,-7.4,621.2,461.3,-159.9,2.7,3.2,0.5,8.6,7.7,-0.899999999999999,2.6,6.6,4,62,44.8,-17.2,0,0,0,348.1,195.8,-152.3,5.6,6.3,0.7,45,9.4,-35.6,0,1.6,1.6,0,3.2,3.2,0.4,3.9,3.5,10,4.9,-5.1,1.2,0.6,-0.6,0.4,0.5,0.1,5.5,0.7,-4.8,0.3,2.3,2,0.1,3.6,3.5,310.3,402.6,92.3,80.5,58.3,-22.2,0.2,1.7,1.5,9,5.6,-3.4,0,0.5,0.5,0,0.1,0.1,1477.9,552.1,-925.8,0,0,0,6.6,11.6,5,20.9,8.9,-12,0.2,1.7,1.5,8.4,3.6,-4.8,0,0,0,,,,,,,,,,0.4,2.7,2.3,39,62.2,23.2,17.4,142.5,125.1,7.9,15.4,7.5,176.1,214.1,38,3.7,26.9,23.2,7.4,25.3,17.9,1.8,37.5,35.7,0,0,0,0.3,79.4,79.1,0,0,0,0,0,0,0,0,0,2.1,13.4,11.3,101.1,261.1,160,0,0,0,743.2,518.7,-224.5,6.1,10.2,4.1,19.5,149.3,129.8,4.9,11.6,6.7,10.1,14.7,4.6,9.5,20.8,11.3,1,0.5,-0.5,391.1,197.6,-193.5,98.8,119.1,20.3,5.8,0.9,-4.9,78.2,39.4,-38.8,86.3,12.6,-73.7,5.9,1.1,-4.8,964.1,558.6,-405.5,5.1,12.3,7.2,0.4,0.1,-0.3,0,0.4,0.4,1358.3,622.5,-735.8,1392,1032.5,-359.5,606.9,213.5,-393.4,,,,1.5,8,6.5,476.7,374.7,-102,79.1,2.6,-76.5,0,0,0,0.7,0,-0.7,3534.3,648,-2886.3,2.8,3.1,0.3,0,0,0,1849.8,1686.1,-163.7,894.9,969.5,74.6,2400,1621.2,-778.8,10628.8,4411.9,-6216.9,311.2,795.1,483.9,0,0,0,0,0,0,0,0.1,0.1,0,0,0,13.3,6.4,-6.9,160.2,200.9,40.7,0.3,0.1,-0.2,0.1,0,-0.1,0,0,0,0.1,0.7,0.6,0,0.1,0.1,0,0.2,0.2,0,0,0,0.1,0.2,0.1,0,0,0,8.2,1.3,-6.9,0,0,0,0.3,7.3,7,1,3,2,1.2,2.6,1.4,0.3,0.7,0.4,0,0,0,5.4,2.1,-3.3,0.4,0.4,0,16.5,24.6,8.1,104,80.4,-23.6,3.7,37.6,33.9,0,0,0,33.7,263.1,229.4,1.4,5,3.6,,,,0.1,0,-0.1,0.1,0.1,0,0,1.6,1.6,1.4,4.1,2.7,1.7,2.2,0.5,2.3,3.2,0.9,5,3.7,-1.3,3.9,2.1,-1.8,7,18.1,11.1,12.7,10.6,-2.1,0,0.2,0.2,0.1,0.8,0.7,0.2,1.6,1.4,367.6,38.5,-329.1,0,0.1,0.1,108.9,3.8,-105.1,0.2,0.1,-0.1,0,1.1,1.1,0,0.8,0.8,0.1,1.9,1.8,196.9,9.2,-187.7,50,1.7,-48.3,0,0,0,0,0.3,0.3,0,0.2,0.2,0.5,0.7,0.2,12.2,2,-10.2,1.1,0.5,-0.6,0,5.9,5.9,0,5.4,5.4,0,0,0,0,0.3,0.3,0,1.1,1.1,11.4,1.7,-9.7,9.3,15.2,5.9,0.5,0.4,-0.1,0,0,0,1.2,3.7,2.5,20.9,3.1,-17.8,0.2,3.1,2.9,3.3,0.8,-2.5,,,,0,0,0,0,0.5,0.5,0,0,0,181.9,177.2,-4.70000000000002,2,2.4,0.4,1.4,1.6,0.2,4.2,2.3,-1.9,1.9,1.4,-0.5,14.9,9,-5.9,4.4,3.1,-1.3,4.9,0,-4.9,0,38.1,38.1,0,0,0
1994-12-01,2726.6,1730.3,-996.3,,,,59204,46945,-12259,3006.9,0,-3006.9,4291,3772.7,-518.3,9290.9,11518.6,2227.7,6166.8,5729.9,-436.900000000001,3284.4,4332.8,1048.4,15703.6,14088.7,-1614.9,,,,,,,22026.9,13407.9,-8619,57530.4,47013.3,-10517.1,24586.2,14651.4,-9934.8,,,,364.3,1038.1,673.8,1020.1,422.4,-597.7,0.2,0.2,0,11438.3,9824.7,-1613.6,0,0,0,4265.3,4264,-1.30000000000018,128.2,135.6,7.40000000000001,3.8,12.6,8.8,53.1,85,31.9,99.5,93.8,-5.7,13.4,25.8,12.4,136.3,158.8,22.5,21.3,115.5,94.2,1.3,31.3,30,16.8,55.7,38.9,0,0.2,0.2,62.1,106,43.9,0.6,3.1,2.5,1.8,30.6,28.8,4.8,50.1,45.3,255.1,241.7,-13.4,0,1.6,1.6,0.5,3.9,3.4,1.5,4.1,2.6,0.3,5.6,5.3,0.2,0.6,0.4,0.9,2.6,1.7,1.8,6.8,5,0.4,3.9,3.5,0.4,2.1,1.7,2.6,14.3,11.7,100.9,47.5,-53.4,26,64.7,38.7,,,,,,,21.4,28.8,7.4,0.1,4.5,4.4,0.2,2.7,2.5,301.1,368.3,67.2,729.7,408.9,-320.8,8.9,7.9,-1,1.2,11,9.8,0,1.2,1.2,159.7,121.2,-38.5,84.7,179.9,95.2,31.6,20,-11.6,167.4,333.8,166.4,670.8,1042.5,371.7,2.3,62.6,60.3,12.8,35.7,22.9,158.9,400.3,241.4,0,0,0,19.3,9.2,-10.1,548.9,237,-311.9,0,0,0,158.7,113.7,-45,153.5,89.2,-64.3,1.1,0,-1.1,163.7,98.2,-65.5,2284.4,2478.2,193.8,217.5,310.9,93.4,496.3,1559.6,1063.3,488.9,1035.7,546.8,24.7,19.7,-5,0,0.1,0.1,0.9,0.6,-0.3,1483.3,1323.9,-159.4,3062.8,1938.5,-1124.3,156.4,139.9,-16.5,0,0,0,29.2,31.1,1.9,16.4,3.2,-13.2,41.2,25,-16.2,8.2,1.5,-6.7,554.8,502.6,-52.1999999999999,5.2,7.4,2.2,3.9,8,4.1,1.8,1.7,-0.1,48.3,53.5,5.2,0,0,0,412.3,211.4,-200.9,2.5,1.8,-0.7,36.5,9.8,-26.7,0.1,2,1.9,0.1,2.8,2.7,0.1,1.8,1.7,6.2,7.5,1.3,0.8,1.1,0.3,0.3,0.4,0.1,19.5,0.6,-18.9,0.1,0.5,0.4,0.8,2.7,1.9,293.3,427,133.7,72,80.8,8.8,0.5,1.2,0.7,8.8,11.9,3.1,0,0.2,0.2,0,0,0,1339.7,808.4,-531.3,0,0,0,11.8,13.1,1.3,22.9,10.5,-12.4,0,0.3,0.3,3,2.3,-0.7,0,0,0,,,,,,,,,,0.7,2.7,2,31.6,86.6,55,18.7,30.9,12.2,31,10.7,-20.3,128.4,233.6,105.2,0.7,24,23.3,0.9,21.4,20.5,2.3,44.1,41.8,0,0,0,0.1,39.1,39,0,0,0,0,0,0,0,0,0,1.1,35.4,34.3,114.9,114.9,0,0,0,0,722.7,541.2,-181.5,5.3,17.4,12.1,28.4,179.6,151.2,9.2,33.9,24.7,11.2,18.7,7.5,19.1,19.9,0.799999999999997,1.3,0.2,-1.1,364.8,195.3,-169.5,92.2,72.9,-19.3,5.9,0.5,-5.4,83.8,21.6,-62.2,92.1,25.7,-66.4,5.1,0.4,-4.7,897.4,448.4,-449,8.3,15.7,7.4,0,0,0,0.5,0.4,-0.1,1311.2,591.7,-719.5,1452.2,1195.2,-257,563.2,267.5,-295.7,,,,1.5,6.9,5.4,477.9,335.1,-142.8,66.1,1.6,-64.5,0,0,0,1.7,0.3,-1.4,2826.5,798,-2028.5,3.2,0.3,-2.9,0,0,0,1731.9,1896.6,164.7,735.6,999.1,263.5,2247.1,1639,-608.1,10262,4662.6,-5599.4,223.5,901.3,677.8,0,0.1,0.1,0,6.5,6.5,0,0.3,0.3,0,0,0,22.7,3.1,-19.6,105.4,110.2,4.8,0,0,0,0.3,0.1,-0.2,0,0.4,0.4,0,0.5,0.5,0,0,0,0,0.1,0.1,0,0,0,0.2,0.2,0,0,0,0,0.1,1,0.9,0,0,0,1.6,6.8,5.2,0.6,2.8,2.2,1.4,1.4,0,0.6,0.4,-0.2,0,0,0,7.6,2.6,-5,0.3,0.3,0,18.2,35.1,16.9,90.2,109.5,19.3,3.5,26.6,23.1,0,0,0,47.8,289.6,241.8,3.7,5.1,1.4,,,,0.1,0,-0.1,0,0.7,0.7,0,1.1,1.1,2.5,16.3,13.8,0.3,3.1,2.8,0.7,5.4,4.7,5.4,4.6,-0.800000000000001,2.5,1.2,-1.3,17.6,8.8,-8.8,14.2,11,-3.2,0.2,0.6,0.4,0.8,1.2,0.4,0.1,1.9,1.8,358.2,47.9,-310.3,0,0.2,0.2,113.9,4.3,-109.6,0,0,0,0,4.5,4.5,0,1,1,0.1,4.3,4.2,179.9,22.9,-157,14,5.3,-8.7,0,0.1,0.1,0,0.2,0.2,0.1,4.7,4.6,0.4,1.3,0.9,13.6,5.7,-7.9,1,0.2,-0.8,0,1,1,0,0.9,0.9,0,0,0,0,1.1,1.1,0,0.2,0.2,2.1,5.1,3,8.6,6.5,-2.1,0.1,0.2,0.1,0,0,0,1.2,1.5,0.3,14.3,1,-13.3,0.2,6.2,6,4.1,0.4,-3.7,,,,0,0,0,0,0.5,0.5,0,0.1,0.1,210.4,205.3,-5.09999999999999,4.7,2.1,-2.6,1.5,1.1,-0.4,5.8,3.2,-2.6,1.3,1.2,-0.1,18.4,10.8,-7.6,11.7,0.8,-10.9,5.8,0,-5.8,0,38.8,38.8,0,0,0
1995-01-01,2720.4,1872.3,-848.1,,,,60492,46256,-14236,3236,0,-3236,4753.2,3764,-989.2,8443,9230,787,6551.9,5078.4,-1473.5,3262.7,3731,468.3,16228.2,14102.5,-2125.7,,,,,,,22094.1,12493.2,-9600.9,57292.9,43632.2,-13660.7,24751.5,14104.5,-10647,,,,423.4,964.8,541.4,972.2,343.6,-628.6,1.1,0.1,-1,11506.1,10101.3,-1404.8,0.4,0,-0.4,4722.1,4001.2,-720.900000000001,119.5,120.4,0.900000000000006,6,7.2,1.2,55.2,76.4,21.2,87.3,91,3.7,19.6,20.2,0.599999999999998,122.2,133.4,11.2,17.3,111.8,94.5,1.2,22.7,21.5,14.1,46.7,32.6,0,0.2,0.2,51.2,101.8,50.6,0.4,2.2,1.8,1.1,23.8,22.7,5.2,50.5,45.3,159,203.5,44.5,0,0.7,0.7,2.6,4.1,1.5,1.2,3.8,2.6,0.3,4.5,4.2,0.2,0.4,0.2,0.6,1,0.4,1.6,5.8,4.2,0.8,1.9,1.1,0.2,2.1,1.9,2.8,11.3,8.5,119.8,61,-58.8,23.4,30.9,7.5,,,,,,,44.6,18.7,-25.9,0,4.7,4.7,0.3,3.6,3.3,266.3,328.9,62.6,772.4,332.7,-439.7,6.4,9.6,3.2,4.5,15.6,11.1,0,1.1,1.1,159.9,110.2,-49.7,68.6,132.2,63.6,24.1,17.1,-7,160.4,251,90.6,804.8,852.8,48,3.9,82.6,78.7,12.8,31,18.2,120.9,399.9,279,0,0,0,9.5,7.5,-2,513.5,209.2,-304.3,0,0,0,208.2,89.8,-118.4,140.6,79.2,-61.4,0.4,0,-0.4,163.5,98.1,-65.4,1875.3,1948.5,73.2,262.9,326,63.1,484,1174,690,502.7,886.4,383.7,25.1,15.1,-10,0,0.1,0.1,0.8,0.3,-0.5,1366.7,1166.2,-200.5,2688.7,1708.9,-979.8,142.2,118,-24.2,0,0,0,30.3,31,0.699999999999999,13.1,3.6,-9.5,45.3,27.1,-18.2,7.4,1.1,-6.3,494.4,354.4,-140,4.8,5.2,0.4,8.5,6.3,-2.2,1.5,3.1,1.6,57.4,45.3,-12.1,0,0,0,385.3,178.3,-207,5.6,2.7,-2.9,26.2,15.4,-10.8,0,0.1,0.1,0,3,3,2,1.1,-0.9,4.7,3.9,-0.8,0.9,1.1,0.2,4.1,0.6,-3.5,4.9,1,-3.9,0.3,1.3,1,0.4,1.7,1.3,290.3,456,165.7,86.6,89.3,2.7,0.1,1,0.9,7.3,4.5,-2.8,0,0.2,0.2,0,0,0,1299.7,639.9,-659.8,0,0,0,8.6,6.3,-2.3,25.2,8.7,-16.5,0.2,1,0.8,3.1,1.1,-2,0,0.2,0.2,,,,,,,,,,1.2,0.2,-1,33.4,71.5,38.1,19.3,23.7,4.4,10.1,11.8,1.7,171.8,166.8,-5,1.3,18.6,17.3,8.5,21.8,13.3,1.3,67.7,66.4,0,0,0,0.2,55,54.8,0,0,0,0,0,0,0,0,0,1,43.8,42.8,59.5,99.7,40.2,0,0,0,646.7,733.2,86.5,6.3,13.9,7.6,31.6,245.6,214,20.1,11.2,-8.9,12.7,26.6,13.9,18.1,18.3,0.199999999999999,0,0.5,0.5,466.8,199.7,-267.1,108.3,72.7,-35.6,10.6,0.4,-10.2,105.1,35.3,-69.8,112.9,18.2,-94.7,9.2,0.8,-8.4,908,461.1,-446.9,17.6,16.6,-1,0.4,0.1,-0.3,0.1,2.3,2.2,1278.4,602.9,-675.5,1392,950.4,-441.6,576.5,252.3,-324.2,,,,2.8,6.7,3.9,507.3,366.3,-141,82.5,1.4,-81.1,0,0,0,1.6,0,-1.6,3450.6,744.9,-2705.7,2.2,0.3,-1.9,0,0,0,1870.4,1644.8,-225.6,903,1029.9,126.9,2386.5,1453.3,-933.2,9233.9,4492.3,-4741.6,271.5,829.3,557.8,0,0.3,0.3,0,0.4,0.4,0,0.2,0.2,0,0,0,13.4,2.2,-11.2,126,116.6,-9.40000000000001,0.1,0.1,0,0.2,0,-0.2,0,0.5,0.5,0,0.2,0.2,0,0,0,0,0,0,0,0.1,0.1,0.3,0.1,-0.2,0,0,0,0.1,3.2,3.1,0,0,0,0.6,5,4.4,3.7,2.2,-1.5,0.9,1.1,0.2,0.2,0.7,0.5,0,0,0,6.2,2.4,-3.8,0.2,0.2,0,18.4,31.5,13.1,131,92.3,-38.7,5.6,20.3,14.7,0,0,0,58.9,225.9,167,1.5,2.5,1,,,,0,0,0,0,0.1,0.1,0.9,1.2,0.3,3.3,1,-2.3,0.2,5.4,5.2,0.4,1.7,1.3,9.6,6.1,-3.5,5.4,0.6,-4.8,28.5,8.2,-20.3,20.8,9.3,-11.5,0.4,0.4,0,0.1,0.5,0.4,0.4,0.4,0,395.8,45.9,-349.9,0.2,0.9,0.7,100.3,1.7,-98.6,0,0,0,0,0.1,0.1,0,1.1,1.1,0.1,2.6,2.5,112.8,18.2,-94.6,10.7,2.8,-7.9,0,0.1,0.1,0,0.3,0.3,0.1,0.4,0.3,0.2,0.5,0.3,25.4,5.1,-20.3,0.6,0,-0.6,0,0.1,0.1,0,0.3,0.3,0,0,0,0.1,2.5,2.4,0,0.4,0.4,3.2,0.6,-2.6,13,7.8,-5.2,0.3,0.4,0.1,0.1,0,-0.1,2.1,3.7,1.6,21,1.1,-19.9,0.2,2.9,2.7,5.3,1.2,-4.1,,,,0,0,0,0,0.2,0.2,0,0,0,181.6,176.8,-4.79999999999998,1.8,6.3,4.5,0.9,0.9,0,2.2,3.1,0.9,2.6,0.1,-2.5,10,6.1,-3.9,2.7,3,0.3,6.7,0.2,-6.5,0,0,0,0,0,0
1995-02-01,2737.9,1364.3,-1373.6,,,,59836,46597,-13239,3310.7,0,-3310.7,4815.9,3861.4,-954.5,8342,10135,1793,5121.7,5699.5,577.8,3171.7,3693.9,522.2,16200.2,13834,-2366.2,,,,,,,20458,13916.4,-6541.6,55217.1,44997.8,-10219.3,22983.2,15074.6,-7908.6,,,,503.7,990.7,487,910.2,420.6,-489.6,0.4,0.2,-0.2,11413.1,10161.6,-1251.5,0.6,0,-0.6,4787.1,3672.4,-1114.7,136.1,114,-22.1,4.8,8.5,3.7,62.4,79.8,17.4,111,79.5,-31.5,26.2,17.2,-9,139.8,130.7,-9.10000000000002,20.3,123.2,102.9,0.6,22.8,22.2,18.4,47.9,29.5,0,0.1,0.1,58,87.4,29.4,0.3,2.8,2.5,2.1,19.2,17.1,13.2,42.5,29.3,246.6,217.8,-28.8,0,0.8,0.8,1.1,5.1,4,2.3,3.2,0.9,0.3,5,4.7,0.2,0.3,0.1,0.7,1.4,0.7,2.8,5.4,2.6,0.5,4.5,4,0.2,2.1,1.9,3,15.7,12.7,82.5,43.5,-39,19.5,33.2,13.7,,,,,,,30.8,28.1,-2.7,0.1,4.1,4,0.1,2.8,2.7,264.4,366.5,102.1,730.4,338.8,-391.6,7.8,6.3,-1.5,4.9,10.3,5.4,0,1,1,149.8,129.6,-20.2,59.2,118.8,59.6,23.9,14,-9.9,175.7,243.4,67.7,633.4,894.6,261.2,9.5,84.4,74.9,9.7,36.3,26.6,119.1,301.3,182.2,0,0,0,20.2,7.8,-12.4,496.1,208.4,-287.7,0,0,0,190.3,84.9,-105.4,180.3,76.9,-103.4,0.4,0,-0.4,150.9,178.8,27.9,2052.6,2064.7,12.0999999999999,265.3,309.6,44.3,435.7,1208.8,773.1,538,977.3,439.3,18.6,15,-3.6,0,0.1,0.1,1.1,0.1,-1,1224.9,1255.5,30.5999999999999,2575.7,1740,-835.7,138.6,118.9,-19.7,0,0,0,25.2,26.4,1.2,8.3,2.5,-5.8,40.6,25.6,-15,7.9,1.3,-6.6,556.8,337.7,-219.1,3.2,0.8,-2.4,8.7,6.7,-2,3.4,1.3,-2.1,58,37.7,-20.3,0,0,0,313,195.2,-117.8,3.2,1.9,-1.3,42.3,12.3,-30,0,0.9,0.9,0,10.4,10.4,0,5.6,5.6,4.9,6.2,1.3,0.5,0.4,-0.1,3.1,0.2,-2.9,3.2,0.2,-3,0,0.5,0.5,5.1,2.5,-2.6,288.2,391.4,103.2,71.4,61.3,-10.1,0.1,2.2,2.1,7.9,6.8,-1.1,0,0.1,0.1,0.1,0,-0.1,1197.9,706.8,-491.1,0,0,0,9.2,26.2,17,20.8,7.8,-13,0.2,0.5,0.3,11.3,2.1,-9.2,0,0,0,,,,,,,,,,0.2,0.5,0.3,22.6,191.4,168.8,12,19.5,7.5,14.5,11.9,-2.6,147.3,267.5,120.2,1.2,15.6,14.4,1.8,18.2,16.4,5.8,44.9,39.1,0,0,0,0,31.1,31.1,0,0,0,0,0,0,0,0,0,2.7,26.7,24,150.5,99,-51.5,0,0,0,655.7,397.7,-258,5.8,12.1,6.3,35.3,119.8,84.5,5.6,13.5,7.9,10.9,17.1,6.2,23.9,16.6,-7.3,1.1,0.1,-1,457.8,207.7,-250.1,113.2,99.3,-13.9,13.6,1.1,-12.5,119.1,19.4,-99.7,98.9,30.7,-68.2,5.2,2.5,-2.7,770,538.4,-231.6,21.8,7.4,-14.4,1.2,0,-1.2,0,0.7,0.7,1107.2,580.6,-526.6,1064.4,1187.2,122.8,532.4,261.7,-270.7,,,,3.2,4.7,1.5,488.5,327,-161.5,59.1,2.8,-56.3,0,0,0,1.9,0.1,-1.8,3001.5,1085.5,-1916,1.5,0.1,-1.4,0,0,0,1498.5,1955.9,457.4,661,1027.4,366.4,1897.8,1529,-368.8,9732.6,4987.3,-4745.3,297.8,846.9,549.1,77.7,0,-77.7,0,0,0,0,0.1,0.1,0,0,0,1.1,3.3,2.2,112.8,117,4.2,0,0.1,0.1,2.4,0,-2.4,0,3.6,3.6,0,0.8,0.8,0.9,0,-0.9,0,0.1,0.1,0,2,2,0.1,0.1,0,0,0,0,0,2,2,0,0,0,0.8,6.5,5.7,1.2,2.4,1.2,1.8,2.3,0.5,0.4,0.6,0.2,0,0,0,6.4,2.3,-4.1,0.3,0.6,0.3,16.9,42.8,25.9,191.8,50.5,-141.3,6.3,31.5,25.2,0,0,0,51.1,224.1,173,1.9,4.1,2.2,,,,0,0,0,0,0.9,0.9,1.1,12.8,11.7,7.2,7.7,0.5,0.2,6.2,6,0.2,1.4,1.2,7.3,2.7,-4.6,1.7,3.3,1.6,26.7,12.5,-14.2,14.4,10.7,-3.7,0,0.1,0.1,0,1.1,1.1,0.6,1.2,0.6,336.3,47.1,-289.2,0,0.2,0.2,99.6,6.4,-93.2,0.2,0.2,0,0,0,0,0.2,2.6,2.4,0.3,3.7,3.4,182.6,13.6,-169,16.9,2.6,-14.3,0,0.1,0.1,0.2,0.9,0.7,0,0.3,0.3,1.4,5.8,4.4,19.7,3.7,-16,0.2,0.2,0,0,0.4,0.4,0,0.2,0.2,0,0,0,0.1,4.2,4.1,0,0.5,0.5,1.4,1.8,0.4,9.1,16.4,7.3,0.6,0.4,-0.2,0,0,0,1,1.3,0.3,17.8,1.3,-16.5,0.6,3.4,2.8,3.4,1,-2.4,,,,0,0,0,0,0.2,0.2,0,0,0,143.2,217.3,74.1,0.5,1.8,1.3,1.1,2,0.9,1.5,2,0.5,1.1,0.2,-0.9,5.8,7,1.2,0.4,3.7,3.3,2.7,0,-2.7,0,0,0,0,0,0
1995-03-01,3056.9,1633.1,-1423.8,,,,61390,48259,-13131,3855.4,0,-3855.4,4906.5,4413.4,-493.1,10183.7,12321,2137.3,6263.9,6813,549.1,3783.6,4477.3,693.7,18091.2,15639.1,-2452.1,,,,,,,23688.9,15990.9,-7698,63583.6,52579.2,-11004.4,26617.7,17444.8,-9172.9,,,,399.5,1153.3,753.8,1072.6,420.6,-652,0,0.3,0.3,12610.4,11718.5,-891.9,0.2,0,-0.2,5480.8,3920.6,-1560.2,148,148.7,0.699999999999989,9.9,9.9,0,82.8,96.9,14.1,126.2,119.4,-6.8,22.4,22.2,-0.199999999999999,171.1,165.2,-5.90000000000001,19.5,126.3,106.8,0.7,29.3,28.6,17.4,51.6,34.2,0,0.1,0.1,76.2,119.3,43.1,0.4,1.9,1.5,0.7,14.6,13.9,9.8,43.6,33.8,320.8,265.5,-55.3,0,1.2,1.2,0.2,4.6,4.4,2.3,4.5,2.2,0.2,6.7,6.5,0.2,0.5,0.3,1.2,2.1,0.9,2.1,6.8,4.7,0.7,2.7,2,1,2.1,1.1,3.3,15.5,12.2,101,57.6,-43.4,32.5,45.7,13.2,,,,,,,28.6,32.8,4.2,0.2,6.8,6.6,0.1,3.4,3.3,334.3,442.1,107.8,863.6,371.6,-492,6.8,10.4,3.6,7,18.5,11.5,0,1.5,1.5,174.6,180.3,5.70000000000002,77.1,148.1,71,16.9,16,-0.899999999999999,216.1,283.1,67,745.2,1102.3,357.1,4,91,87,12.7,32.4,19.7,145.4,372.2,226.8,0.4,0.3,-0.1,18.5,11.6,-6.9,629.2,247.3,-381.9,0,0,0,274.4,115.4,-159,165.7,81.2,-84.5,0.4,0,-0.4,175.7,104.4,-71.3,2537.8,2749.7,211.9,276.5,403,126.5,500.6,1505.7,1005.1,545.4,1140.4,595,17.9,15.7,-2.2,0,0.2,0.2,1.4,0.4,-1,1608.7,1288.3,-320.4,3005.5,1905.6,-1099.9,166.4,316.5,150.1,0,0,0,25.9,31.6,5.7,25.1,3,-22.1,49.7,25.3,-24.4,10.2,1.4,-8.8,620,874.1,254.1,8.7,9.6,0.9,3.5,5.3,1.8,4.8,3.4,-1.4,57,52,-5,0,0,0,497.1,216.8,-280.3,5.4,3.3,-2.1,38.4,14.6,-23.8,0.1,12.2,12.1,0,1,1,2.4,9.5,7.1,7.7,4.9,-2.8,1.2,0.4,-0.8,0.4,0.5,0.1,6.2,1.6,-4.6,0,0.5,0.5,3,1.9,-1.1,349.6,589.2,239.6,82,96.2,14.2,0.6,1.9,1.3,9.8,12.4,2.6,0,0.3,0.3,0.2,0,-0.2,1375.4,780.1,-595.3,0,0,0,7.6,18.5,10.9,27.6,10.8,-16.8,0.3,1.6,1.3,8.1,2.2,-5.9,0,0,0,,,,,,,,,,2.1,0.5,-1.6,30.4,71,40.6,19.4,26.4,7,26.2,9.8,-16.4,191.1,209.7,18.6,1.1,15.6,14.5,8.6,21.1,12.5,3.3,49.6,46.3,0,0,0,0,47.4,47.4,0,0,0,0,0,0,0,0,0,1.7,22.7,21,120.5,114.6,-5.90000000000001,0,0,0,745,410.9,-334.1,5.6,19.9,14.3,39.8,253.6,213.8,0.2,22.3,22.1,9.6,19,9.4,12.1,22.5,10.4,0.2,0.4,0.2,524,260.3,-263.7,99,115.8,16.8,15.5,0.5,-15,139.8,14.3,-125.5,110.5,19.2,-91.3,5.5,1.4,-4.1,933.5,516.3,-417.2,24.1,12.5,-11.6,0.6,0.1,-0.5,0.9,1.3,0.4,1200.2,686.5,-513.7,1437.5,1304.8,-132.7,591.5,284.7,-306.8,,,,3.7,5.4,1.7,554.2,414.5,-139.7,46.7,2.3,-44.4,0,0,0,1.1,0.1,-1,2910.4,1070.1,-1840.3,0.6,0.6,0,0,6.6,6.6,1819,2480.6,661.6,656.4,1234.9,578.5,2351,1792.7,-558.3,11732.1,5580.9,-6151.2,258.5,972,713.5,0.5,0.1,-0.4,0,0,0,0,0.8,0.8,0,0,0,2.1,4.5,2.4,126,157.2,31.2,0.1,0.1,0,0.1,0,-0.1,0,3.6,3.6,0,0.8,0.8,0.3,0.7,0.4,0,0.1,0.1,0,0.1,0.1,0.1,0,-0.1,0,0,0,3.9,1,-2.9,0,0,0,0.3,4.6,4.3,0.7,2.1,1.4,1.3,1.4,0.0999999999999999,0.1,0.6,0.5,0,0.2,0.2,5.1,2.7,-2.4,0.4,0.7,0.3,20.8,33.5,12.7,113.8,77.1,-36.7,12.9,46.6,33.7,0,0,0,48.9,265,216.1,2,3.9,1.9,,,,0,0,0,7.6,0.2,-7.4,0,2.1,2.1,1.8,5.8,4,0.6,1.3,0.7,0.2,1.4,1.2,6.9,5.7,-1.2,2.4,1.4,-1,9.7,15.2,5.5,17.1,11.1,-6,0.8,0.9,0.1,0,0.9,0.9,0.1,1.4,1.3,466.5,47.6,-418.9,0,0.3,0.3,110.6,5.7,-104.9,0,4.5,4.5,0,0,0,0,0.6,0.6,0.2,2.4,2.2,193.4,8.7,-184.7,14.5,6.4,-8.1,0,0,0,0,0.2,0.2,0,0.1,0.1,0,3,3,21.3,4.9,-16.4,1.5,0.1,-1.4,0,1.6,1.6,0,4.5,4.5,0,0,0,0,2.5,2.5,0,0.8,0.8,0.3,1.3,1,8.1,8.6,0.5,0.4,0.1,-0.3,0,0,0,4.4,1.8,-2.6,14.7,1.8,-12.9,0,3.2,3.2,3.6,0.3,-3.3,,,,0.4,0,-0.4,0,0.2,0.2,0,0,0,165.1,224.2,59.1,0.5,1.8,1.3,1.7,4.2,2.5,2.4,2.2,-0.2,1.5,0,-1.5,6,4.7,-1.3,0.7,0.9,0.2,4.9,0,-4.9,0,16.9,16.9,0,0,0
1995-04-01,2626.2,1427.3,-1198.9,,,,62557,47684,-14873,3328.6,0,-3328.6,4751.9,3965.2,-786.7,9200.9,11059,1858.1,5957.2,5818.4,-138.8,3220.2,4231.5,1011.3,16740,13983.8,-2756.2,,,,,,,22956.8,14425.1,-8531.7,59792.7,47807.6999999999,-11985.0000000001,25385.6,15507.4,-9878.2,,,,407,1055.8,648.8,906.3,420.7,-485.6,0,0.4,0.4,12012.2,10601.3,-1410.9,0,0,0,4727.8,3382.5,-1345.3,117.9,156.4,38.5,2.8,7.7,4.9,52.2,96.5,44.3,98.4,114.3,15.9,15.7,20,4.3,146.7,150.1,3.40000000000001,24.2,120.5,96.3,0.7,24.5,23.8,12.4,49.6,37.2,0,0.2,0.2,64,119.2,55.2,0.4,1.7,1.3,1.9,12.8,10.9,10.3,37.9,27.6,256.6,284,27.4,0,0.8,0.8,0.4,3.4,3,1.6,4.1,2.5,0.3,22.4,22.1,0.1,0.4,0.3,0.8,3.9,3.1,1.8,6.7,4.9,0.5,2.9,2.4,0.6,1.8,1.2,2.9,16.2,13.3,96.3,45.6,-50.7,18.8,43.4,24.6,,,,,,,8.6,17.9,9.3,0.1,6.6,6.5,0.2,3.3,3.1,281.9,400.7,118.8,722.2,364.8,-357.4,10,10.4,0.4,4.9,11.7,6.8,0.1,1.4,1.3,152.4,108.5,-43.9,79.3,147,67.7,18.9,20.2,1.3,194.7,247.3,52.6,647.1,1081.8,434.7,2.1,85.8,83.7,11.7,27.6,15.9,157.7,349.5,191.8,0,0,0,29.1,14,-15.1,531.2,269.1,-262.1,0,0,0,241.3,108.9,-132.4,192,101.5,-90.5,0.4,0,-0.4,166.7,115.7,-51,2224.9,2801.8,576.9,308.6,336.6,28,532.2,1481.2,949,467.5,1139.4,671.9,17.7,14.1,-3.6,0,0.1,0.1,0.3,0.3,0,1506.8,1235.8,-271,3245.5,1943.7,-1301.8,158.7,167.3,8.60000000000002,0,0,0,31.1,31,-0.100000000000001,8.7,7,-1.7,44.5,23.7,-20.8,14.8,1,-13.8,626.3,391,-235.3,2.2,6.7,4.5,15.8,7.4,-8.4,1.4,2.6,1.2,52,53.9,1.9,0,0,0,429.7,220.1,-209.6,4.1,7.3,3.2,38.7,11.3,-27.4,0.2,8.4,8.2,0,2,2,0,7.1,7.1,12,10.9,-1.1,0.4,2.4,2,0.3,0.5,0.2,9.9,1.3,-8.6,0.1,0.3,0.2,0.1,3,2.9,319.8,482.9,163.1,87.9,72.7,-15.2,0.3,1.7,1.4,7.8,5.2,-2.6,0,0.3,0.3,0.1,0,-0.1,1300.3,727.2,-573.1,0,0,0,5,11.5,6.5,25.3,10.6,-14.7,0.1,2.2,2.1,6,2.3,-3.7,0,0,0,,,,,,,,,,0.4,0.6,0.2,33.6,127.5,93.9,11.8,16.8,5,19.6,11.2,-8.4,157.1,184.5,27.4,1.2,16.9,15.7,8.4,25.8,17.4,2.1,49.4,47.3,0,0,0,0,27.5,27.5,0,0,0,0,0.1,0.1,0,0,0,3.2,21.7,18.5,88.4,86.9,-1.5,0,0,0,716.9,401.8,-315.1,4.9,23.9,19,32.2,160.7,128.5,9.5,5.4,-4.1,9.6,16,6.4,9.1,15.8,6.7,0.7,0.3,-0.4,433.1,248.5,-184.6,83.5,67.5,-16,8.5,0.7,-7.8,69.7,38.1,-31.6,89.2,17,-72.2,4.5,0.4,-4.1,846.1,477,-369.1,10.6,21.3,10.7,0.7,0,-0.7,0.7,1,0.3,1268,628.2,-639.8,1354.6,1109.7,-244.9,494.3,240.6,-253.7,,,,2.1,2.8,0.7,467.8,514.2,46.4,46.2,4,-42.2,0,0,0,1.2,0.1,-1.1,3148.3,896.4,-2251.9,1,3.3,2.3,0,0,0,1746.9,2045.9,299,669.5,1132.7,463.2,2186.2,1530.1,-656.1,11179.8,5286.6,-5893.2,261,832,571,0,0.1,0.1,0,0.1,0.1,0,0.4,0.4,0,0,0,0.6,3.3,2.7,131.6,198.6,67,0,0.1,0.1,2.1,0,-2.1,0,2.7,2.7,0,0.6,0.6,0.1,0.9,0.8,0,0.1,0.1,0,0,0,0.1,0.1,0,0,0,0,4.4,1.2,-3.2,0,0,0,0.7,6.9,6.2,0.2,2.4,2.2,0.7,3.4,2.7,0.5,0.7,0.2,0,0,0,4.6,2.1,-2.5,0.4,0.1,-0.3,21.6,47.6,26,163.4,81.1,-82.3,4.3,12.7,8.4,0,0,0,52.6,236.6,184,2.2,1.4,-0.8,,,,0,0,0,0.1,0.6,0.5,1,1.3,0.3,17.2,4,-13.2,0.2,2.7,2.5,0.1,1.6,1.5,5.7,5.8,0.0999999999999996,1.3,0.5,-0.8,8.8,10.5,1.7,10.4,11.5,1.1,0,0.5,0.5,0,1.7,1.7,0.2,1.7,1.5,306.5,37.4,-269.1,0.1,0.2,0.1,97.4,2.7,-94.7,0.2,1.9,1.7,0,0,0,0,0.6,0.6,0.4,2.1,1.7,201.3,15,-186.3,19.5,2.6,-16.9,0,0.4,0.4,0,0,0,0,0.1,0.1,0.6,5.1,4.5,11.9,6.6,-5.3,0.8,0.5,-0.3,0.1,1.6,1.5,0,0.1,0.1,0,0,0,0,0.7,0.7,0,1.9,1.9,0.3,3.4,3.1,5.5,6.7,1.2,0.2,0.5,0.3,0.2,0,-0.2,1.3,1.5,0.2,20.3,2.2,-18.1,0.2,4.1,3.9,5.6,0.2,-5.4,,,,1.8,0,-1.8,0,0.3,0.3,0,0,0,162.8,237.8,75,0.6,3.1,2.5,1.4,3.3,1.9,3.8,3.6,-0.2,0.5,1.1,0.6,8.8,14.1,5.3,1.1,1.7,0.6,5.2,0,-5.2,0,27.3,27.3,0,0,0
1995-05-01,3212.1,1797.2,-1414.9,,,,62311,48405,-13906,3703.4,0,-3703.4,5426.5,4317.5,-1109,9809.4,11011,1201.6,6618.2,6291.9,-326.3,3738.9,4350.5,611.6,17807.4,15201.1,-2606.3,,,,,,,23860.7,14533.2,-9327.5,63198.4,49854.9,-13343.5,26458.8,16147.6,-10311.2,,,,467,1069.9,602.9,1241.2,418,-823.2,0.3,0.3,0,12502.4,11419.9,-1082.5,1,0.1,-0.9,5305,3781.2,-1523.8,119.9,145.5,25.6,3.1,8.6,5.5,62.7,105.3,42.6,131,113.9,-17.1,18.3,14.2,-4.1,160.8,137.2,-23.6,37.2,122,84.8,0.7,23.6,22.9,13,68.1,55.1,0,0,0,75.2,112,36.8,0.4,1.7,1.3,0.6,11.9,11.3,13.3,53.2,39.9,306.1,289.1,-17,0,1,1,1.5,4.8,3.3,2.1,4,1.9,0.3,4.8,4.5,0.2,0.4,0.2,0.3,2.5,2.2,2.9,7.5,4.6,0.5,3.6,3.1,0.7,2,1.3,3.9,14,10.1,106.9,51.3,-55.6,22.6,49.3,26.7,,,,,,,41.9,14.8,-27.1,0.1,4.6,4.5,0.1,2.4,2.3,342.1,390.5,48.4,901,386.5,-514.5,9,15.6,6.6,4.6,14.7,10.1,1.9,75.9,74,203.7,119.2,-84.5,89.1,132.6,43.5,18.9,18.1,-0.799999999999997,146.4,397,250.6,702,980.6,278.6,2.6,85.8,83.2,16,35.6,19.6,175.3,325.1,149.8,0,0,0,19.1,14.9,-4.2,592.5,246.5,-346,0,0,0,287,107.2,-179.8,178.1,105.5,-72.6,0.1,0,-0.1,167.9,123.9,-44,2393.7,2409.6,15.9000000000001,360.3,295.2,-65.1,542.1,1596.6,1054.5,554.9,1065.7,510.8,24.6,17.8,-6.8,0,0.2,0.2,1,6,5,1525.7,1266.7,-259,3116.1,1824.8,-1291.3,162.1,212.5,50.4,0,0,0,32.6,34.4,1.8,18.6,3,-15.6,44.8,22.3,-22.5,16.2,1.4,-14.8,747.7,765,17.3,4,12.6,8.6,2.3,7,4.7,1.7,3.7,2,59.7,134.3,74.6,0,0,0,316.8,249.4,-67.4,6.7,2.6,-4.1,40.3,13.4,-26.9,0.1,6.6,6.5,0,1.6,1.6,0.1,0.9,0.8,13.4,13.2,-0.200000000000001,1.8,0.5,-1.3,0.5,0.3,-0.2,1.4,0.2,-1.2,0.1,3.2,3.1,0.3,4.1,3.8,325,498.7,173.7,90.1,74.1,-16,0.3,1,0.7,10.6,11.4,0.800000000000001,0.1,0.3,0.2,0,0,0,1320.4,716.5,-603.9,0,0,0,9.9,9.7,-0.200000000000001,20.9,7.9,-13,0.2,1.1,0.9,5.4,1.2,-4.2,0,0,0,,,,,,,,,,0.4,0.9,0.5,38,74.1,36.1,18.5,11.3,-7.2,6.5,10.5,4,166.9,244,77.1,1.3,55.2,53.9,7.7,14.3,6.6,2.8,48.5,45.7,0,0,0,0,28.1,28.1,0,0,0,0,0,0,0,0,0,3.6,17.3,13.7,120.9,206.2,85.3,0,0,0,766.3,628.6,-137.7,5.1,27.3,22.2,42.6,158.5,115.9,0.2,19.5,19.3,9.8,21.4,11.6,10.1,21.9,11.8,1.3,0.7,-0.6,451.5,272.8,-178.7,96.7,62.2,-34.5,6.6,0.6,-6,83.2,33.7,-49.5,84.3,15.6,-68.7,7.7,3,-4.7,858.6,454.1,-404.5,7.3,11.9,4.6,1.3,0.1,-1.2,0.4,1.9,1.5,1404.2,686.9,-717.3,1375.7,1113.3,-262.4,612,242.2,-369.8,,,,2.8,3.8,1,536.4,397.2,-139.2,67.9,2.8,-65.1,0,0.1,0.1,0.9,0.1,-0.8,3654.9,831,-2823.9,1.6,0.5,-1.1,0,0,0,1982.8,2056,73.2,811.4,1396.6,585.2,2448.3,1726,-722.3,10510.2,5034.6,-5475.6,298.9,915.1,616.2,0.2,0.1,-0.1,0,0,0,0,0.6,0.6,0,0,0,0.3,6.2,5.9,155,121.6,-33.4,0.1,0.1,0,0.2,0.1,-0.1,0.1,3.2,3.1,0.1,0.9,0.8,0.2,0.1,-0.1,0,0.1,0.1,0,0,0,0.1,0.3,0.2,0,0,0,3.7,1.6,-2.1,0,0,0,0.7,9.3,8.6,0.2,2.4,2.2,0.7,1.6,0.9,0.1,0.5,0.4,0,0,0,6.1,5.3,-0.8,0.3,0.8,0.5,20.1,35.9,15.8,141.9,65.4,-76.5,10,12.6,2.6,0,0,0,62.7,228.5,165.8,2.8,1.5,-1.3,,,,0,0,0,0.7,0.1,-0.6,0,0.6,0.6,2.4,2.9,0.5,0.3,5.8,5.5,0.9,2.1,1.2,7.9,8.2,0.299999999999999,2.7,1.8,-0.9,6.1,17.7,11.6,27.3,10,-17.3,0.5,0.3,-0.2,0.1,1.7,1.6,0.8,0.6,-0.2,492.2,46.9,-445.3,0,0.1,0.1,130.2,7.7,-122.5,0.1,0.2,0.1,0,0,0,0,1,1,4,3.5,-0.5,249.8,16.3,-233.5,24.6,4.4,-20.2,0,0.1,0.1,0,0.7,0.7,0,0,0,1.1,4.5,3.4,22.6,4,-18.6,3.2,0.2,-3,0,2.3,2.3,0,0,0,0,0,0,0,0.6,0.6,0,0.5,0.5,1.4,1.1,-0.3,9,9.2,0.199999999999999,0.1,0.2,0.1,0.2,1.6,1.4,1.9,8.2,6.3,17,2.2,-14.8,0.4,6.1,5.7,4.1,0.9,-3.2,,,,0,0,0,0.1,0.3,0.2,0,0,0,201.4,211.9,10.5,1.4,1.8,0.4,2.1,2.5,0.4,3.2,6.3,3.1,2.8,0.2,-2.6,6.1,9.3,3.2,2.9,0.6,-2.3,4.4,0.1,-4.3,0,32.4,32.4,0,0,0
1995-06-01,3100.1,1765.8,-1334.3,,,,62698,48271,-14427,3784.8,0,-3784.8,5647.9,4254.8,-1393.1,10615,11970,1355,6854.9,6632.8,-222.099999999999,3678.5,4136.5,458,17654.5,14641.5,-3013,,,,,,,24882.3,15818.7,-9063.6,64090.5,49392.2,-14698.3,27566.4,17112.5,-10453.9,,,,420.4,1157.7,737.3,1135.2,460.7,-674.5,0.8,0.3,-0.5,12391.6,10937.5,-1454.1,0,0.2,0.2,5262.9,3704,-1558.9,134.9,125.3,-9.60000000000001,2.9,7.8,4.9,68.9,90.9,22,116.4,108,-8.40000000000001,16.2,22.1,5.9,162.8,154.6,-8.20000000000002,32.5,105.4,72.9,1.1,25.9,24.8,10.1,51.9,41.8,0,0.1,0.1,81.2,125.9,44.7,0.4,2.6,2.2,3.6,11.3,7.7,13.5,53.1,39.6,317.2,259.8,-57.4,0,0.9,0.9,0.3,3.5,3.2,1.6,3.7,2.1,0.2,5.6,5.4,0.1,0.2,0.1,0.5,2.2,1.7,9.5,7.1,-2.4,0.5,3,2.5,1.1,2.2,1.1,4,13.7,9.7,98.1,46.2,-51.9,21.9,48.5,26.6,,,,,,,37.7,17.5,-20.2,0.1,5,4.9,0.3,2.8,2.5,321.3,373.2,51.9,859.4,456.3,-403.1,6.7,17.4,10.7,8.4,15.7,7.3,0.1,3,2.9,167.6,115.1,-52.5,74.2,135.3,61.1,21.3,15.8,-5.5,170.2,290.9,120.7,732.2,967.9,235.7,3.8,89.5,85.7,14.1,33.9,19.8,161.5,315.7,154.2,0.1,0,-0.1,21,15.4,-5.6,532.4,236.9,-295.5,0,0,0,326,94,-232,200,94,-106,2,0,-2,158.9,119.6,-39.3,2332.3,2238.6,-93.7000000000003,392.1,272.2,-119.9,557.7,1211.9,654.2,444.7,966.3,521.6,13.8,17.6,3.8,0,0.1,0.1,1.9,0.7,-1.2,1384.4,1158.6,-225.8,3305.6,1755.7,-1549.9,167.8,123.9,-43.9,0,0,0,31.5,37,5.5,6.5,3.1,-3.4,45,22.3,-22.7,11.2,2,-9.2,672.9,932.9,260,7.1,38.6,31.5,2.2,6.8,4.6,1.3,10.5,9.2,52.4,54.1,1.7,0,0,0,477.5,265.9,-211.6,5.7,0.8,-4.9,22.5,10.3,-12.2,0.2,0.5,0.3,0,0.5,0.5,0.2,3.6,3.4,14,4.9,-9.1,0,0.3,0.3,1,0.5,-0.5,2.8,0.5,-2.3,0.1,0.9,0.8,4.8,1.1,-3.7,360.4,414.9,54.5,112,62.5,-49.5,0.3,3.2,2.9,9.9,8.4,-1.5,0.1,0.2,0.1,0.1,0,-0.1,1471.8,861.7,-610.1,0,0,0,12.1,11.8,-0.299999999999999,25.7,8.9,-16.8,0.3,0,-0.3,7.2,2.7,-4.5,0,1,1,,,,,,,,,,2.7,0.5,-2.2,39.2,123.6,84.4,17.9,15,-2.9,9.1,12.6,3.5,146.4,268.1,121.7,1.3,15.8,14.5,1.8,20.4,18.6,3.6,31.8,28.2,0,0,0,0,35,35,0,0,0,0,0,0,0,0,0,2.4,18.8,16.4,139.3,109.4,-29.9,0,0,0,637.5,619.4,-18.1,9.7,17.3,7.6,46.2,153.1,106.9,0.5,9.8,9.3,38.7,21.3,-17.4,9.1,20.8,11.7,0.8,0.4,-0.4,457.9,292.9,-165,93.7,36.3,-57.4,7.4,1.1,-6.3,114,31.6,-82.4,95.6,29.6,-66,7,0.6,-6.4,943.6,514.6,-429,8.5,20.6,12.1,0.7,0.2,-0.5,0.1,3.6,3.5,1428.7,753.8,-674.9,1608.8,1299.1,-309.7,676.9,241.2,-435.7,,,,2.5,112.2,109.7,589.8,455,-134.8,78,1.7,-76.3,0,0,0,0.8,0.1,-0.7,3960.7,946.7,-3014,1.5,2.6,1.1,0,4.2,4.2,2002.6,2238.4,235.8,880.6,1230.9,350.3,2362.9,1864.4,-498.5,10885.4,5542,-5343.4,265,989,724,0,0.1,0.1,0,0,0,0,0.6,0.6,0,0,0,0.9,5.6,4.7,139.5,138.5,-1,0.2,0,-0.2,0,0,0,0,2.4,2.4,0.1,0.7,0.6,1,0.1,-0.9,0,0.3,0.3,0,0,0,0.1,0.3,0.2,0,0,0,1.9,1.6,-0.3,0,0,0,1.3,7.6,6.3,1.8,5,3.2,1.6,2.3,0.7,0.6,0.7,0.1,0,0,0,6.2,2.4,-3.8,0.2,0.5,0.3,15.2,55.8,40.6,158.6,73.7,-84.9,4.4,13.5,9.1,0,0,0,40.5,201.2,160.7,2.7,1.4,-1.3,,,,0,0,0,7.2,1.3,-5.9,0,0.9,0.9,2.2,3.1,0.9,0.3,6.6,6.3,0.2,1.2,1,13.5,6.2,-7.3,1.7,0.9,-0.8,15.4,20.4,5,16.3,13.3,-3,0.1,0.1,0,0,1.2,1.2,0.1,2.7,2.6,430.9,55.3,-375.6,0,0.4,0.4,141.7,5,-136.7,0.6,0.2,-0.4,0,0,0,0,1.9,1.9,0.2,3.2,3,162.9,30.1,-132.8,14.4,2.1,-12.3,0,0,0,0,2,2,0,0,0,0.3,3.2,2.9,29,14.3,-14.7,4.7,0.3,-4.4,1,3,2,0,2.6,2.6,0,0,0,0,1.1,1.1,0,0.6,0.6,1.2,2,0.8,9,7.5,-1.5,0.1,0.6,0.5,0,0.1,0.1,1.4,2.8,1.4,23.2,1.7,-21.5,0.3,1,0.7,2,1,-1,,,,0,0.6,0.6,0,0.5,0.5,0,0,0,216.4,239,22.6,0.5,1,0.5,1.8,2.4,0.6,5.8,3.5,-2.3,1.6,0,-1.6,13.7,7.7,-6,1.3,0.5,-0.8,5.3,0.5,-4.8,0,24.5,24.5,0,0,0
1995-07-01,3188,1549.8,-1638.2,,,,62479,48097,-14382,3391.1,0,-3391.1,3303.9,3611.8,307.9,10384.9,10627,242.1,7164.9,6090.4,-1074.5,3581.6,3944.9,363.3,14476.5,11901.4,-2575.1,,,,,,,25411.7,15083.4,-10328.3,61856.7,44389.3,-17467.4,28339,16289.7,-12049.3,,,,448.8,1023.7,574.9,1170.5,464,-706.5,0.2,0.3,0.1,9703.1,8435.4,-1267.7,0,0.1,0.1,4773.4,3466,-1307.4,121.8,156.1,34.3,4.6,7.3,2.7,70.7,94.5,23.8,119,103.8,-15.2,15.6,18.2,2.6,161.5,144.5,-17,32.7,107.3,74.6,0.8,23.7,22.9,10.9,60.9,50,0,4.4,4.4,72,123.1,51.1,0.3,4.2,3.9,0.7,12.1,11.4,13.2,39.9,26.7,297.5,230.8,-66.7,0,0.9,0.9,0.3,4,3.7,2,3,1,0.2,6.8,6.6,0.4,0.3,-0.1,0.6,3.5,2.9,3.2,7.8,4.6,0.5,4.5,4,0.3,2.6,2.3,3,18.1,15.1,89.3,46.3,-43,19.2,44.1,24.9,,,,,,,41.2,18.3,-22.9,0.1,5.2,5.1,0.1,3.7,3.6,292.8,385.8,93,861.3,438.3,-423,9,9.4,0.4,8,14.2,6.2,0.4,1,0.6,187.5,130.4,-57.1,102.2,135.4,33.2,18.7,11.9,-6.8,158.1,295.1,137,715,817.7,102.7,3.9,91.4,87.5,11.5,32.3,20.8,131.5,282.1,150.6,0,0,0,17.5,15.6,-1.9,493.3,225.9,-267.4,0,0.7,0.7,227.5,97.3,-130.2,197.6,105.2,-92.4,1.8,0.1,-1.7,156.8,113.3,-43.5,2110.2,2171.8,61.6000000000004,347,306.6,-40.4,565.4,1197.9,632.5,591.7,928.5,336.8,24.1,19.4,-4.7,0,1.5,1.5,0.9,0.5,-0.4,1495.6,1044,-451.6,3632.5,1699.2,-1933.3,167.5,119,-48.5,0,0,0,35.2,23.4,-11.8,8,3.7,-4.3,48.9,23.4,-25.5,12.2,1.7,-10.5,706.4,342.2,-364.2,11.2,14.8,3.6,2.3,8,5.7,1.6,2.4,0.8,55.1,54.9,-0.200000000000003,0,0,0,253.3,229.6,-23.7,1.9,1.8,-0.0999999999999999,42.6,14.1,-28.5,3.2,0.6,-2.6,0,1.6,1.6,1.6,1.3,-0.3,15,2,-13,0.6,0.3,-0.3,4.7,2.3,-2.4,1.2,4.9,3.7,0.1,6.5,6.4,0.2,0.8,0.6,338,362.8,24.8,110.7,73.6,-37.1,1.2,1.1,-0.0999999999999999,11,7.4,-3.6,0.1,0.6,0.5,0,0,0,1576.1,579.9,-996.2,0,0,0,8.2,12.8,4.6,26.9,9.6,-17.3,0.2,2.8,2.6,12.8,1.2,-11.6,0,0.1,0.1,,,,,,,,,,0.3,0.4,0.1,48.8,220.5,171.7,25.4,16.5,-8.9,14,7.7,-6.3,181.4,225.8,44.4,0.8,21,20.2,1,11.1,10.1,2.5,55.6,53.1,0,0,0,0,20.8,20.8,0,0,0,0,0,0,0,0.1,0.1,2.4,33.4,31,106.7,70.9,-35.8,0,0,0,684.9,406.3,-278.6,7.3,14.2,6.9,46.8,143.2,96.4,0.1,9.5,9.4,53.6,17,-36.6,10.5,18.4,7.9,0,0.2,0.2,518.3,352.6,-165.7,100.5,41.7,-58.8,5.4,1.1,-4.3,124.7,14.7,-110,117.9,17.1,-100.8,7.5,1.5,-6,1006.1,516.4,-489.7,7.6,31.6,24,0.8,0,-0.8,0.7,1.3,0.6,1524.2,805.5,-718.7,1592.1,1266.9,-325.2,736.4,311,-425.4,,,,3.7,6.1,2.4,607.7,404.7,-203,89.3,2.1,-87.2,0,0.1,0.1,1.1,0.1,-1,4311.8,985.7,-3326.1,2.4,2.8,0.4,0,0,0,2131.6,2111.1,-20.5,949.7,1237.2,287.5,2491.5,1475.2,-1016.3,10548.6,5474.1,-5074.5,293.8,857.3,563.5,0,0.1,0.1,0,0,0,0,0.2,0.2,0,0,0,1,6.8,5.8,130.3,139.8,9.5,0.1,0.1,0,0.1,0,-0.1,0,2.5,2.5,0,0.7,0.7,1.4,0.3,-1.1,0,0.2,0.2,0,0,0,0.1,0,-0.1,0,0.1,0.1,3.5,2.1,-1.4,0,0,0,6.7,6.3,-0.4,0.8,2.5,1.7,1.2,1.7,0.5,0.9,0.6,-0.3,0,0,0,8.7,1.8,-6.9,0.2,0.6,0.4,27.2,97.1,69.9,173.9,59.8,-114.1,5.2,10.1,4.9,0,0,0,42.5,233.6,191.1,1.8,3.2,1.4,,,,0,0,0,0.6,0.5,-0.1,0,0.4,0.4,2.7,4.7,2,1.1,6.6,5.5,0.1,0.5,0.4,10.1,8.3,-1.8,3.8,1.8,-2,16.6,15.3,-1.3,13.2,10.3,-2.9,0.2,0.2,0,0.2,1.3,1.1,0.2,1.9,1.7,411.9,78.4,-333.5,0,2.2,2.2,158.7,7,-151.7,0.2,0.3,0.1,0,0,0,0.1,1.4,1.3,0.1,3.2,3.1,231.2,16,-215.2,29.8,4.4,-25.4,0,0,0,0,0.4,0.4,0,0.1,0.1,0.9,1.5,0.6,20.8,5.5,-15.3,3.7,0.1,-3.6,0,0.4,0.4,0,0.1,0.1,0,0,0,0,0.3,0.3,0,1.3,1.3,1.2,3.2,2,8.7,8.4,-0.299999999999999,0.2,0.4,0.2,0.2,0,-0.2,1.7,31.7,30,20.8,2.1,-18.7,0.1,3,2.9,4.5,1,-3.5,,,,0,0,0,0.1,0.6,0.5,0.4,0,-0.4,186.4,210.1,23.7,2.7,1.6,-1.1,1.4,1.7,0.3,1.5,2.2,0.7,2.2,0.1,-2.1,14.6,11.5,-3.1,0.6,0.7,0.1,5.4,0,-5.4,0,33.4,33.4,0,0,0
1995-08-01,2984.7,1469.6,-1515.1,,,,62042,49309,-12733,3758.2,0,-3758.2,6547.2,4192.9,-2354.3,11004.2,11724,719.799999999999,7678.6,6490.9,-1187.7,3702.9,4203.3,500.4,17566.3,15020.7,-2545.6,,,,,,,26432.1,15433.8,-10998.3,64452.1,48972.2,-15479.9,29407.8,16663.9,-12743.9,,,,431.4,1026.6,595.2,1056.2,482.7,-573.5,0.1,0.1,0,12213.1,10833.8,-1379.3,0,0.1,0.1,5353.2,4186.9,-1166.3,146.2,145,-1.19999999999999,4.4,6.9,2.5,77.4,83.9,6.5,130.8,121,-9.80000000000001,25.4,28,2.6,161.5,149.5,-12,26.2,102.6,76.4,1,24.2,23.2,8.9,60.3,51.4,0,0.1,0.1,73.9,132.7,58.8,0.5,4.7,4.2,1.4,11,9.6,13.3,41.5,28.2,321.9,261.2,-60.7,0,1.2,1.2,2.2,3.2,1,1.7,2.8,1.1,0.2,5.2,5,0.1,0.3,0.2,0.7,1.5,0.8,2.1,6.8,4.7,0.6,5.6,5,0.1,2.4,2.3,2.6,14.4,11.8,72,56.9,-15.1,24.3,37.6,13.3,,,,,,,35.4,18.7,-16.7,0,5.4,5.4,0.1,3.3,3.2,373.6,357,-16.6,771.8,443.7,-328.1,14.2,13.5,-0.699999999999999,7.3,14.4,7.1,0.1,1.3,1.2,159.9,117.1,-42.8,79.4,184.1,104.7,22,17.3,-4.7,132.9,353.2,220.3,811.8,914.9,103.1,4.5,91.2,86.7,18.1,30.5,12.4,172.4,327.2,154.8,0,0,0,11,16.2,5.2,312.3,261.5,-50.8,0,0,0,309.6,96.8,-212.8,208.1,113.7,-94.4,0.8,0,-0.8,131.9,122.9,-9,2074.5,2306.7,232.2,272.1,346.9,74.8,491.7,1400.2,908.5,346.1,1039.2,693.1,24.2,40.4,16.2,0.1,2.3,2.2,2,0.3,-1.7,1470.7,1075.2,-395.5,2991.6,1760.3,-1231.3,170,201.6,31.6,0,0,0,28,24.4,-3.6,12.1,3.2,-8.9,41.9,19.4,-22.5,9.3,1.2,-8.1,557.6,384.7,-172.9,3.6,5.1,1.5,2,8.2,6.2,2.6,2.8,0.2,48.3,57.6,9.3,0,0,0,344.9,232.5,-112.4,2.2,2.6,0.4,32.2,18.8,-13.4,11.8,11.1,-0.700000000000001,0,2.3,2.3,2,11.9,9.9,16.1,4.8,-11.3,0.5,11.4,10.9,1.2,0.3,-0.9,3.6,1.8,-1.8,0.3,2,1.7,0.2,3.5,3.3,340.9,382.3,41.4,104.8,71.6,-33.2,0,0.1,0.1,9.7,9.5,-0.199999999999999,0.3,0.3,0,0,0.1,0.1,1420.1,689.8,-730.3,0,0,0,6.4,7.2,0.8,19.9,8.7,-11.2,0.2,1.9,1.7,7.5,1.8,-5.7,0,0.7,0.7,,,,,,,,,,0.3,0.5,0.2,29.2,124.4,95.2,21.3,20,-1.3,14.8,9.9,-4.9,134.2,245.9,111.7,0.7,14.7,14,6.8,25.5,18.7,1.8,49.8,48,0,0.2,0.2,0,11.6,11.6,0,0,0,0,0,0,0,0.1,0.1,2.4,29.2,26.8,101.5,102,0.5,0,0,0,624.4,368,-256.4,15.3,33.4,18.1,58.9,142.3,83.4,4.4,34.6,30.2,50.7,16.2,-34.5,10.4,20.6,10.2,0.1,0.3,0.2,551.2,317.8,-233.4,110.9,40,-70.9,6.7,1.1,-5.6,136.8,29.1,-107.7,141.4,37.4,-104,7.6,1.2,-6.4,1086.6,498,-588.6,9.5,29.4,19.9,1,0.4,-0.6,1.1,2,0.9,1625.2,834.1,-791.1,1688.1,1416.9,-271.2,691,262.4,-428.6,,,,5,9,4,666.1,513.9,-152.2,87.3,2.3,-85,0.1,0,-0.1,1.4,0.1,-1.3,4804.7,881.4,-3923.3,4.8,0.6,-4.2,0,0,0,2310.4,2202.3,-108.1,1012.7,1155.9,143.2,2667.4,1715.8,-951.6,10459.4,5434.5,-5024.9,283.2,852.1,568.9,0.1,0.1,0,0,0,0,0,1.1,1.1,0.1,0,-0.1,3.5,2.8,-0.7,128.2,150.5,22.3,0.1,0.1,0,0.1,0,-0.1,0,2.3,2.3,0,0.6,0.6,0.1,0.2,0.1,0,0,0,0,0,0,0.1,0.2,0.1,0,0,0,4.1,1.1,-3,0,0,0,1.2,7,5.8,0.1,2.4,2.3,1.5,2,0.5,1,0.8,-0.2,0,0,0,7.8,2.3,-5.5,0.2,1,0.8,17.5,31.6,14.1,150.7,41.7,-109,10,12.9,2.9,0,0,0,61.6,253.8,192.2,1.3,4.7,3.4,,,,0,0,0,0.8,0.4,-0.4,1.1,1.5,0.4,2.4,4.2,1.8,0.5,3.9,3.4,0.4,2.1,1.7,8.7,6.7,-2,1.1,2.5,1.4,12.3,18.6,6.3,17.5,11.4,-6.1,0,0.9,0.9,0.1,1.7,1.6,0.1,1.5,1.4,417.2,58.6,-358.6,0,0.5,0.5,153.9,5.7,-148.2,0.5,0.2,-0.3,0,0,0,0,0.9,0.9,0.2,1.8,1.6,146.7,27.8,-118.9,10,3.1,-6.9,0,0.1,0.1,0,0.5,0.5,0,0.1,0.1,0.4,1.2,0.8,22.5,5.3,-17.2,1.1,0.8,-0.3,0.1,11.2,11.1,0,0,0,0,0,0,0,0.5,0.5,0,0.3,0.3,1,1.9,0.9,9.4,13.5,4.1,0.1,0.6,0.5,0.1,0,-0.1,1.9,2.8,0.9,17.7,1.8,-15.9,5.5,7.6,2.1,6.8,0.7,-6.1,,,,0,0,0,0.1,0.4,0.3,0,0,0,191.4,253.5,62.1,2,1.2,-0.8,1.9,2.1,0.2,2.5,2.7,0.2,1.7,0.1,-1.6,4.2,7.6,3.4,2.1,0.7,-1.4,5.5,0,-5.5,0,51.2,51.2,0,0,0
1995-09-01,3084.6,1615.3,-1469.3,,,,62845,50640,-12205,3736.7,0,-3736.7,6640.9,4161.3,-2479.6,11588.1,11549,-39.1000000000004,7551.9,6205.2,-1346.7,3499.1,4232.5,733.4,17845.2,14840.1,-3005.1,,,,,,,25711.7,15528.4,-10183.3,63416,49723.5,-13692.5,28685,16933.8,-11751.2,,,,390.4,1134.9,744.5,1141.3,530.4,-610.9,1.9,0.1,-1.8,12456.6,10777.8,-1678.8,0.8,0,-0.8,5388.6,4062.3,-1326.3,138.8,120.9,-17.9,4.7,10.9,6.2,67.6,83.4,15.8,122.7,96.3,-26.4,19.9,20.9,1,155.9,139.8,-16.1,25.8,106.8,81,0.8,38.2,37.4,13.4,55.6,42.2,0,0,0,75.3,125.2,49.9,0.6,3.8,3.2,1.2,15.1,13.9,10.3,60.4,50.1,298.3,246.4,-51.9,0,1.3,1.3,0.5,3,2.5,1.3,3.5,2.2,0.2,8.8,8.6,0,0.3,0.3,0.4,1.9,1.5,2.4,5.2,2.8,0.7,3.8,3.1,0.1,1.9,1.8,2.8,15.8,13,71.2,67.6,-3.60000000000001,26.9,37.3,10.4,,,,,,,23.4,21,-2.4,0,4.1,4.1,0.2,2.9,2.7,302.2,402.5,100.3,866.3,421.8,-444.5,8.8,12.8,4,9,18,9,1.5,73.1,71.6,141.6,114,-27.6,96.4,177.7,81.3,19.5,24,4.5,115.7,315.8,200.1,695.3,854.2,158.9,6.8,85.8,79,20.8,35.6,14.8,149.8,395.1,245.3,0,0,0,21.4,16.9,-4.5,494.2,267.8,-226.4,0.1,0.3,0.2,248.5,105.9,-142.6,207.3,127,-80.3,0.7,0,-0.7,169.7,101.1,-68.6,2312.8,2556.6,243.8,398.4,310.2,-88.2,492,1217.2,725.2,460.8,1063.1,602.3,16.4,155.7,139.3,0,2.4,2.4,0.6,0.2,-0.4,1263.8,1112.3,-151.5,2665.3,1912.3,-753,159.8,121.9,-37.9,0,0,0,24.8,24.9,0.0999999999999979,7.3,2.9,-4.4,42.7,26,-16.7,10.5,0.7,-9.8,610.9,399.2,-211.7,4.7,4.2,-0.5,6.8,6.5,-0.3,2.1,6.3,4.2,49.6,67.2,17.6,0,0,0,272.4,258.2,-14.2,3.1,5.7,2.6,28.3,17.9,-10.4,0.4,17.3,16.9,0.2,2.5,2.3,0,12.8,12.8,12.9,15.4,2.5,0.8,0.6,-0.2,4.9,1.2,-3.7,0.3,0.3,0,0,4,4,4.1,1.5,-2.6,269.1,525.9,256.8,72.6,55.4,-17.2,0.1,0.3,0.2,13.6,8.9,-4.7,0,2.4,2.4,0.1,0.1,0,1056.4,727.3,-329.1,0,0,0,7.9,9,1.1,22.6,8.6,-14,0.4,8.2,7.8,4.5,1.5,-3,0,0,0,,,,,,,,,,0.2,1.5,1.3,29,70.4,41.4,27.9,25.4,-2.5,15.4,13.2,-2.2,127.7,209.4,81.7,1,15.7,14.7,1.3,27.7,26.4,0.8,49.5,48.7,0,0,0,0,10.9,10.9,0,0,0,0,0,0,0,0,0,3.2,21.6,18.4,82.3,94.5,12.2,0,0,0,744.5,526,-218.5,13.7,16.8,3.1,35.8,144.3,108.5,0,25.5,25.5,31,18.1,-12.9,9.5,19.1,9.6,0.1,0.2,0.1,526.6,345.1,-181.5,104.1,81.3,-22.8,5.5,0.4,-5.1,122.9,31,-91.9,108.5,22.6,-85.9,7.9,0.9,-7,1028.9,639.8,-389.1,20.7,16.9,-3.8,1.6,0.4,-1.2,0.6,3,2.4,1723.4,805,-918.4,1792.7,1305.8,-486.9,656.5,310.9,-345.6,,,,3.5,7,3.5,674.8,438,-236.8,95,1.8,-93.2,0,0,0,0.4,0.1,-0.3,4584.1,959.6,-3624.5,2.2,0.7,-1.5,0,0.2,0.2,2180.7,2065.2,-115.5,1024.1,1180.7,156.6,2554.4,1653.5,-900.9,10050.4,5685.1,-4365.3,271.2,964.1,692.9,0.1,0,-0.1,0,0,0,0,0.1,0.1,0,0,0,5.1,2.1,-3,95.8,149.5,53.7,0,0,0,0.6,0,-0.6,0,2.3,2.3,0,0.6,0.6,0.1,0.1,0,0,0.1,0.1,0,0,0,0.1,0.5,0.4,0,0,0,4.7,1.6,-3.1,0,0,0,0.7,6.7,6,0.8,2.3,1.5,0.3,1.1,0.8,0.5,0.5,0,0,0,0,10.1,2.3,-7.8,0.3,1,0.7,18,34.6,16.6,142.7,39.5,-103.2,2,11.5,9.5,0,0,0,42.4,245.1,202.7,1.8,5.5,3.7,,,,0,0,0,6.2,0.1,-6.1,0,11.9,11.9,7.1,3.4,-3.7,0.5,2.1,1.6,0.5,3.2,2.7,7.9,3.5,-4.4,2.7,0.6,-2.1,21.2,10.7,-10.5,22.2,24.6,2.4,0,0.1,0.1,0.1,1.4,1.3,0.1,0.9,0.8,454.2,48.1,-406.1,0,0.3,0.3,88.6,2.5,-86.1,0,2.1,2.1,0,0.2,0.2,0,1,1,3.9,1.4,-2.5,206.7,24.3,-182.4,3.1,6.7,3.6,0,0,0,0,0.1,0.1,0,0,0,1.3,6.3,5,21.6,8.3,-13.3,1.4,0.2,-1.2,0.4,2,1.6,0,0,0,0,0,0,0.1,0.3,0.2,0,0.8,0.8,1.4,1.5,0.1,8.2,8.1,-0.0999999999999996,0.2,1.1,0.9,0,0.1,0.1,2.3,3,0.7,21.1,1.7,-19.4,8.4,5.7,-2.7,5.8,0.5,-5.3,,,,0,0,0,0.1,0.1,0,0,0,0,197.9,280.1,82.2,0.7,4.6,3.9,2.4,2.8,0.4,1.5,4,2.5,11,1,-10,14.3,12.1,-2.2,7.1,2.2,-4.9,5.1,1,-4.1,0,91.2,91.2,0,0,0
1995-10-01,2899.5,1726.2,-1173.3,,,,62028,50133,-11895,4113.3,0,-4113.3,6987.7,4306.2,-2681.5,12262.3,12200,-62.2999999999993,8035.8,6278.2,-1757.6,3604.7,4253.8,649.1,18885,15741.5,-3143.5,,,,,,,26586.2,15623.4,-10962.8,67389.6,51828.1,-15561.5,29518,17164.3,-12353.7,,,,389,1116.3,727.3,1110,514.3,-595.7,0.3,0.2,-0.1,13167.9,11429,-1738.9,0.4,0,-0.4,5717.1,4312.5,-1404.6,107.9,142.7,34.8,3.4,8.4,5,70.9,112.1,41.2,128.7,116.3,-12.4,17,22.4,5.4,164.2,142.6,-21.6,26.9,123.1,96.2,1,20.1,19.1,13,58.3,45.3,0,0.2,0.2,80.6,125.5,44.9,0.4,2.3,1.9,1.6,15.8,14.2,10,47.4,37.4,318.1,266.7,-51.4,0,1.7,1.7,1.1,4.2,3.1,2.2,3.8,1.6,0.2,8.6,8.4,0.2,0.3,0.1,0.3,2.7,2.4,2.5,8.3,5.8,0.8,3.2,2.4,0.4,2.1,1.7,3.8,17.6,13.8,96.3,54.6,-41.7,22.3,45.4,23.1,,,,,,,44.6,17.3,-27.3,0.1,5.5,5.4,0.1,2.8,2.7,349.4,406.5,57.1,730.9,404.5,-326.4,9.2,10,0.800000000000001,8.3,19.6,11.3,0.3,1.8,1.5,148.9,129.3,-19.6,114.6,162.8,48.2,26.6,18.9,-7.7,142.2,313.7,171.5,775,911.7,136.7,3.8,83.9,80.1,14.9,32.7,17.8,162,376.4,214.4,0,0,0,26.4,19.3,-7.1,548.7,308.2,-240.5,0,0,0,234.6,156.6,-78,198.1,132.2,-65.9,0.6,0.1,-0.5,172.1,162.6,-9.5,2565.7,2451.2,-114.5,429.5,357.1,-72.4,716.2,1490.7,774.5,551.6,1114.7,563.1,18.8,28.7,9.9,0,2.4,2.4,0.7,0.2,-0.5,1707.6,1215.4,-492.2,2937,2069.6,-867.4,180.5,182.7,2.19999999999999,0,0,0,26.2,34.9,8.7,7.8,3.7,-4.1,50.6,24.4,-26.2,10.7,0.9,-9.8,760.5,554.4,-206.1,6.4,16.3,9.9,9.5,8.6,-0.9,2.2,2.5,0.3,58.5,62.4,3.9,0,0,0,218.5,250,31.5,1.5,2.6,1.1,28.9,18.7,-10.2,0,5.3,5.3,0.2,5.1,4.9,0.3,4,3.7,6.2,5.4,-0.8,1.6,0.6,-1,3.6,1.5,-2.1,2.9,0.1,-2.8,0,1.9,1.9,0.1,27,26.9,362.8,450.8,88,78.6,71.1,-7.5,0.5,0.2,-0.3,15.3,9.3,-6,0.2,0.5,0.3,0,0.1,0.1,1528.7,872.5,-656.2,0,0,0,7.5,11.7,4.2,23.7,9.3,-14.4,0.3,7.1,6.8,4.5,1.7,-2.8,0,0,0,,,,,,,,,,0.3,2.4,2.1,36.9,87.9,51,19.2,14.6,-4.6,9.4,16.2,6.8,101.7,244,142.3,0.9,15.9,15,6.4,13,6.6,2.7,54.9,52.2,0,0,0,0,9.9,9.9,0,0,0,0,0,0,0,0,0,2.4,29,26.6,108,121.6,13.6,0,0,0,634,543.4,-90.6,6.4,16.6,10.2,39.8,193.8,154,0.4,5.8,5.4,27.5,17.1,-10.4,8.7,19.5,10.8,0.9,0.2,-0.7,542.5,284.9,-257.6,114.9,127.9,13,4.9,0.6,-4.3,103.7,23.7,-80,114.2,19.9,-94.3,8.6,1.8,-6.8,1099.2,678.1,-421.1,21.6,29,7.4,0.4,0.1,-0.3,0.3,6,5.7,1750.3,779.8,-970.5,1819.2,1540.7,-278.5,672.2,339,-333.2,,,,4.2,11,6.8,704.7,514,-190.7,101.3,2.2,-99.1,0,0.3,0.3,0.4,0.1,-0.3,4714.3,1097.4,-3616.9,2.6,0.5,-2.1,0,0,0,2395.1,2125.8,-269.3,1076.5,1222.8,146.3,2745,1388.9,-1356.1,10234.8,5510,-4724.8,261,957.6,696.6,0,0.1,0.1,0,0,0,0,0.2,0.2,0.1,0,-0.1,6.2,2.9,-3.3,101.3,131.3,30,0,0,0,0.2,0,-0.2,0,3,3,0.1,0.2,0.1,0.1,0.2,0.1,0,0.1,0.1,0,0,0,0.1,0.3,0.2,0,0.2,0.2,6.9,2.9,-4,0,0,0,0.5,7.9,7.4,1.1,2.3,1.2,0.9,2.1,1.2,1.1,0.9,-0.2,0,0,0,7.7,3.5,-4.2,1.7,0.6,-1.1,22.1,25,2.9,140.6,38.5,-102.1,4.7,21.7,17,0,0,0,39.5,309.1,269.6,1.4,5.8,4.4,,,,0,0,0,0.9,0.4,-0.5,0,9.9,9.9,2.3,2.3,0,0.5,4.7,4.2,0.1,3.7,3.6,7.2,4.1,-3.1,2.3,1.2,-1.1,12.4,12.5,0.0999999999999996,9,23.2,14.2,0.2,0.3,0.1,0.5,2.3,1.8,0,3.3,3.3,443.7,56.9,-386.8,0,0.8,0.8,123.8,2.1,-121.7,0.3,0.2,-0.1,0,0,0,0,0.4,0.4,0.2,2.7,2.5,205.5,23.1,-182.4,28.6,8.1,-20.5,0,0,0,0,1.4,1.4,0,0.6,0.6,0.7,1.5,0.8,21.5,7.9,-13.6,1.8,0.1,-1.7,0.2,14.1,13.9,0,0.1,0.1,0,0,0,0.1,1,0.9,0,0.6,0.6,0.7,2.1,1.4,8.3,4.9,-3.4,0,1.1,1.1,0.5,0,-0.5,1.8,3.2,1.4,25.2,3.6,-21.6,8.6,3.6,-5,8.6,1,-7.6,,,,0,0,0,0,0.2,0.2,0,0,0,165.8,264.9,99.1,0.2,2,1.8,2.7,2.3,-0.4,4.1,2.5,-1.6,2,0.1,-1.9,3.9,16.9,13,7.6,0.8,-6.8,5.1,0,-5.1,0,105.9,105.9,0,0,0
1995-11-01,2972.6,1741.6,-1231,,,,62138,50259,-11879,4139.4,0,-4139.4,7232.2,4144.8,-3087.4,11637.3,12904,1266.7,7392.2,6032.5,-1359.7,3667.9,4330.5,662.6,18356.3,15045.6,-3310.7,,,,,,,24110.8,15234.8,-8876,63576.5,50710.3,-12866.2,26909.4,17047.3,-9862.1,,,,425,1034.2,609.2,965.5,463.3,-502.2,1.3,0.1,-1.2,12678.7,11077.8,-1600.9,0,0,0,5677.6,3967.8,-1709.8,114.1,132.3,18.2,2.5,8.6,6.1,73.6,100.7,27.1,137.9,115.4,-22.5,20.1,24.1,4,160.1,154,-6.09999999999999,22.9,127.1,104.2,1.2,26.6,25.4,11.9,57,45.1,0,0,0,70.6,119.3,48.7,0.5,2.6,2.1,2.6,14.1,11.5,8.4,31.6,23.2,308.6,267.2,-41.4,0,2,2,0.7,4.5,3.8,2.4,3.7,1.3,0.2,10.6,10.4,0.2,0.5,0.3,0.3,2.1,1.8,2.4,7.6,5.2,1,4.2,3.2,0.3,3,2.7,3.4,17.2,13.8,80.1,72.6,-7.5,22.6,47.5,24.9,,,,,,,59.9,20.6,-39.3,0.4,4.6,4.2,0.2,3.7,3.5,318.5,382.6,64.1,855.6,356.1,-499.5,10.7,14,3.3,9.6,18.2,8.6,0.8,93.2,92.4,146.5,122.9,-23.6,112.1,164.8,52.7,28.6,21.6,-7,152.4,316.5,164.1,774.5,1014.9,240.4,6,68.7,62.7,12.5,30.3,17.8,131,341.7,210.7,0,0,0,19.4,16.6,-2.8,551.4,267.3,-284.1,0,0,0,244.3,111.4,-132.9,209.2,105.9,-103.3,0.4,0.1,-0.3,166.6,147.5,-19.1,2294.4,2510.1,215.7,398,441.6,43.6,543.3,1579.8,1036.5,577.8,1099.5,521.7,16.1,16.3,0.199999999999999,0.1,1.4,1.3,0.8,0.2,-0.6,1419.1,1159.4,-259.7,3160.5,1913.8,-1246.7,177.7,164.3,-13.4,0,0,0,38.9,31.4,-7.5,6.4,20.4,14,47.9,26.7,-21.2,8.2,1.2,-7,621.1,436.7,-184.4,2.7,6.7,4,10,8.3,-1.7,2.8,8.7,5.9,58.9,72.5,13.6,0,0,0,294.3,270.7,-23.6,2.8,11,8.2,31.1,49.1,18,0.3,1.3,1,0.2,3.2,3,1.9,26.5,24.6,8,4.2,-3.8,0.1,2.1,2,0.6,0.5,-0.1,2.8,0.4,-2.4,0.3,12.6,12.3,0.4,5.8,5.4,343.3,423.1,79.8,77.3,67.8,-9.5,0.3,0.2,-0.1,17.8,13.4,-4.4,0,0.3,0.3,0,0,0,1439.2,740.6,-698.6,0,0,0,7.3,10,2.7,26.6,7.9,-18.7,0.6,0.7,0.1,7.7,1.8,-5.9,0,0,0,,,,,,,,,,0.4,2.9,2.5,30,273.9,243.9,14.6,24.5,9.9,26.3,7.7,-18.6,145,208.2,63.2,1.1,24.4,23.3,1,13.8,12.8,2,42.9,40.9,0,0,0,0,0,0,0,0,0,0,0,0,0,0,0,2,44,42,152.5,213.1,60.6,0,0,0,760,588.9,-171.1,6.3,12.4,6.1,22,131.9,109.9,0.3,15.8,15.5,22.2,17.7,-4.5,6.2,21.6,15.4,0.1,0.3,0.2,436.5,266.7,-169.8,96.2,106.9,10.7,5.9,1.1,-4.8,61,23.3,-37.7,96.1,27.2,-68.9,6.4,0.8,-5.6,975.8,831.2,-144.6,22,26.1,4.1,1,0.1,-0.9,0.1,2.4,2.3,1583.1,795.5,-787.6,1727.7,1317.2,-410.5,594.3,323.4,-270.9,,,,2.6,11.5,8.9,627.6,490.2,-137.4,80.8,3.9,-76.9,0,0,0,0.7,0.1,-0.6,3868,1124.7,-2743.3,1.5,0.5,-1,0,0.5,0.5,2260.4,2055,-205.4,900.8,1201.7,300.9,2503.3,1458.6,-1044.7,9551.9,5442,-4109.9,305.4,869.3,563.9,0,0,0,0,0,0,0,0.1,0.1,0.1,0,-0.1,3.8,6.4,2.6,102.1,135.4,33.3,0.1,0.1,0,0,0,0,0,2.8,2.8,0,0.7,0.7,0.1,0.1,0,0,0,0,0,0,0,0.1,0.2,0.1,0,0,0,4.6,2.2,-2.4,0,0,0,0.4,7.9,7.5,0.4,2.2,1.8,1.4,2.4,1,0.2,0.8,0.6,0,0.3,0.3,4.8,2.4,-2.4,1.5,0.9,-0.6,16,30.9,14.9,128.2,66.9,-61.3,2.8,11.4,8.6,0,0,0,47.6,217.1,169.5,2.5,3.8,1.3,,,,0,0,0,6.9,0.4,-6.5,0,0.3,0.3,1.7,4.1,2.4,0.3,18.4,18.1,0.2,2.8,2.6,5.3,2.2,-3.1,1.6,1,-0.6,18.6,21.2,2.6,13,10.2,-2.8,0,0.3,0.3,0.1,24.2,24.1,0.7,2.3,1.6,335.9,45.2,-290.7,0.1,0.3,0.2,117.7,3.7,-114,0.5,0.4,-0.1,0,0,0,0,0.9,0.9,0.2,1.8,1.6,172.8,23.9,-148.9,3.6,8.4,4.8,0,0,0,0,0.5,0.5,0,0.1,0.1,2,1.5,-0.5,16.3,4.9,-11.4,1.5,0.3,-1.2,0,0.6,0.6,0,0.1,0.1,0,0,0,0,1.2,1.2,0,0.5,0.5,0.4,1.1,0.7,6.8,6.1,-0.7,0.3,0.4,0.1,0.2,0,-0.2,1.3,2.7,1.4,18.2,1.5,-16.7,2.2,1.1,-1.1,3.7,0.7,-3,,,,0,0,0,0,0.6,0.6,0,0,0,206.4,221.2,14.8,0.3,0.5,0.2,2.5,5.4,2.9,1.2,5,3.8,4.2,0.2,-4,4.2,7.8,3.6,3.9,1.6,-2.3,6.9,0,-6.9,0,119.8,119.8,0,0,0
1995-12-01,3022.8,1570.8,-1452,,,,62727,50832,-11895,3569.1,0,-3569.1,6139.4,3546.8,-2592.6,11315.8,13751,2435.2,6816.4,6802.8,-13.5999999999995,3560.7,4405.7,845,16619.5,13566.8,-3052.7,,,,,,,22489.8,16470.5,-6019.3,59678.9,50853,-8825.9,25025.2,17911.6,-7113.6,,,,380.3,1065.7,685.4,1131.6,467.8,-663.8,1.2,0,-1.2,11714.7,9732.1,-1982.6,0,0,0,4904.8,3834.7,-1070.1,121.7,139.3,17.6,3,7.9,4.9,67.8,90,22.2,131.8,100,-31.8,22.4,20.3,-2.1,136.6,135,-1.59999999999999,21.6,113.5,91.9,0.6,16.9,16.3,13.2,53.3,40.1,0,0,0,68.7,128.8,60.1,0.4,3.1,2.7,0.7,18.4,17.7,9.4,48.5,39.1,248.2,222.9,-25.3,0,2.1,2.1,0.3,4.8,4.5,1.6,3.5,1.9,0.2,8,7.8,0.1,0.5,0.4,0.2,1.8,1.6,1.8,5.8,4,0.8,2.3,1.5,0.3,2.6,2.3,2.2,16.1,13.9,75.7,86,10.3,35.8,41,5.2,,,,,,,24,21.9,-2.1,0,12.5,12.5,0.1,3.8,3.7,344.2,388.1,43.9,829.1,325.3,-503.8,8.8,11.9,3.1,23.5,18.8,-4.7,0,187.5,187.5,147.3,161.7,14.4,82.2,136.6,54.4,23.1,18.6,-4.5,166,307.7,141.7,796.6,1046,249.4,4.1,52.3,48.2,12.4,37.6,25.2,134.2,403,268.8,0,0,0,19.7,14.7,-5,561.6,331.6,-230,0.1,0.1,0,295,124.7,-170.3,192.9,127.4,-65.5,0.4,0.1,-0.3,164.2,129.8,-34.4,2155.5,2647.2,491.7,368,403.7,35.7,544,1493.6,949.6,472.7,1045.1,572.4,16.5,18.4,1.9,0,5.7,5.7,0.7,0.4,-0.3,1235.4,1267.8,32.3999999999999,3519.9,2160.4,-1359.5,171.9,170.4,-1.5,0,0,0,33.6,32.4,-1.2,7.6,4.9,-2.7,45.1,29,-16.1,7.6,1.2,-6.4,619.3,455.1,-164.2,3.5,18.5,15,10.4,10.4,0,1.1,4.9,3.8,56.7,84.2,27.5,0,0,0,227.3,256.7,29.4,2.8,5.6,2.8,34.2,27.5,-6.7,0,6,6,0.1,2.4,2.3,0.2,10.9,10.7,8,5.1,-2.9,0,4.5,4.5,0.4,1.8,1.4,1.7,5.3,3.6,0,0.6,0.6,0.1,10.5,10.4,292.3,548,255.7,82.7,102.5,19.8,1,5.5,4.5,11.8,9.5,-2.3,0.2,0.2,0,0.1,0,-0.1,1362.4,819.3,-543.1,0,0,0,4.1,5.3,1.2,24.3,10.8,-13.5,0.5,1.2,0.7,10.7,1.6,-9.1,0,0.1,0.1,,,,,,,,,,0.9,2.6,1.7,26,82.5,56.5,15,39.5,24.5,22.6,9.3,-13.3,127.3,294.1,166.8,1.2,28.4,27.2,7.8,10.7,2.9,6.3,47.6,41.3,0,0,0,0,0.1,0.1,0,0,0,0,0,0,0,0.1,0.1,1.9,27.1,25.2,105.4,119.5,14.1,0,0,0,760.7,530.8,-229.9,4.5,18.2,13.7,28.1,159.5,131.4,0.2,12.4,12.2,18.6,14.5,-4.1,6.6,40,33.4,0.1,0.4,0.3,360.1,246.8,-113.3,76,89.7,13.7,5.5,1.1,-4.4,77.2,30.8,-46.4,90.2,24.6,-65.6,3.9,1.3,-2.6,891.7,540,-351.7,27.7,29,1.3,0.5,0.1,-0.4,0.1,1.4,1.3,1562,857.3,-704.7,1707.6,1521,-186.6,601.3,290.2,-311.1,,,,2.3,9.9,7.6,581.6,459.8,-121.8,61.2,2.6,-58.6,0,0,0,0.5,0.1,-0.4,3133.9,1130.3,-2003.6,1.3,1.4,0.0999999999999999,0,0.1,0.1,1985.6,2398.9,413.3,745.6,1180.8,435.2,2377.6,1702.1,-675.5,9360.2,5873.3,-3486.9,255.7,904.4,648.7,0,0.2,0.2,0,0,0,0,0.1,0.1,0,0,0,12.2,4.7,-7.5,103.2,135.3,32.1,0,0.1,0.1,0.1,0,-0.1,0,2.6,2.6,0,0.5,0.5,0,0,0,0,0,0,0,0,0,0.1,0.2,0.1,0,0,0,2.4,1.8,-0.6,0,0,0,0.5,6.6,6.1,0.1,3.6,3.5,0.9,1.9,1,0.2,0.9,0.7,0,0,0,4.4,2.3,-2.1,0.5,0.5,0,25.6,51.1,25.5,112.9,87.6,-25.3,2.2,10.1,7.9,0,0,0,58,345.1,287.1,0.7,5.7,5,,,,0,0,0,0,0.2,0.2,1.3,0.3,-1,7,2.4,-4.6,0.2,4.2,4,0.3,1.4,1.1,8.7,7,-1.7,1.7,2.5,0.8,37.8,10.5,-27.3,14.9,21.6,6.7,0,2,2,0.2,1.6,1.4,0,0.6,0.6,439.4,35.5,-403.9,0,0.1,0.1,141.4,4.3,-137.1,0.7,0.6,-0.1,0,0,0,0.1,2.3,2.2,0.2,5.6,5.4,166.6,42.7,-123.9,31.1,3.2,-27.9,0,0,0,0,0.5,0.5,0,0,0,1,7.6,6.6,34.4,6.6,-27.8,0,0.1,0.1,0,1,1,0,0.1,0.1,0,0,0,0,1.6,1.6,0,0.3,0.3,0.9,2.1,1.2,6.4,16.8,10.4,0,1.4,1.4,0.4,0,-0.4,1.3,3.5,2.2,12.5,3.6,-8.9,1,7.6,6.6,4,1.3,-2.7,,,,0,0,0,0,0.1,0.1,0,0,0,189.6,213.7,24.1,0.3,0.8,0.5,1.4,6.1,4.7,3.1,11.8,8.7,1.2,0.1,-1.1,5.9,17.3,11.4,10.7,1.4,-9.3,5.1,0,-5.1,0,62.4,62.4,0,0,0
1996-01-01,3280,1512.2,-1767.8,,,,63825,50275,-13550,4101,0,-4101,6425,3822.9,-2602.1,10633,11213,580,7298,5768.2,-1529.8,3733.5,3773,39.5,17818.5,14577.6,-3240.9,,,,,,,23163.4,14718.9,-8444.5,61909.3999999999,47767.8,-14141.5999999999,26094.8,15887,-10207.8,,,,389.7,1164.1,774.4,1251.4,518.5,-732.9,0.8,0,-0.8,12211.4,10301.2,-1910.2,0,0,0,5607.1,4276.4,-1330.7,122.1,125.9,3.80000000000001,3,7.5,4.5,65.4,77.3,11.9,105.1,113.1,8,22.6,16,-6.6,138.3,155.2,16.9,25.2,105.6,80.4,0.9,17,16.1,13.6,67.3,53.7,0,0,0,57.7,116.5,58.8,0.3,2.9,2.6,1.2,14.2,13,7.1,34.2,27.1,178,209.3,31.3,0,0.9,0.9,0.4,3.5,3.1,1.5,2.2,0.7,0.2,6.2,6,0.3,0.4,0.1,0.4,2.6,2.2,0.9,5.6,4.7,0.3,5.3,5,0.2,2.1,1.9,2,12.8,10.8,105.1,46,-59.1,61.9,42.6,-19.3,,,,,,,38.7,20,-18.7,0,4.5,4.5,0.2,2.7,2.5,300.5,379.7,79.2,955.5,332.2,-623.3,4.2,11.4,7.2,9,19.2,10.2,0,1.2,1.2,166.4,115.5,-50.9,102.5,143.6,41.1,24.1,17.3,-6.8,210.5,287.3,76.8,741,829.3,88.3,3,73.1,70.1,69.7,32.4,-37.3,194.5,311.4,116.9,0,0,0,23.3,13.8,-9.5,567.4,256.9,-310.5,0.3,0.1,-0.2,259.6,105.6,-154,202.1,99.7,-102.4,0.5,0,-0.5,146.7,121.4,-25.3,2181.9,2341.9,160,455.3,334,-121.3,457.3,1249.2,791.9,493.5,977.5,484,13.7,16.1,2.4,0,2.8,2.8,6,0.2,-5.8,1293.7,1203.9,-89.8,2913.6,1902.7,-1010.9,171.6,174.5,2.90000000000001,0,0,0,32.7,30.4,-2.3,7.1,4.5,-2.6,43.7,24.5,-19.2,10.8,1.3,-9.5,591.8,392.6,-199.2,3.5,4.9,1.4,11.7,8.6,-3.1,1.4,2.1,0.7,54,69.1,15.1,0,0,0,183.5,243.2,59.7,3,1.9,-1.1,28,22.7,-5.3,0,0.9,0.9,0.7,1.4,0.7,2.2,4.3,2.1,1.2,6.4,5.2,0.4,4.6,4.2,0.9,0.1,-0.8,4.1,0.2,-3.9,0.2,0.1,-0.1,2.8,21.1,18.3,315,589.3,274.3,83.1,124,40.9,0.4,0.2,-0.2,10.2,15.9,5.7,0.1,1.2,1.1,0,0,0,1525.6,744.8,-780.8,0,0,0,6.4,4.3,-2.1,20.5,17.3,-3.2,0.2,0.4,0.2,13.2,1.7,-11.5,0,0.8,0.8,,,,,,,,,,0.6,0.6,0,41.7,72,30.3,15,30.3,15.3,19.6,9.1,-10.5,153.9,218.5,64.6,0.5,8.7,8.2,2.2,15.4,13.2,5.4,46.8,41.4,0,0,0,0,0,0,0,0,0,0.1,0,-0.1,0,0.1,0.1,1.5,23.9,22.4,71.7,93.9,22.2,0,0,0,746.7,428,-318.7,15.3,15.2,-0.100000000000001,34.8,165.1,130.3,0.1,20.3,20.2,15.1,16.2,1.1,9.9,26.3,16.4,0.2,0.2,0,488.5,250.1,-238.4,96.5,97.8,1.3,11.2,0.4,-10.8,128.4,11.4,-117,152.1,18.6,-133.5,6.1,0.7,-5.4,937.2,526.8,-410.4,39.1,111.9,72.8,2,0.1,-1.9,0.2,2,1.8,1504.4,831.5,-672.9,1665.3,1276,-389.3,616.6,335.7,-280.9,,,,5.1,13.9,8.8,663.2,469.4,-193.8,89,2.9,-86.1,0.1,0,-0.1,1.2,0.1,-1.1,3657.7,929.2,-2728.5,2.5,0.2,-2.3,0,0,0,2267.5,1925.2,-342.3,912.3,996.2,83.9000000000001,2452.9,1570.8,-882.1,8954.8,5221.7,-3733.1,254.5,1012.8,758.3,0,0,0,0,0,0,0,0,0,0,0,0,2.1,4.8,2.7,118,129,11,0.1,0.1,0,0.5,0.1,-0.4,0,1.9,1.9,0,0.5,0.5,0.1,0,-0.1,0.1,0.1,0,0.8,0,-0.8,0.1,0.1,0,0,0,0,5.7,1.7,-4,0,0,0,0.6,6,5.4,0.2,2.6,2.4,0.9,1.5,0.6,0.6,0.8,0.2,0,0,0,4.8,1.8,-3,0.6,0.3,-0.3,16.1,51.5,35.4,161.6,65.7,-95.9,4.9,33.8,28.9,0,0,0,61.7,211.8,150.1,1.4,1.8,0.4,,,,0,0,0,0,2.3,2.3,1.2,0.6,-0.6,6,5.6,-0.4,0.5,9.2,8.7,0,1.7,1.7,10.1,10.3,0.200000000000001,2,1.3,-0.7,77.8,10.7,-67.1,14.7,20.9,6.2,0,0.7,0.7,0.1,1.1,1,1,1.2,0.2,548.5,67.7,-480.8,0,0.3,0.3,129.2,8.8,-120.4,0.9,0.2,-0.7,0,0,0,0,1.1,1.1,3.4,0.7,-2.7,196.5,19.5,-177,22,3.9,-18.1,0,0.1,0.1,0,0.1,0.1,0,0.1,0.1,0.4,4.8,4.4,25.4,13.2,-12.2,0.2,0.4,0.2,0.3,0.1,-0.2,0,0.6,0.6,0,0,0,1.2,2.4,1.2,0,1.6,1.6,0.1,2.2,2.1,8,12.5,4.5,0,0.4,0.4,0.2,0,-0.2,2.1,4.4,2.3,15,1.1,-13.9,1,5.9,4.9,3.1,0.4,-2.7,,,,4,0,-4,0,0.5,0.5,0,0,0,146.2,267.6,121.4,0.5,0.4,-0.1,2.4,2.2,-0.2,3.6,8.3,4.7,1.7,0,-1.7,6.7,11.3,4.6,6.1,0.7,-5.4,7.5,0,-7.5,0,0,0,0,0,0
1996-02-01,2809.3,1571.9,-1237.4,,,,63519,51625,-11894,4020.8,0,-4020.8,6517.6,3994.9,-2522.7,10144,12256,2112,6384.6,5815.5,-569.1,3444,3964.7,520.7,17978.1,15476.2,-2501.9,,,,,,,22534.2,15414.7,-7119.5,60579.5,51112.5,-9467,25124.8,17161.1,-7963.69999999999,,,,410,1121.2,711.2,1047.1,497.6,-549.5,0.4,0.1,-0.3,12395.8,11211.5,-1184.3,0,0.5,0.5,5582.3,4264.7,-1317.6,148.7,121.8,-26.9,6.5,7.9,1.4,88.2,80.8,-7.40000000000001,128.3,106.6,-21.7,21.2,17.5,-3.7,150.4,144.4,-6,22.7,108.3,85.6,0.4,21.7,21.3,15.9,55.3,39.4,0,0.1,0.1,68.4,110.4,42,0.3,3.5,3.2,1,14.1,13.1,8.5,47.2,38.7,275.1,247.2,-27.9,0,1.2,1.2,0.8,4.3,3.5,1.8,4.8,3,0.5,7.2,6.7,0.3,0.7,0.4,0.2,1.9,1.7,2.3,6.1,3.8,0.3,4.4,4.1,0.3,3.2,2.9,3.1,15.6,12.5,88.5,40.4,-48.1,44.5,43.3,-1.2,,,,,,,39.9,19.7,-20.2,0,5.1,5.1,0.1,3,2.9,302.1,401.5,99.4,802.4,334.5,-467.9,9.4,6.8,-2.6,5.9,19.8,13.9,0,1,1,127.6,121.3,-6.3,80.1,141.7,61.6,20.5,17.4,-3.1,207.1,389.5,182.4,632.5,857.7,225.2,4.5,68.2,63.7,11.3,30.2,18.9,122.4,327.4,205,0,0,0,11.5,12.8,1.3,580.9,275.9,-305,0,0.2,0.2,241.6,126.1,-115.5,156.6,115.7,-40.9,0.7,0,-0.7,147.7,119.6,-28.1,2217.1,2481.4,264.3,345.1,316.8,-28.3,501,1374.4,873.4,531.7,1087.3,555.6,16.6,25.1,8.5,0.1,1.4,1.3,0.8,0.2,-0.6,1353.8,1221.4,-132.4,2856.6,1931.9,-924.7,166.5,160.3,-6.19999999999999,0,0,0,39.9,29.1,-10.8,7.3,4.5,-2.8,43.7,30.8,-12.9,8,1.2,-6.8,646.4,509.4,-137,2.3,33.4,31.1,0.6,7.2,6.6,1.9,7.4,5.5,46.9,63.4,16.5,0,0,0,236.9,355.2,118.3,1.2,6.2,5,45.2,28.9,-16.3,0,11.9,11.9,0.4,1.2,0.8,0.2,7.2,7,5,70,65,1.5,12.5,11,0.5,1.2,0.7,0.8,1.7,0.9,0,1.9,1.9,0.3,49.9,49.6,333.4,535.2,201.8,65.2,90.9,25.7,0.4,7.6,7.2,12.7,13,0.300000000000001,0,1.2,1.2,0,0,0,1420.1,899.7,-520.4,0,0,0,11.8,13.8,2,26.3,21,-5.3,0.8,8.5,7.7,12.8,1.5,-11.3,0.1,0.8,0.7,,,,,,,,,,4.9,4.9,0,80.4,92.9,12.5,17.6,20.5,2.9,8.8,8.1,-0.700000000000001,151.4,266.3,114.9,1.1,13.1,12,1.1,27.6,26.5,2,84.3,82.3,0,0,0,0,0,0,0,0,0,0,0,0,0,0,0,1.5,24.9,23.4,86.7,121.4,34.7,0,0,0,571.3,501.1,-70.1999999999999,50.7,13.5,-37.2,42.3,176.2,133.9,0.2,5.4,5.2,12.5,15.2,2.7,8.4,19.5,11.1,0.9,0.6,-0.3,471,252,-219,102.3,82.1,-20.2,11.9,0.8,-11.1,138.6,28.1,-110.5,107.8,36.2,-71.6,7.9,2.5,-5.4,828.9,709.7,-119.2,32.3,213.8,181.5,1.9,0.1,-1.8,0.4,1.2,0.8,1301,665,-636,1416.8,1438.6,21.8,628.7,306.6,-322.1,,,,3.5,47.3,43.8,635.9,454.5,-181.4,65.7,3,-62.7,0,0,0,1.4,0.1,-1.3,3539.6,1146.9,-2392.7,2,0.3,-1.7,0,0,0,1995.8,2066.8,71.0000000000002,720.3,969.6,249.3,2251.7,1340.5,-911.2,9575.3,5874.6,-3700.7,289.3,966.1,676.8,0,0.2,0.2,0,0,0,0,0.1,0.1,0.1,0,-0.1,2.7,6.4,3.7,107.9,128.9,21,0,0,0,0.2,0,-0.2,0,1.8,1.8,0,1.2,1.2,0.1,0.1,0,0.2,0,-0.2,0,0,0,0.4,0.1,-0.3,0,0,0,0,1.8,1.8,0,0,0,0.6,7.9,7.3,0.2,1.5,1.3,1.4,1.1,-0.3,0.5,0.5,0,0,0,0,6,3,-3,0.4,0.5,0.1,18,43.7,25.7,134.3,59.2,-75.1,1.5,7.3,5.8,0,0,0,55.9,293.8,237.9,1.5,4.7,3.2,,,,0,0,0,9.9,0.7,-9.2,0,0.6,0.6,7.2,1.8,-5.4,0.3,3.6,3.3,0.1,2.2,2.1,10.5,12.3,1.8,3,3,0,64,10,-54,17.7,20.9,3.2,0,1.2,1.2,0,2.5,2.5,0,2.3,2.3,404.9,56.2,-348.7,0,0.4,0.4,88,3.3,-84.7,0.1,0.1,0,0.1,3.2,3.1,0,2.9,2.9,0.2,2.2,2,164.9,47.2,-117.7,13.2,3.4,-9.8,0,0.1,0.1,0,0.3,0.3,0.2,0.1,-0.1,22,9.7,-12.3,15.5,5.3,-10.2,0.2,0,-0.2,0,2.1,2.1,0,0,0,0,0,0,0,0.9,0.9,0,1.5,1.5,0.4,1.5,1.1,9.4,7.2,-2.2,0.1,0.4,0.3,0.2,0.1,-0.1,2.1,3.2,1.1,15.3,1.4,-13.9,1.6,3.9,2.3,3.9,0.8,-3.1,,,,0.6,0,-0.6,0,0.1,0.1,0,0,0,155.6,252.6,97,0.8,3.2,2.4,3,2.4,-0.6,6.1,2.6,-3.5,3.2,0,-3.2,9.9,8.9,-1,5.6,0.3,-5.3,5.8,0.1,-5.7,0,0,0,0,0,0
1996-03-01,2964,1943.8,-1020.2,,,,63806,50901,-12905,4192.2,0,-4192.2,6631,4462.2,-2168.8,11385,13983,2598,6724.6,7077.5,352.9,3816.9,4099.8,282.9,18462,16059.1,-2402.9,,,,,,,22929.8,17586.7,-5343.1,63363.3,54951.7,-8411.60000000001,25659.1,19118.1,-6541,,,,424.8,1250.1,825.3,989.3,562.1,-427.2,0.4,0.2,-0.2,12761.1,11599.8,-1161.3,0,0.2,0.2,5700.9,4459.3,-1241.6,144.8,137,-7.80000000000001,11.4,8.1,-3.3,78,102.1,24.1,145.9,116.9,-29,29.7,21.9,-7.8,148.9,148.8,-0.0999999999999943,22.7,117.3,94.6,0.5,24.1,23.6,22.1,56.1,34,0,0,0,76.2,127.8,51.6,0.4,4.3,3.9,1.3,15.5,14.2,10.6,36.1,25.5,276.9,259,-17.9,0.6,1.4,0.8,0.6,5.2,4.6,1.9,3.5,1.6,0.8,6.8,6,0.3,0.5,0.2,0.4,2.6,2.2,1.9,6.3,4.4,0.6,2.6,2,0.2,2.2,2,3,16,13,86.7,51.4,-35.3,37.1,42.2,5.1,,,,,,,34.1,18.6,-15.5,0,7.2,7.2,0.1,2.1,2,403.2,372.9,-30.3,914.4,412.1,-502.3,7.3,12.6,5.3,8.5,35.4,26.9,2.9,1,-1.9,170.5,94.6,-75.9,87.3,125.2,37.9,17.8,13.7,-4.1,210.3,279.5,69.2,686.4,941.4,255,2,83,81,10.7,38.5,27.8,157.9,346.3,188.4,0,0,0,26.9,76,49.1,622.6,307.3,-315.3,0,0.4,0.4,321.5,136.5,-185,183.9,116.1,-67.8,1.2,0.1,-1.1,181,148.2,-32.8,2328.2,2612.7,284.5,365.7,326.5,-39.2,567.8,1592.6,1024.8,577.3,1048.3,471,16.8,20,3.2,0.2,2,1.8,0.4,0.4,0,1678.9,1312.9,-366,3311.8,2168.8,-1143,182,162.2,-19.8,0,0,0,38.6,34.5,-4.1,7.6,5.2,-2.4,48.3,27.7,-20.6,8.3,0.9,-7.4,721,1044.3,323.3,3,11.3,8.3,0.8,12.1,11.3,2.1,3.9,1.8,48.3,78.1,29.8,0,0,0,232.4,329.9,97.5,1.5,10.9,9.4,38.6,25.8,-12.8,0,0.3,0.3,0.3,1.6,1.3,0.4,19.1,18.7,10.5,4.1,-6.4,0.3,3.4,3.1,0.5,0.7,0.2,5.6,0,-5.6,0,9,9,5,16.1,11.1,353.2,502.3,149.1,74.1,89.3,15.2,1.8,0.1,-1.7,13.7,15.5,1.8,0.1,0.1,0,0,0.1,0.1,1537.1,807.3,-729.8,0,0,0,6.8,10.3,3.5,24.1,9.6,-14.5,0.3,1.9,1.6,8.5,1.7,-6.8,0.1,1.7,1.6,,,,,,,,,,0.3,1.1,0.8,37,70.6,33.6,16.2,12.7,-3.5,7.8,12.6,4.8,152,256.6,104.6,1.6,26.1,24.5,1.8,14.1,12.3,2.5,52.1,49.6,0,0,0,0,0,0,0,0,0,0,0,0,0,0,0,1.9,29.4,27.5,68.8,127.4,58.6,0,0,0,749.9,731.9,-18,5.7,15.7,10,39.6,172,132.4,0.1,17.4,17.3,9.7,19.1,9.4,6.6,18.8,12.2,0.4,1.4,1,495.2,297.9,-197.3,96.5,96.8,0.299999999999997,12.8,1.4,-11.4,89.6,7.9,-81.7,116.2,9,-107.2,6.4,2,-4.4,915.3,565.3,-350,25.6,39.6,14,1.3,0.1,-1.2,0.2,1.8,1.6,1422.7,765.4,-657.3,1979.6,1712.6,-267,566.7,349.7,-217,,,,3.6,161.2,157.6,656.6,495.5,-161.1,44.7,2.8,-41.9,0,0,0,1.6,0.2,-1.4,2863.7,1092.5,-1771.2,1.7,0.4,-1.3,0,0,0,1939.9,2566.9,627,640.2,1192.2,552,2164.9,1605.8,-559.1,10240.7,6412.1,-3828.6,282.6,1076,793.4,0,0.1,0.1,0,0,0,0,0,0,0.1,0,-0.1,2.4,8.3,5.9,121.4,145.8,24.4,0.2,0.1,-0.1,0.1,0,-0.1,0,3.3,3.3,0.1,0.7,0.6,0.1,0.1,0,0.1,0,-0.1,0,0,0,0.1,0.3,0.2,0,0,0,9.2,1.9,-7.3,0,0,0,0.9,5.2,4.3,0.2,2.2,2,1.2,1.9,0.7,0.4,1.9,1.5,0.1,0,-0.1,5.4,2.2,-3.2,0.2,0.1,-0.1,22.8,50.3,27.5,148.7,63.2,-85.5,2.5,17.9,15.4,0,0,0,62.4,239.4,177,2.5,2.9,0.4,,,,0,0,0,0,1.9,1.9,1.2,0.9,-0.3,2.4,5.1,2.7,0.4,3.5,3.1,0.3,0.9,0.6,7.2,8,0.8,1.4,1.5,0.1,60,12.2,-47.8,13.1,18.9,5.8,0.5,0.4,-0.1,0,2.2,2.2,0.4,1.1,0.7,366.6,67.5,-299.1,0,0.1,0.1,103.6,4.3,-99.3,0.1,0.8,0.7,0.3,0.1,-0.2,0,0.5,0.5,0.1,1.7,1.6,128.3,18.6,-109.7,31.3,5.1,-26.2,0,0,0,0,59.8,59.8,0.1,0,-0.1,3.3,4.6,1.3,9.3,12.3,3,0.2,0.4,0.2,0.9,4.4,3.5,0,0.8,0.8,0,0,0,0,0.3,0.3,0,0.9,0.9,0.7,1.5,0.8,8.5,6.6,-1.9,0.3,0.6,0.3,0.1,0,-0.1,2,3.2,1.2,17.1,3.2,-13.9,0.7,1.5,0.8,4.2,2.3,-1.9,,,,0,0,0,0,0.2,0.2,0,0,0,191.3,275.2,83.9,1.2,1.8,0.6,1.7,2.4,0.7,3.7,2.4,-1.3,1.2,0.3,-0.9,7.6,5.5,-2.1,3,1.6,-1.4,5.6,0,-5.6,0,0,0,0,1.5,1.5
1996-04-01,3554.9,1707.7,-1847.2,,,,64459,51351,-13108,4526.6,0,-4526.6,6985.6,4294.6,-2691,10574,12451,1877,6591.1,6223.1,-368,4103.9,4015.1,-88.7999999999997,19041,15858.4,-3182.6,,,,,,,22841.5,15388,-7453.5,64663.4,51871.8,-12791.6,25665,16849.8,-8815.2,,,,423.1,1128.3,705.2,1303.2,446.8,-856.4,0.5,0.2,-0.3,13047.4,11499.7,-1547.7,0,0,0,5993.6,4358.7,-1634.9,135.8,126.8,-9.00000000000001,5.2,10.2,5,68.9,100.1,31.2,128.7,119.9,-8.79999999999998,29.7,24.9,-4.8,174.5,125.6,-48.9,30.3,120.6,90.3,2.8,23.7,20.9,12.3,57.3,45,0,0.3,0.3,56.6,126.1,69.5,0.8,3.5,2.7,2.3,15.8,13.5,11,44.1,33.1,290,256.2,-33.8,0.1,1.2,1.1,1.3,4.2,2.9,1.8,2.5,0.7,1,7.7,6.7,0.2,0.3,0.1,0.6,2.1,1.5,1.7,6.9,5.2,0.7,3.1,2.4,0.4,2.7,2.3,3.7,17.2,13.5,80.8,39.7,-41.1,55.7,40.6,-15.1,,,,,,,43.9,20.3,-23.6,0.1,5.8,5.7,0.1,2.5,2.4,374.4,402.7,28.3,1057.5,376.3,-681.2,7.7,10.3,2.6,6.9,19.1,12.2,0,0.9,0.9,214.6,104.9,-109.7,109.6,149.1,39.5,20.5,12.7,-7.8,253.3,309,55.7,716,879.4,163.4,3.9,69.1,65.2,14.7,35.9,21.2,183.8,333.8,150,0,0,0,21.5,16.2,-5.3,635.8,268.1,-367.7,0,0,0,399.6,117.6,-282,211.2,127,-84.2,0.9,0.1,-0.8,268.7,185.1,-83.6,2469.7,3346.3,876.6,393.5,341.8,-51.7,543.8,1230.8,687,565.9,1003.5,437.6,17.8,16.1,-1.7,0,1.8,1.8,0.6,0.1,-0.5,1490.8,1252.3,-238.5,3225.2,1963.7,-1261.5,174.2,165.3,-8.89999999999998,0,0,0,36.9,38.2,1.3,8,3.3,-4.7,49,28.8,-20.2,6.9,0.2,-6.7,663.1,769.3,106.2,5.7,2.2,-3.5,4.2,8.6,4.4,2.4,3.1,0.7,49.8,73.1,23.3,0,0,0,339.5,277.2,-62.3,4.2,3.6,-0.6,30.2,55.3,25.1,0,0.2,0.2,0.3,0.6,0.3,0.3,4.6,4.3,15.5,6.9,-8.6,0.5,3.9,3.4,0.8,0.6,-0.2,5.3,1.8,-3.5,0,26.7,26.7,5,5.6,0.6,371.4,428.2,56.8,81.8,72.9,-8.89999999999999,0.7,0.1,-0.6,12.2,6,-6.2,0,0.1,0.1,0,0,0,1465.5,871.4,-594.1,0,0,0,6.4,15.1,8.7,30.7,13.8,-16.9,0.6,2.5,1.9,11.3,1.3,-10,0.1,2.7,2.6,,,,,,,,,,0.3,0.7,0.4,41.9,94.9,53,16.3,32.3,16,6.9,13.2,6.3,162.5,257.4,94.9,1.1,18.1,17,1.6,30.3,28.7,2.3,57,54.7,0,0,0,0,0.1,0.1,0,0,0,0,0,0,0,0,0,1.9,32.1,30.2,94.7,100.9,6.2,0,0,0,910,564.8,-345.2,5,14.3,9.3,38.7,170.9,132.2,0.2,22.2,22,10.2,19,8.8,15.2,27.9,12.7,0.1,8.6,8.5,513.6,241.8,-271.8,99,47.1,-51.9,12.3,1,-11.3,55.4,20,-35.4,109.8,19.2,-90.6,7.3,1.1,-6.2,889.8,678,-211.8,29.7,32.8,3.1,0.9,0.2,-0.7,0.6,1.4,0.8,1425.8,687.4,-738.4,1698.6,1339.6,-359,629.8,385.8,-244,,,,2.8,86.9,84.1,568.6,617.2,48.6,51.4,2,-49.4,0,0,0,1.1,0.1,-1,3247.9,841.3,-2406.6,1.3,0.6,-0.7,0,0.4,0.4,1919.2,2144.2,225,669.4,1125.9,456.5,2303.9,1613.4,-690.5,9913.3,5439.6,-4473.7,277.1,952.2,675.1,0,0,0,0,0,0,0.2,0.2,0,0,0,0,1.9,6.2,4.3,131.6,146.1,14.5,0,0,0,0,0.1,0.1,0,2.3,2.3,0.1,0.5,0.4,0.1,0.2,0.1,0.2,0.1,-0.1,0,0,0,0.1,0.6,0.5,0,0,0,4,3.3,-0.7,0,0,0,0.6,7.3,6.7,0.2,1.5,1.3,0.4,2.6,2.2,1.2,2.1,0.9,0.2,0,-0.2,5,2.4,-2.6,0.2,0.6,0.4,17.2,37.3,20.1,169.9,29.5,-140.4,2,7.4,5.4,0,0,0,80.9,223.2,142.3,2.7,6.1,3.4,,,,0,0,0,6.2,2.1,-4.1,0.1,2.2,2.1,1.4,6,4.6,0.5,2.3,1.8,0.2,0.5,0.3,10.8,5.7,-5.1,1.2,4.8,3.6,55.7,15.4,-40.3,9.9,12.1,2.2,0.1,0.2,0.1,0.1,1.2,1.1,0.3,0.7,0.4,484.2,60.1,-424.1,0,0.3,0.3,165.1,5,-160.1,0.2,0.8,0.6,0,0,0,0,1.1,1.1,0.2,1.3,1.1,224.4,14.2,-210.2,2.9,4.7,1.8,0,0.6,0.6,0,1.7,1.7,0.1,0,-0.1,0.1,5.1,5,27.3,7.1,-20.2,0,0.4,0.4,3.7,4.3,0.6,0,1.2,1.2,0,0,0,0,1.6,1.6,0,0.5,0.5,1.9,1.7,-0.2,9.3,6.7,-2.6,0.3,0.2,-0.1,0.2,0,-0.2,1.4,3.8,2.4,17.5,1.2,-16.3,0.8,1.3,0.5,2.5,1,-1.5,,,,0.8,0,-0.8,0,0.2,0.2,0,0,0,239.4,242.6,3.19999999999999,0.6,1.3,0.7,1.9,1.8,-0.0999999999999999,2.9,1.8,-1.1,1,0.1,-0.9,14.6,3.8,-10.8,1.7,0.7,-1,3.7,0,-3.7,0,95.3,95.3,0,0,0
1996-05-01,3896.4,1777,-2119.4,,,,66464,52012,-14452,4689.5,0,-4689.5,7454.1,4237.1,-3217,10441,12843,2402,6932.7,6529.7,-403,4325.4,4396.4,71,20168.9,16196.2,-3972.7,,,,,,,23162.2,16086,-7076.2,66856.9,53358.9,-13498,25982,17314.1,-8667.9,,,,485.4,1282.8,797.4,1423.4,475,-948.4,0.2,0.8,0.6,13749.4,11455.8,-2293.6,0,0,0,6419.5,4740.4,-1679.1,150.7,132.3,-18.4,5.9,10.9,5,74.3,81.2,6.90000000000001,150.4,119,-31.4,29.1,17.4,-11.7,160.1,156.4,-3.69999999999999,33.8,116.1,82.3,1.4,30.6,29.2,13.8,62.1,48.3,0,0,0,82.9,145.4,62.5,0.3,3.8,3.5,1.1,15.6,14.5,12,50.7,38.7,308.5,294.3,-14.2,0,0.9,0.9,0.7,4.8,4.1,2.2,2.9,0.7,1.1,7.9,6.8,0.7,0.4,-0.3,0.5,4.8,4.3,1.9,8.8,6.9,0.6,4,3.4,0.5,3.5,3,3.3,22.5,19.2,121.7,52.8,-68.9,95.5,50.8,-44.7,,,,,,,53.6,16.6,-37,0.1,4.3,4.2,0.1,4,3.9,350,406.9,56.9,1222.6,465.6,-757,11.4,12.2,0.799999999999999,10.9,17.9,7,0,1.1,1.1,174.8,99,-75.8,86.7,146,59.3,20.9,17.9,-3,195.3,307.9,112.6,723,990.3,267.3,2.4,80.7,78.3,14.4,43.5,29.1,206.2,382.6,176.4,0,0,0,21.9,16,-5.9,643.2,276.6,-366.6,0,0.3,0.3,353,113.2,-239.8,197.5,392.1,194.6,0.7,0.1,-0.6,179.1,140,-39.1,2583.3,3150,566.7,411.6,331.5,-80.1,578.1,1340.4,762.3,575.2,1084.5,509.3,15.4,19.1,3.7,0.1,0.9,0.8,0.4,0.7,0.3,1607,1153.7,-453.3,3422.8,2043.6,-1379.2,187.9,164,-23.9,0,0,0,39.7,34.9,-4.8,7.5,9.9,2.4,51.8,24.9,-26.9,8.3,0.8,-7.5,668,867,199,4.4,1.6,-2.8,1.2,10.1,8.9,4.2,2.3,-1.9,59.9,93.8,33.9,0,0,0,288.3,273.4,-14.9,4.7,3.4,-1.3,39.2,26.6,-12.6,0,13.9,13.9,0.2,1.3,1.1,0.3,2.5,2.2,29.1,6.2,-22.9,0.4,6.3,5.9,0.9,0.7,-0.2,5,0.4,-4.6,0,0.6,0.6,11,13.5,2.5,360,499,139,81.6,71.4,-10.2,1.4,0.1,-1.3,16.5,12.2,-4.3,0,0.1,0.1,0,0,0,1476.2,755.8,-720.4,0,0,0,5.8,8.2,2.4,23.1,8.8,-14.3,1.3,0.9,-0.4,5.5,1.1,-4.4,1.3,8.9,7.6,,,,,,,,,,0.6,1.4,0.8,26.8,61.5,34.7,10.2,9.2,-1,5.7,7.3,1.6,140.3,227.4,87.1,1.6,20.9,19.3,1.7,20,18.3,2.6,34.9,32.3,0,0,0,0,0.1,0.1,0,0,0,0,0,0,0,0.1,0.1,1.8,28.1,26.3,154.3,174.7,20.4,0,0,0,910.6,560.9,-349.7,5.6,17.9,12.3,47.4,161.7,114.3,0.3,5.4,5.1,9.6,17.9,8.3,7,18.1,11.1,0.1,1,0.9,474.2,256.7,-217.5,98.6,61.8,-36.8,11.3,0.4,-10.9,93.7,11.4,-82.3,87.7,21.7,-66,6.5,0.8,-5.7,817,535.4,-281.6,26.8,32.8,6,1.3,0.1,-1.2,0.4,1.5,1.1,1443.1,692.5,-750.6,1713,1348.6,-364.4,592.9,289.7,-303.2,,,,2.9,9.8,6.9,614.6,517.5,-97.1,65.2,2,-63.2,0,0,0,0.6,0.2,-0.4,3954.3,881.6,-3072.7,1.9,0.2,-1.7,0,0,0,1937.3,2194.8,257.5,806,1267.1,461.1,2476.4,1719.2,-757.2,9081.8,5903.4,-3178.4,303.2,1098.6,795.4,0,0.1,0.1,0,0,0,0,0,0,0,0,0,14,6.1,-7.9,157.5,155.1,-2.40000000000001,0,0.1,0.1,0.2,0,-0.2,0,2.6,2.6,0.1,1.2,1.1,0.1,0.3,0.2,0,0.1,0.1,0,0,0,0.1,0.3,0.2,0,0,0,3.3,2,-1.3,0,0,0,1.7,7,5.3,0.1,2,1.9,0.2,2.9,2.7,0.7,1.2,0.5,0,0,0,4,2.8,-1.2,0.2,0.4,0.2,23.9,36.2,12.3,240.3,46.3,-194,1.9,13.5,11.6,0,0,0,46,200.7,154.7,3.5,2.7,-0.8,,,,0,0,0,7.2,1.7,-5.5,0,2.6,2.6,4.2,8.2,4,0.2,4.5,4.3,0.5,2.8,2.3,22.5,9.3,-13.2,2.8,3.1,0.3,14.6,10.9,-3.7,19.7,25.5,5.8,0.3,0.3,0,0,1,1,0.1,3.1,3,551.6,56.7,-494.9,0,0.4,0.4,171.2,3.5,-167.7,1.6,0.1,-1.5,0,0,0,0.1,1.2,1.1,4.5,2.2,-2.3,277.9,19.6,-258.3,39.5,7.2,-32.3,0,0.1,0.1,0.1,0.3,0.2,0,0,0,0.1,5.2,5.1,18.6,4.9,-13.7,0.5,0.3,-0.2,0.9,12.3,11.4,0,0,0,0,0,0,0,0.2,0.2,0,0.6,0.6,3.8,1.7,-2.1,8.8,6.7,-2.1,0.1,0.4,0.3,0.3,0,-0.3,1.2,5,3.8,14.7,1.4,-13.3,1.2,0.8,-0.4,2.6,1.1,-1.5,,,,0.4,0,-0.4,0,0.4,0.4,0,0,0,215.2,235.7,20.5,4.6,1.1,-3.5,3.2,1.3,-1.9,5.9,4.7,-1.2,2.6,0.1,-2.5,6.6,12.9,6.3,3,0.9,-2.1,5,0.1,-4.9,0,81.5,81.5,0,0,0
1996-06-01,3401.3,1886.2,-1515.1,,,,66087,52114,-13973,4576.4,0,-4576.4,7490.7,4356.3,-3134.4,10540,13207,2667,6500.5,6459.9,-40.6000000000004,3924.7,4403.8,479.1,19645.3,15880.7,-3764.6,,,,,,,22762.8,15418.7,-7344.1,64195.8,51821.5,-12374.3,25536.8,17074.5,-8462.3,,,,456.6,1111.5,654.9,1172.5,480.4,-692.1,0.5,0.4,-0.1,13479.2,11320.3,-2158.9,0.1,0.2,0.1,6166.1,4560.4,-1605.7,139.5,136.8,-2.69999999999999,4.8,5.9,1.1,75.1,74.4,-0.699999999999989,148.6,144.4,-4.19999999999999,35.1,18.5,-16.6,151.8,155.7,3.89999999999998,29.1,109.3,80.2,1.4,23.9,22.5,11.7,70.9,59.2,0,3.9,3.9,59.3,121.4,62.1,0.3,4,3.7,2.2,16.9,14.7,11.8,32.8,21,306.6,237.3,-69.3,0,0.7,0.7,0.4,4.8,4.4,2.1,3.3,1.2,0.7,6,5.3,0.3,0.5,0.2,0.8,3.1,2.3,3,5.6,2.6,0.4,4.5,4.1,0.3,2.8,2.5,3.8,18.8,15,99,67.1,-31.9,23.4,39.3,15.9,,,,,,,53.5,16.3,-37.2,0.1,4.7,4.6,0,3.2,3.2,334.9,395.3,60.4,989.5,392.5,-597,8.3,10.2,1.9,8.6,19.3,10.7,1.5,0.9,-0.6,165.4,94.3,-71.1,92.8,163.2,70.4,14,19,5,181.3,295.9,114.6,737.1,1116.1,379,2.5,75.8,73.3,16.1,45.4,29.3,207.1,439.1,232,0.5,0,-0.5,14.2,18.8,4.6,592.6,250.9,-341.7,0,0.1,0.1,369.6,145.8,-223.8,179,317,138,0.5,0,-0.5,165.3,121.8,-43.5,2363.7,2708.4,344.7,388.5,247.2,-141.3,533.2,1377.2,844,547.7,1000.1,452.4,17.1,30,12.9,0,1.6,1.6,0.4,0.2,-0.2,1559.7,1156.9,-402.8,2969.5,1927.2,-1042.3,177.7,156.6,-21.1,0,0,0,39.5,44.9,5.4,9,5.5,-3.5,46.5,24.7,-21.8,5.5,0.2,-5.3,633.4,907.7,274.3,3.9,1.9,-2,0.6,17.8,17.2,1.2,6.7,5.5,47.9,64.7,16.8,0,0,0,253.9,237.5,-16.4,4.2,1.8,-2.4,47.9,21.3,-26.6,0.3,8.8,8.5,0.3,3.6,3.3,0.5,1.2,0.7,19.6,8.6,-11,0.6,3.6,3,3.7,0.7,-3,3,0.2,-2.8,0,0.7,0.7,26.3,13.9,-12.4,327.6,432.4,104.8,84,75.6,-8.40000000000001,0.2,0.1,-0.1,15.4,11.6,-3.8,0,0.3,0.3,0.1,0,-0.1,1536.3,733.6,-802.7,0,0,0,3.2,7.6,4.4,24.9,9,-15.9,0.8,9.4,8.6,10,1.5,-8.5,0.7,5,4.3,,,,,,,,,,0.3,0.8,0.5,32.5,78.3,45.8,24.1,14.7,-9.4,4.7,14.4,9.7,119.9,201.7,81.8,0.6,36.8,36.2,0.5,15.9,15.4,2.2,41.8,39.6,0,0,0,0,0,0,0,0,0,0,0,0,0,0,0,3.3,30.4,27.1,211.5,261.7,50.2,0,0,0,635.4,449.4,-186,23.2,18.4,-4.8,40.4,309.8,269.4,0,8.8,8.8,98.9,19.2,-79.7,10.5,11.7,1.2,10.8,0.6,-10.2,445.9,228.9,-217,98.8,60,-38.8,10.2,0.3,-9.9,84.5,21.7,-62.8,95.2,10.7,-84.5,7,1.6,-5.4,899.6,664.2,-235.4,34.2,31.8,-2.4,1.8,0.5,-1.3,0.1,0.8,0.7,1348.3,648.7,-699.6,1611.2,1540,-71.2,679,326.8,-352.2,,,,3.1,10.7,7.6,655,467,-188,64.6,2.3,-62.3,0,0,0,0.8,0.1,-0.7,4111.2,771.6,-3339.6,2.7,0.6,-2.1,0,0,0,1659.8,2260.1,600.3,762.6,1227.9,465.3,2466.9,1431.9,-1035,8963.8,5644.3,-3319.5,301.7,945.6,643.9,0,0,0,0,0.1,0.1,0.1,0.1,0,0,0,0,7.3,3.6,-3.7,128.2,138.2,10,0,0,0,0.9,0,-0.9,0,3.4,3.4,0,0.8,0.8,0.1,0.1,0,0,0.1,0.1,0,0,0,0.2,0.1,-0.1,0,0,0,6.4,1.7,-4.7,0,0,0,0.3,7,6.7,1.8,2.9,1.1,1.4,2.3,0.9,0.5,3.1,2.6,0,0,0,7.5,1.5,-6,0.2,0.9,0.7,24.4,31.2,6.8,171.1,76.2,-94.9,4.2,13,8.8,0,0,0,47.4,215.6,168.2,1.3,6.1,4.8,,,,0,0,0,0,1.4,1.4,1.4,0.6,-0.8,2.3,6.8,4.5,0.3,4.2,3.9,0.1,1.9,1.8,9.3,7.1,-2.2,1.8,1.2,-0.6,6.3,8.6,2.3,16.4,13.8,-2.6,0.2,1.6,1.4,0,1.6,1.6,0.2,0.5,0.3,523,47.1,-475.9,0,0.2,0.2,128.3,4.2,-124.1,0.2,0.1,-0.1,0,0,0,0.8,0.5,-0.3,0.2,1.4,1.2,214.1,17.3,-196.8,18.6,6,-12.6,0,0,0,0,1.4,1.4,0,0,0,0.4,0.3,-0.1,20.8,4.8,-16,0,0.3,0.3,0.1,0.3,0.2,0,0.9,0.9,0,0,0,0.1,0.2,0.1,0,0.7,0.7,2.5,2.2,-0.3,7.1,9.4,2.3,0.3,0.5,0.2,0.4,0,-0.4,1.6,5.2,3.6,17.4,1.3,-16.1,1.3,0.7,-0.6,3.3,1.5,-1.8,,,,0.3,0,-0.3,0,0.3,0.3,0,0.1,0.1,165.4,285.9,120.5,1,0.9,-0.1,2,0.5,-1.5,6.9,5,-1.9,1.4,0.3,-1.1,3.6,13.6,10,4.7,1.2,-3.5,5.3,1.5,-3.8,0,65,65,0,0,0
1996-07-01,4089.6,2124.1,-1965.5,,,,66253,51330,-14923,4356.6,0,-4356.6,6255.1,4154.8,-2100.3,10649,11817,1168,7112.7,5928.2,-1184.5,4341,4462.5,121.5,17635.9,14213.7,-3422.2,,,,,,,25242.9,14881.8,-10361.1,67681.5000000001,47597.3,-20084.2000000001,28635.6,16609.6,-12026,,,,487.5,1117,629.5,1492.8,459.3,-1033.5,1.2,0.3,-0.9,11595.4,9646.6,-1948.8,0.1,0.6,0.5,6040.5,4567.1,-1473.4,150,134.3,-15.7,4.8,8.8,4,84.8,94.7,9.90000000000001,167.3,148.1,-19.2,36.2,25.4,-10.8,178.3,131.9,-46.4,33.4,109.7,76.3,1.4,22.2,20.8,10.1,59.9,49.8,0,0.5,0.5,81.5,110,28.5,0.4,3.4,3,2.2,18.4,16.2,14.2,34.5,20.3,353.5,270.8,-82.7,0,0.6,0.6,0.7,4.3,3.6,2.2,3.1,0.9,0.8,6.3,5.5,0.3,0.8,0.5,0.8,2.2,1.4,2.1,5.1,3,0.5,4,3.5,0.2,3.1,2.9,3.7,19.2,15.5,133,56.6,-76.4,55.6,43.3,-12.3,,,,,,,47.1,15.1,-32,0.1,5.4,5.3,0,3.1,3.1,385.5,377.4,-8.10000000000002,1160.1,378.1,-782,8.9,13.5,4.6,6.6,15.8,9.2,0,78.3,78.3,159.1,104.4,-54.7,135.7,151.3,15.6,20.6,18.7,-1.9,171.8,403.4,231.6,728.6,1033.3,304.7,3.4,117.4,114,19.7,38.7,19,175.8,387.4,211.6,0,0,0,18.5,15.1,-3.4,628.6,221.3,-407.3,0.2,0,-0.2,398.4,125,-273.4,254.4,282.6,28.2,0.4,1.1,0.7,197.9,123.7,-74.2,2474.7,2154.8,-319.9,381.2,224.7,-156.5,559.7,1024.7,465,681.6,889.5,207.9,23.2,14.8,-8.4,0,1.3,1.3,1.1,0.2,-0.9,1620.8,952.5,-668.3,3613.2,1661.7,-1951.5,193.4,141.1,-52.3,0,0,0,43.7,25,-18.7,9.1,4.7,-4.4,53.7,22.6,-31.1,8.2,1.1,-7.1,653.7,653.3,-0.400000000000091,3.4,5.1,1.7,0.6,8.6,8,2.8,1.8,-1,52.6,97.7,45.1,0,0,0,232.2,232.1,-0.0999999999999943,5.3,2.7,-2.6,36.2,20.8,-15.4,0.1,0.4,0.3,0.8,15.8,15,0.8,2.2,1.4,3.2,5.2,2,0.4,3.8,3.4,4.2,0.5,-3.7,1.8,3.9,2.1,0,4.1,4.1,30.9,8.5,-22.4,403.4,363.2,-40.2,111.2,53.7,-57.5,0.3,0.1,-0.2,16.5,9.5,-7,0,0.5,0.5,0,0,0,1785.3,601.9,-1183.4,0,0,0,4.4,5.6,1.2,25.2,8.3,-16.9,1.1,0.4,-0.7,13.7,0.4,-13.3,1.2,4.5,3.3,,,,,,,,,,0.6,0.5,-0.1,45.8,64.5,18.7,24.9,13,-11.9,11.9,24.7,12.8,148.1,192,43.9,1.4,11.5,10.1,1.3,14.6,13.3,1.9,63.7,61.8,0,0,0,0,0,0,0,0,0,0,0,0,0,0,0,2.2,18.2,16,160.2,186.7,26.5,0,0,0,916.2,786.6,-129.6,10.2,19.2,9,38.3,342.1,303.8,0.3,12.9,12.6,50,13.3,-36.7,11,15.8,4.8,0.6,0.6,0,564,259.4,-304.6,120.3,81.7,-38.6,11.9,0.5,-11.4,137.8,12.6,-125.2,138.5,9.9,-128.6,10.6,1.6,-9,1003.5,504.6,-498.9,13.8,27.7,13.9,1.5,0.3,-1.2,0.1,1.5,1.4,1499.9,677.4,-822.5,1695,1437.4,-257.6,750.8,280.5,-470.3,,,,3.6,9.3,5.7,725.7,460.4,-265.3,85.9,1.5,-84.4,0,0,0,0.9,0.1,-0.8,4816.7,998.2,-3818.5,3.2,0.5,-2.7,0,0,0,1816.3,2053.3,237,953,997.3,44.3,2648.4,1440.2,-1208.2,9781.1,5431.9,-4349.2,315.2,950.1,634.9,0,0.1,0.1,0,0,0,0,0,0,0,0,0,14.8,4.6,-10.2,136.4,139.7,3.29999999999998,0,0,0,0.3,0,-0.3,0,2.1,2.1,0.1,1.6,1.5,0.1,0.2,0.1,0,0.1,0.1,0,0,0,0.1,0,-0.1,0,0,0,4.8,2.3,-2.5,0,0,0,6.5,8.4,1.9,0.8,2.1,1.3,0.5,1.7,1.2,1.4,1.6,0.2,0,0,0,6.3,1.9,-4.4,0.2,0.5,0.3,22.3,42.4,20.1,198.3,51,-147.3,1.8,14.1,12.3,0,0,0,78.8,293.2,214.4,0.9,9.7,8.8,,,,0,0,0,10.5,1.4,-9.1,0,0.6,0.6,2.9,6.6,3.7,1.1,3.5,2.4,2.1,1,-1.1,8.8,3.9,-4.9,1.3,4.2,2.9,29.5,7.2,-22.3,16.2,22.4,6.2,0.3,0.2,-0.1,0.1,2.3,2.2,0.1,0.8,0.7,667,74.8,-592.2,0.1,0.2,0.1,188.4,5.1,-183.3,0.8,0.1,-0.7,0,0.1,0.1,2.9,0.3,-2.6,0.2,2,1.8,203.9,12.8,-191.1,26.6,3.1,-23.5,0,0,0,0,0.5,0.5,0,0,0,0.1,1.2,1.1,18.8,4.7,-14.1,0.6,0.3,-0.3,0,0.2,0.2,0,0.1,0.1,0,0,0,0,0.3,0.3,0,0.4,0.4,3.2,1.2,-2,10.2,7.5,-2.7,0.1,0.4,0.3,0.2,0,-0.2,1.6,4.4,2.8,19.2,2.3,-16.9,2.2,0.9,-1.3,2.2,1.1,-1.1,,,,0,0,0,0,0.3,0.3,0,0.1,0.1,222.8,249.8,27,1.1,0.8,-0.3,2.3,1.4,-0.9,9.6,2.7,-6.9,2.4,0.4,-2,16.4,4.7,-11.7,8.3,1,-7.3,6,0.1,-5.9,0,24.8,24.8,0,0,0
1996-08-01,3835.3,1935.6,-1899.7,,,,67329,52521,-14808,4795.7,0,-4795.7,7212.4,4229.7,-2982.7,10541,12751,2210,6924.8,6367.9,-556.900000000001,4148.4,4613.9,465.5,19634.8,15765.2,-3869.6,,,,,,,25515.9,15523.6,-9992.3,68025.4,51574.4,-16451,28781.9,17023.5,-11758.4,,,,510.9,1257.4,746.5,1376.2,523.5,-852.7,0.2,0.8,0.6,13163,10935.1,-2227.9,0.1,0.1,0,6471.8,4830.1,-1641.7,137.2,120.5,-16.7,4.1,9.8,5.7,85.6,82.3,-3.3,160.5,140.8,-19.7,31.8,19.9,-11.9,165.3,163.5,-1.80000000000001,35.7,113.5,77.8,0.7,24,23.3,12.1,60.1,48,0,0.1,0.1,73.2,129.4,56.2,1,3.2,2.2,1.5,17.3,15.8,14.7,37.4,22.7,328.2,296.8,-31.4,0,0.9,0.9,0.4,3.6,3.2,1.4,2.8,1.4,1.1,5.7,4.6,0.3,0.6,0.3,0.8,3.2,2.4,1.9,8.6,6.7,0.6,3.6,3,0.2,2.7,2.5,2.3,20.9,18.6,88.3,58.3,-30,52.6,46.2,-6.4,,,,,,,28.4,24.3,-4.1,0.1,4.4,4.3,0.1,2.2,2.1,344.3,385.3,41,1030.3,453,-577.3,8.8,13.4,4.6,6.5,17.4,10.9,0,0.8,0.8,154.6,101.6,-53,102,156.4,54.4,23.5,22.7,-0.800000000000001,162.4,323.4,161,859.4,1238.5,379.1,3.8,63.8,60,17.7,41.7,24,205,389.3,184.3,0,0,0,25.7,21.7,-4,337.9,254,-83.9,0,0,0,343.8,125.2,-218.6,197,173.3,-23.7,0.2,0,-0.2,139.7,122.6,-17.1,2329.4,2620.4,291,377.8,253.3,-124.5,541.5,1321.8,780.3,422.2,1086.8,664.6,18.2,19.2,1,2,1.5,-0.5,1.5,0.1,-1.4,1532.9,1105.7,-427.2,3267.6,1852.9,-1414.7,181.5,146.4,-35.1,0,0,0,41,28.6,-12.4,12,4.4,-7.6,58.5,24.3,-34.2,5,0.3,-4.7,552.7,669.9,117.2,2.3,5.5,3.2,0.7,19.1,18.4,2.5,12,9.5,52.8,69,16.2,0,0,0,356.9,323.1,-33.8,7.9,3.7,-4.2,54.4,39.7,-14.7,0.3,0.7,0.4,0.7,11.2,10.5,0.8,8.9,8.1,11.6,8.5,-3.1,0.2,2.2,2,3.2,0.5,-2.7,0.4,0.2,-0.2,0.1,128.6,128.5,25.5,11.5,-14,334.8,362.2,27.4,103.5,64.1,-39.4,0.5,1.1,0.6,17.2,8.7,-8.5,0,0.3,0.3,0.1,0,-0.1,1680.1,612.6,-1067.5,0,0,0,3.8,10.3,6.5,23.4,6,-17.4,0.9,9,8.1,13.8,1.1,-12.7,1.3,3.5,2.2,,,,,,,,,,1.5,0.5,-1,38.6,46.4,7.8,21.5,32.6,11.1,8.2,8.3,0.100000000000001,140.3,250.9,110.6,1.5,17.2,15.7,1.1,21.4,20.3,2.8,59.5,56.7,0,0,0,0,0,0,0,0,0,0,0,0,0,0,0,2.6,45.4,42.8,178.9,178.2,-0.700000000000017,0,0,0,932,734.1,-197.9,9.5,15.6,6.1,43.2,154.3,111.1,5,31.7,26.7,46.6,22.2,-24.4,9.2,21.8,12.6,1,1.2,0.2,583.8,250.4,-333.4,117.6,119.4,1.80000000000001,8.2,1.1,-7.1,154.5,9.5,-145,124.1,32.9,-91.2,12.9,2.4,-10.5,1007.5,524.1,-483.4,14.7,21.3,6.6,1,0.2,-0.8,0.1,1.9,1.8,1595.7,604.6,-991.1,1698.8,1334.5,-364.3,735.9,280.5,-455.4,,,,6.2,10.6,4.4,732.5,503.1,-229.4,78.4,2.5,-75.9,0,0,0,1.3,0.1,-1.2,5495.7,778.3,-4717.4,3.9,0.1,-3.8,0,0,0,1770.1,2418.9,648.8,889,1214.8,325.8,2566.9,1399.7,-1167.2,9453,5740.8,-3712.2,352.9,1061.8,708.9,0,0.1,0.1,0,0,0,0,0,0,0,0,0,5.2,3.9,-1.3,135.8,169.5,33.7,0.1,0.1,0,0,0,0,0,2.2,2.2,0.1,1,0.9,0.1,0.3,0.2,0,0.1,0.1,0,0,0,0.1,0.1,0,0,0,0,5.9,2,-3.9,0,0,0,0.7,7.9,7.2,0,2,2,2.2,2.6,0.4,1.3,1,-0.3,0,0,0,6.3,2.4,-3.9,0.2,0.4,0.2,24.2,57.7,33.5,202.6,41,-161.6,4.7,26.1,21.4,0,0,0,41.7,320.4,278.7,1.4,0.9,-0.5,,,,0,0,0,0,1.6,1.6,0,1.6,1.6,22.7,4.6,-18.1,0.9,5.2,4.3,0.4,1,0.6,7.3,6.4,-0.899999999999999,1.7,0.8,-0.9,9.1,7,-2.1,12.2,21.9,9.7,0,0.4,0.4,0,2.5,2.5,0.8,2.3,1.5,498.9,74.2,-424.7,0,0.1,0.1,204.1,4.7,-199.4,2.2,0.9,-1.3,0,0,0,0,0.6,0.6,0,1.6,1.6,269.5,25.5,-244,20.2,4.1,-16.1,0,0,0,0,0.3,0.3,0,0,0,0.1,0.4,0.3,38.8,5.4,-33.4,0.1,0.1,0,0.5,4.2,3.7,0,0,0,0,0,0,0,0.1,0.1,0,0.6,0.6,0.7,1.2,0.5,10.7,12.8,2.1,0.3,0.6,0.3,0.3,0.1,-0.2,2,7.7,5.7,16.6,2.8,-13.8,1.8,0.5,-1.3,5.1,0.7,-4.4,,,,0.1,0,-0.1,0,0.1,0.1,0,0,0,203.6,293.8,90.2,1.9,0.6,-1.3,2,1.6,-0.4,8,9.1,1.1,1.9,0.1,-1.8,9.4,7,-2.4,9,1.3,-7.7,8.6,0,-8.6,0,33,33,0,0,0
1996-09-01,4235,1801.4,-2433.6,,,,68080,52264,-15816,4763,0,-4763,7606.1,4519.9,-3086.2,11345,12339,994,7158.7,5825.8,-1332.9,4353.3,4446.4,93.0999999999995,19985.3,16623.1,-3362.2,,,,,,,25497.9,14343.4,-11154.5,68308.8,50598.1,-17710.7,28941.9,15834,-13107.9,,,,459.9,1123.6,663.7,1524.8,525.3,-999.499999999999,0.8,0.1,-0.7,13488.1,11673.1,-1815,0,0.1,0.1,6497.2,4950,-1547.2,138.5,124.5,-14,8.2,7.7,-0.499999999999999,88.7,94.2,5.5,164.5,153.2,-11.3,25.6,25.1,-0.5,168.3,158.3,-10,26.2,115,88.8,0.3,21,20.7,9.6,56.6,47,0,0.1,0.1,75.4,123.8,48.4,0.4,2.8,2.4,1.1,15.6,14.5,13.7,33.7,20,305.7,261.6,-44.1,0,1.1,1.1,0.3,4.4,4.1,1.8,3.2,1.4,1,5.4,4.4,0.3,0.6,0.3,0.9,4.3,3.4,1.6,7.4,5.8,0.6,2.7,2.1,0.4,2,1.6,3.5,19.2,15.7,90,52.7,-37.3,55.9,39.4,-16.5,,,,,,,62.2,15.3,-46.9,0.1,4.7,4.6,0,2.6,2.6,378.5,387.2,8.69999999999999,1262.3,370.8,-891.5,19.9,11.1,-8.8,7.8,12.6,4.8,0,2.5,2.5,149.7,89.7,-60,113.2,166.7,53.5,30.4,23.1,-7.3,143.4,316.6,173.2,732,1202.9,470.9,3,62.2,59.2,18.7,47.7,29,249.6,395.1,145.5,0,0,0,13,18.1,5.1,564.6,268.1,-296.5,0,0,0,336.9,99.8,-237.1,222.3,198.3,-24,0.2,0.1,-0.1,174.6,152.4,-22.2,2245.5,2359.5,114,429.6,303.3,-126.3,553.6,1238.2,684.6,570.4,1051.2,480.8,17.7,19.1,1.4,0,2.7,2.7,0.6,0.3,-0.3,1530.8,1111.9,-418.9,2957.8,1906.6,-1051.2,180.9,165.3,-15.6,0,0,0,41.3,29.7,-11.6,16.2,2.8,-13.4,59,26.6,-32.4,6,0.9,-5.1,637.8,791.8,154,3.4,5.6,2.2,3,15.4,12.4,3,3.4,0.4,51,81.1,30.1,0,0,0,298.8,247.6,-51.2,5.6,7,1.4,27.9,44.8,16.9,0.2,3.6,3.4,0.4,5.4,5,1.1,2.5,1.4,1.3,7.2,5.9,0.3,0.2,-0.1,6.2,0.7,-5.5,3.9,2,-1.9,0,5.5,5.5,37.4,9.4,-28,301.9,373.3,71.4,82.3,58.9,-23.4,0.3,1.5,1.2,15.2,10.1,-5.1,0,0,0,0,0,0,1203.7,613.5,-590.2,0,0,0,5.3,5.9,0.600000000000001,21.2,4.7,-16.5,0.6,14.6,14,9.5,1.3,-8.2,0.6,3.5,2.9,,,,,,,,,,0.2,0.3,0.1,25.3,48.3,23,17.1,24.5,7.4,10.4,7.3,-3.1,126.4,270.6,144.2,1.6,31.2,29.6,1.3,20.7,19.4,1.7,46.8,45.1,0,0,0,0,0,0,0,0,0,0,0,0,0,0,0,2.7,22.9,20.2,105.7,207.6,101.9,0,0,0,1068.2,608.7,-459.5,8,17.7,9.7,38.9,238.4,199.5,7.8,24.5,16.7,70.5,15.5,-55,8.9,24.4,15.5,0.8,0.8,0,590.1,273.4,-316.7,113.7,130.8,17.1,5.9,0.5,-5.4,137.3,21.9,-115.4,127.9,11.6,-116.3,13.7,1,-12.7,1000.2,479.5,-520.7,16.5,19.5,3,0.8,1.2,0.4,0.2,1.6,1.4,1637.9,580.1,-1057.8,1800.9,1249.5,-551.4,714.6,240.4,-474.2,,,,4.3,4.9,0.600000000000001,767.1,474.8,-292.3,83.9,1.9,-82,0,0,0,0.7,0.4,-0.3,5480.7,753.4,-4727.3,3.2,0.1,-3.1,0,0.1,0.1,1724.7,2025,300.3,902.1,1129.4,227.3,2731,1421.9,-1309.1,9205,5358.7,-3846.3,324.8,957.4,632.6,0.3,0.1,-0.2,0,0,0,0,0,0,0,0,0,27.4,5.4,-22,93.5,140.4,46.9,0.1,0,-0.1,0.3,0,-0.3,0,2.8,2.8,0.1,0.8,0.7,0.1,0.1,0,0,0,0,0,0,0,0.1,0.1,0,0,0,0,1.2,2.1,0.9,0,0,0,0.3,7.3,7,0.1,1.7,1.6,1,1.5,0.5,0.7,0.9,0.2,0,0,0,9.7,2.5,-7.2,0.2,0.5,0.3,20,15.8,-4.2,150.1,33.4,-116.7,16.4,23.2,6.8,0,0,0,31.8,268.5,236.7,0.6,4.8,4.2,,,,0,0,0,0,0.7,0.7,0,1,1,2.7,7.8,5.1,0.3,4.7,4.4,0.2,1.6,1.4,6.3,4.9,-1.4,0.9,0.5,-0.4,15.3,14.1,-1.2,12.1,22.1,10,0,0.3,0.3,0,3.8,3.8,0.1,3.2,3.1,648.3,79.4,-568.9,0,0.1,0.1,238.9,4.9,-234,0,0.1,0.1,0,0,0,0,0.4,0.4,0,3.6,3.6,293,17.2,-275.8,11.2,4.2,-7,0,5.6,5.6,0.2,0.4,0.2,0,0,0,0,1.2,1.2,11.8,4.5,-7.3,0,0,0,0,4.1,4.1,0,0.2,0.2,0,0,0,0,0.1,0.1,0,0.2,0.2,0.3,0.8,0.5,11.3,14.6,3.3,1.1,0.9,-0.2,0.6,0,-0.6,1.1,3.4,2.3,32.5,4.3,-28.2,1.3,0.7,-0.6,5.1,0.3,-4.8,,,,0,0,0,0,0.2,0.2,0,0,0,184,284.8,100.8,0.7,1.6,0.9,2.4,1.5,-0.9,5.2,2.2,-3,8.8,0.3,-8.5,13.5,4.2,-9.3,9.8,1.2,-8.6,4.9,0,-4.9,0,46.7,46.7,0,0.1,0.1
1996-10-01,4263,2027,-2236,,,,67423,53474,-13949,5328.7,0,-5328.7,7120.1,5050.4,-2069.7,11590,13946,2356,7504.7,6405.6,-1099.1,4595,4904.5,309.5,20616.7,17747.2,-2869.5,,,,,,,27996.4,16084.4,-11912,74117.3,56107.1,-18010.2,31525.6,17937.3,-13588.3,,,,499.5,1217.8,718.3,1496.8,566.3,-930.499999999999,0.6,0.2,-0.4,13500.7,12120,-1380.7,0.1,0,-0.1,7116,5627.2,-1488.8,137.6,129.9,-7.69999999999999,4.1,9.6,5.5,100.1,97.2,-2.89999999999999,169.8,172.8,3,27.8,29.1,1.3,183.7,161.6,-22.1,31.6,130.1,98.5,0.9,30.1,29.2,13.8,66.3,52.5,0,0.1,0.1,78.9,137.5,58.6,0.3,3.1,2.8,0.7,17,16.3,13.7,46.6,32.9,355.6,305.8,-49.8,0,1.2,1.2,0.6,4.3,3.7,2.3,3.9,1.6,1,6.2,5.2,0.6,0.9,0.3,1,2.3,1.3,1.6,6.5,4.9,1.1,2.8,1.7,0.4,5.3,4.9,3.4,20.7,17.3,177.9,66.8,-111.1,53.4,56.8,3.4,,,,,,,49.5,21.8,-27.7,0.1,6.4,6.3,0.2,2.9,2.7,436.8,447.3,10.5,1313.8,436,-877.8,6.9,12.8,5.9,11.2,15.9,4.7,0.1,56.9,56.8,158,94.4,-63.6,129.7,135.9,6.20000000000002,27.8,24,-3.8,135.7,378.8,243.1,705.9,1237.6,531.7,4.3,70,65.7,19.8,45.3,25.5,233.3,403.9,170.6,0,0.1,0.1,23.3,15.5,-7.8,682.1,312.7,-369.4,0,0,0,377.2,155.5,-221.7,193.3,200,6.69999999999999,1,0.1,-0.9,202.8,197.5,-5.30000000000001,2623.9,2466.8,-157.1,398.8,335.5,-63.3,636,1826.1,1190.1,692.4,1102,409.6,15,19,4,0.1,4,3.9,1.3,0.4,-0.9,1814.8,1346.4,-468.4,3448,2043,-1405,212.2,217.8,5.60000000000002,0,0,0,39.7,43.7,4,8.2,3.7,-4.5,67.3,26.4,-40.9,7.2,0.2,-7,687.1,774.4,87.3,4.8,6.5,1.7,24.5,19.7,-4.8,3.5,7.9,4.4,61.1,80.1,19,0,0,0,393.8,282,-111.8,3.9,1.7,-2.2,55.8,46.9,-8.9,0.1,0.6,0.5,0.4,5,4.6,0.5,10.5,10,9.8,3.3,-6.5,0.1,2.4,2.3,1.7,6.8,5.1,2.8,0.9,-1.9,0.1,19.4,19.3,7,73.9,66.9,419.4,464.6,45.2,90.1,78.2,-11.9,0,0.5,0.5,27.7,8.1,-19.6,0,1.3,1.3,0,0,0,1598,732.9,-865.1,0,0,0,5.7,8.2,2.5,29.9,6.9,-23,1.9,3.1,1.2,10.3,0.8,-9.5,1.5,8.4,6.9,,,,,,,,,,0.5,0.8,0.3,39.8,69.5,29.7,18.8,18.4,-0.400000000000002,9.5,4.9,-4.6,161.4,195.2,33.8,2.2,24.8,22.6,1.3,8.6,7.3,8.7,47.1,38.4,0,0,0,0,0,0,0,0,0,0,0,0,0,0,0,2.1,34.3,32.2,156.7,156,-0.699999999999989,0,0,0,938.9,658,-280.9,7,24.8,17.8,44.8,310.7,265.9,2.5,12.7,10.2,38,15.3,-22.7,9.5,19.5,10,0.6,0.6,0,637.9,387.4,-250.5,120.4,128.3,7.90000000000001,6.8,0.4,-6.4,138.9,24.1,-114.8,121.3,12.2,-109.1,11.6,5.6,-6,1109.7,670.4,-439.3,31.7,29.2,-2.5,1.5,0.2,-1.3,0.6,2.9,2.3,1685.3,867.9,-817.4,1758.5,1309.2,-449.3,897.8,311.2,-586.6,,,,7.1,4.9,-2.2,782.8,569.1,-213.7,85.9,3.5,-82.4,0,0.1,0.1,0.7,0.3,-0.4,5812.9,927.5,-4885.4,3.8,0.6,-3.2,0,0,0,1911.5,2220.8,309.3,1016.6,1391.5,374.9,2818.1,1484.1,-1334,10741.4,5810.4,-4931,364.6,1025.3,660.7,0,0.3,0.3,0,0,0,0,0,0,0,0,0,3.2,6.1,2.9,110.7,152.8,42.1,0.1,0.1,0,0.1,0,-0.1,0,2,2,0.1,0.9,0.8,0.7,0.1,-0.6,0,0,0,0,0,0,0.1,1.2,1.1,0,0,0,6.3,4,-2.3,0,0.1,0.1,1.3,9.2,7.9,0.2,7.2,7,0.7,2.8,2.1,0.9,2,1.1,0,0,0,10,3,-7,0.5,0.7,0.2,17.4,39.4,22,178,56.8,-121.2,10.4,7.5,-2.9,0,0,0,57.9,230.6,172.7,1.8,4,2.2,,,,0,0,0,22,0.6,-21.4,1.3,1.2,-0.1,8.2,9,0.800000000000001,0.6,6.5,5.9,0.4,2,1.6,11,10,-1,2.8,1.6,-1.2,11.3,16.2,4.9,17.5,64.4,46.9,0.4,1.2,0.8,0.2,3.8,3.6,1,1.2,0.2,522.8,66.6,-456.2,0,0.5,0.5,203.1,6.9,-196.2,0.5,0.1,-0.4,0,0.1,0.1,0,0.3,0.3,4.7,2,-2.7,353.1,31.8,-321.3,10.1,4,-6.1,0,0.2,0.2,0,1.1,1.1,0.1,0,-0.1,0,4.3,4.3,23.2,4.6,-18.6,0.3,0,-0.3,0.8,0.3,-0.5,0,0.2,0.2,0,0,0,0.1,0.8,0.7,0,0.5,0.5,0.3,0.6,0.3,9.7,9,-0.699999999999999,0.2,0.9,0.7,0.4,0,-0.4,1.6,3.6,2,27.8,2.9,-24.9,12.3,3.1,-9.2,6,0.3,-5.7,,,,0,0,0,0.1,0.6,0.5,0.5,0,-0.5,193.9,256.5,62.6,5.6,3.2,-2.4,2.9,8.7,5.8,5.1,3.4,-1.7,1.9,0,-1.9,12.7,4.3,-8.4,13.7,1.1,-12.6,3.7,0.3,-3.4,0,113.9,113.9,0,0,0
1996-11-01,3643.1,1949.9,-1693.2,,,,68364,54123,-14241,5068.6,0,-5068.6,7631.4,4621.7,-3009.7,10775,13730,2955,6755.7,6470.4,-285.3,4087.3,4773.2,685.9,20375.8,17260.9,-3114.9,,,,,,,24419.5,16319.7,-8099.8,68015.4000000001,55016.4,-12999.0000000001,27393.7,17958.5,-9435.2,,,,531.6,1210.1,678.5,1304.8,530.6,-774.2,0.3,0.7,0.4,13772.6,12144.9,-1627.7,0,0.1,0.1,6603.2,5116,-1487.2,126,145.4,19.4,6.4,9.4,3,80.5,98.5,18,152.9,164.5,11.6,30.1,23.2,-6.9,175.3,162.8,-12.5,29.6,124.6,95,0.5,24,23.5,12.5,55.3,42.8,0,0.2,0.2,61.7,122.4,60.7,0.4,4.7,4.3,1.2,22.8,21.6,12.2,42.9,30.7,284.4,305,20.6,0,1.3,1.3,0.1,4.8,4.7,2.3,3.7,1.4,0.2,9.6,9.4,0.6,0.9,0.3,0.8,3,2.2,1.5,11.2,9.7,0.5,4.4,3.9,0.3,4.3,4,3.9,20.6,16.7,125.7,59.8,-65.9,77.2,47.1,-30.1,,,,,,,39.8,29.8,-10,0.3,5.4,5.1,0,3.9,3.9,384.3,386.3,2,1107.8,439.6,-668.2,9.3,11.2,1.9,8.9,17.1,8.2,0,3.2,3.2,135,104.2,-30.8,94.8,137.5,42.7,31.8,24.1,-7.7,162.4,356.3,193.9,746.8,1244,497.2,4.9,70.9,66,22.6,42.7,20.1,151.8,420.6,268.8,0,0,0,16.6,17.8,1.2,639,378.5,-260.5,0,0,0,323.4,190.9,-132.5,188.8,224.3,35.5,0.7,0,-0.7,170.7,166.3,-4.39999999999998,2365.9,2409.9,44,450.2,299.3,-150.9,558,1553.8,995.8,556.1,1067.2,511.1,12.3,21,8.7,0,1.9,1.9,1.1,0.1,-1,1509.4,1316.1,-193.3,3404.3,2086.3,-1318,185.3,172.2,-13.1,0,0,0,49.6,37.6,-12,14,8.7,-5.3,76.7,42.4,-34.3,8.8,1.5,-7.3,696.9,509.8,-187.1,6.4,3.9,-2.5,8.5,28.1,19.6,4.6,6.1,1.5,51.4,120,68.6,0,0,0,330.6,272.3,-58.3,7,3.8,-3.2,65.1,22.9,-42.2,0.1,7.1,7,0.2,4,3.8,0,8.5,8.5,5.7,7.8,2.1,0.3,0.9,0.6,2.1,3.3,1.2,0,2.4,2.4,0,2,2,6.8,117.9,111.1,378.3,465.7,87.4,77.8,97.3,19.5,0,0.1,0.1,26.4,7.5,-18.9,0,0.6,0.6,0,0,0,1537,693.8,-843.2,0,0,0,5.8,6.1,0.3,18.9,14.1,-4.8,0.4,4.7,4.3,7.9,1,-6.9,0.5,3.3,2.8,,,,,,,,,,0.3,0.3,0,43.9,61.2,17.3,42.5,31.2,-11.3,12.7,16.9,4.2,165.9,236.4,70.5,2.6,22.4,19.8,0.5,15.4,14.9,5.4,57.5,52.1,0,0,0,0,0,0,0,0,0,0,0,0,0,0.1,0.1,2,33.3,31.3,167.2,110,-57.2,0,0,0,822.7,709.5,-113.2,7.7,16.1,8.4,32.5,154.6,122.1,5.4,55.4,50,41.1,18.5,-22.6,11.2,17.6,6.4,0.6,0.5,-0.1,478.9,390,-88.9,105.5,123.3,17.8,6.3,0.5,-5.8,86.9,21.9,-65,95.9,17.2,-78.7,8.7,7.7,-0.999999999999999,996.5,466.7,-529.8,43.2,23.2,-20,1.7,0.1,-1.6,0.9,2.4,1.5,1496.1,792.4,-703.7,1601.4,1392.9,-208.5,715,339.2,-375.8,,,,4,5,1,655.3,574.5,-80.8,71.2,2.6,-68.6,0,0,0,0.8,0.6,-0.2,4585.4,1586.4,-2999,2.2,0.5,-1.7,0,0,0,1826.2,2268.7,442.5,834.8,1196.9,362.1,2493.3,1611.9,-881.4,9619.8,5371.6,-4248.2,407.3,1019.2,611.9,0.5,0.1,-0.4,0,0,0,0,0,0,0,0,0,2.3,7.5,5.2,107.5,150.9,43.4,0.1,0.2,0.1,0.1,0,-0.1,0,2.8,2.8,0.1,1.1,1,0.1,5.6,5.5,0.1,0,-0.1,0,0,0,0.1,0.7,0.6,0,0,0,6.6,3.9,-2.7,0,0,0,0.9,8.2,7.3,0.1,3,2.9,0.5,2.1,1.6,0.1,1.2,1.1,0,0,0,4.8,2.8,-2,0.4,0.8,0.4,19.6,29.3,9.7,184.2,55.5,-128.7,15.9,17.9,2,0,0,0,64.7,286.7,222,0.9,3.2,2.3,,,,0,0,0,0.1,1.5,1.4,0,1.2,1.2,2,4,2,0.2,3.3,3.1,0.2,1.1,0.9,6.4,6.4,0,2.3,1.6,-0.7,4.5,16.2,11.7,11.3,22.6,11.3,0.1,1,0.9,0,2.1,2.1,0,1.3,1.3,413.9,122,-291.9,0,0.1,0.1,192,3.6,-188.4,0.3,0,-0.3,0,0,0,0,0.2,0.2,0,2.3,2.3,288.9,21.7,-267.2,76.3,5.8,-70.5,0,0.1,0.1,0,0.2,0.2,0,0,0,0,7.3,7.3,18.9,3.5,-15.4,0,0,0,0.6,2,1.4,0,0.1,0.1,0,0,0,0.1,6.4,6.3,0,0.3,0.3,0.3,0.8,0.5,5.9,5.7,-0.2,0.1,1.7,1.6,0,0,0,1.3,3.5,2.2,11.5,2,-9.5,1.3,2.4,1.1,3,1.4,-1.6,,,,0,0,0,0,0.3,0.3,0,0,0,226.4,222.4,-4,2.1,4.1,2,1.9,2.3,0.4,5,1.5,-3.5,2.1,0.2,-1.9,14.6,6.2,-8.4,3,2,-1,3.8,0.5,-3.3,0,113.4,113.4,0,0,0
1996-12-01,4313.1,2038,-2275.1,,,,69681,53087,-16594,4657,0,-4657,6916.2,3979.1,-2937.1,11746,14374,2628,6881.7,6895.8,14.1000000000004,4673.6,4745.4,71.7999999999993,18827.5,15343.5,-3484,,,,,,,23966.9,16477.3,-7489.6,67569.9,53295.8,-14274.1,27268.6,18560.6,-8708,,,,524.9,1102.7,577.8,1225.4,567.4,-658,0.6,0.3,-0.3,12728.5,10302.2,-2426.3,0.1,0,-0.1,6099,5041.3,-1057.7,147.6,131.1,-16.5,3.8,10.8,7,85.8,91.7,5.90000000000001,173.4,143.3,-30.1,31.4,23.4,-8,179.4,152.1,-27.3,25.9,110.4,84.5,0.4,19.5,19.1,17.3,58.8,41.5,0,0,0,66.5,120.2,53.7,0.3,4.3,4,1.2,24.7,23.5,13.9,34.6,20.7,312.5,247.2,-65.3,0,1.4,1.4,0.4,5.7,5.3,1.4,3.5,2.1,0.6,7.4,6.8,0.5,1,0.5,0.4,2.1,1.7,1.7,6.6,4.9,0.5,3.5,3,0.2,1.7,1.5,5.5,18.9,13.4,116.5,73.9,-42.6,72,38,-34,,,,,,,67.7,16.8,-50.9,0.3,8.2,7.9,0.1,3,2.9,429.3,371.7,-57.6,1356.8,358.9,-997.9,7.5,11.3,3.8,5.8,13.2,7.4,0.1,152.9,152.8,182.4,134.6,-47.8,126.6,157,30.4,23.2,58.8,35.6,228.7,491.9,263.2,764.4,1147.1,382.7,4.7,63.3,58.6,25.1,40.9,15.8,191.8,380,188.2,0,0,0,19.6,15.3,-4.3,658.1,360.3,-297.8,0,0.4,0.4,267.9,117.9,-150,202.8,192.6,-10.2,1.3,0.1,-1.2,167.4,132.3,-35.1,2795.4,2310.2,-485.2,406.5,354.9,-51.6,553.1,1533.2,980.1,561.6,1134.2,572.6,20,22.6,2.6,0,2.6,2.6,1.6,0.1,-1.5,1653.1,1321.7,-331.4,3554.5,2006.5,-1548,187,184.1,-2.90000000000001,0,0,0,39.8,35.7,-4.09999999999999,18.9,5.3,-13.6,77.8,27.1,-50.7,8.1,0.5,-7.6,640.5,483.7,-156.8,12,1.7,-10.3,46.4,11.3,-35.1,4.8,6.1,1.3,52.2,78.3,26.1,0,0,0,430.1,272.3,-157.8,3.5,6.2,2.7,38.5,39.4,0.899999999999999,0.3,9,8.7,0.1,2.9,2.8,0.2,10.9,10.7,8.6,4.1,-4.5,0.1,3.1,3,5.1,5.9,0.800000000000001,0,3.5,3.5,0,2.3,2.3,1,10.5,9.5,381.3,484.3,103,81.7,84.6,2.89999999999999,0.3,0.3,0,25,7.1,-17.9,0,0.7,0.7,0,0.1,0.1,1559.9,729.8,-830.1,0,0,0,5.8,10.6,4.8,21,11.5,-9.5,1.3,3.4,2.1,8.5,0.7,-7.8,0.7,2.9,2.2,,,,,,,,,,0.2,0.2,0,52.2,64.4,12.2,24.4,26.2,1.8,20.3,10.7,-9.6,156.2,273.8,117.6,1.7,26.1,24.4,0.7,22.5,21.8,3.9,35.5,31.6,0,2.8,2.8,0,0,0,0,0,0,0,0,0,0,0,0,1.7,22.3,20.6,194.7,264.9,70.2,0,0,0,1265.4,578.3,-687.1,9.1,19.4,10.3,57.9,177.6,119.7,9.2,39.2,30,12.1,25.4,13.3,8.7,22.7,14,0.2,0.7,0.5,426.4,240.2,-186.2,96.4,242.2,145.8,7.6,1.3,-6.3,97.4,19.5,-77.9,116.4,12.2,-104.2,9.4,5.1,-4.3,930.8,872.8,-58,24.2,33,8.8,0.6,0.4,-0.2,0.5,2.6,2.1,1468.6,733.4,-735.2,1704,1341.1,-362.9,722.2,530.7,-191.5,,,,2,10.1,8.1,704.1,539.4,-164.7,71.8,2.8,-69,0,0,0,0.7,0.1,-0.6,3947,1285.7,-2661.3,2.4,0.2,-2.2,0,0,0,1886.6,2476.4,589.8,758.2,1257.4,499.2,2532.9,1820.9,-712,9657.1,5397.5,-4259.6,395.7,943.3,547.6,0,0,0,0.4,0,-0.4,0,0,0,0,0,0,2.2,6.5,4.3,114.6,132,17.4,0.1,0.2,0.1,0.2,0,-0.2,0.3,4,3.7,0.1,1.5,1.4,0.1,0,-0.1,0,0.1,0.1,0,0,0,0.1,0.6,0.5,0,0,0,1.3,2.1,0.8,0,0,0,3,7.4,4.4,0.1,0.7,0.6,0.9,1.8,0.9,0.6,0.8,0.2,0,0,0,4.9,1.2,-3.7,0.3,0.5,0.2,21.2,41.4,20.2,186.6,57.5,-129.1,9.6,7.6,-2,0,0,0,51.2,369.5,318.3,0.3,4.4,4.1,,,,0,0.1,0.1,20.1,0.8,-19.3,0,2.3,2.3,2.6,5.6,3,0.2,5.4,5.2,0.2,1.5,1.3,6.4,2.8,-3.6,1.3,4.8,3.5,49.3,12.5,-36.8,10.5,30.2,19.7,0.1,1,0.9,0.1,3.1,3,0,2.4,2.4,348.6,46.1,-302.5,0.1,1,0.9,171.6,1.9,-169.7,0.1,0.1,0,1.7,0,-1.7,0,1.4,1.4,0,6.3,6.3,287,23,-264,43.5,11.5,-32,0,0.1,0.1,0,1.7,1.7,0,0,0,0.4,5.7,5.3,30.3,2.9,-27.4,0,0,0,0.9,3,2.1,0.1,0.1,0,0,0,0,0,0.6,0.6,0,0.5,0.5,1.7,1.8,0.1,7.5,5.9,-1.6,0.1,96.3,96.2,0.5,0,-0.5,0.9,3,2.1,12.2,1.1,-11.1,1,1.4,0.4,4.5,0.6,-3.9,,,,0,0,0,0,0.2,0.2,0,0,0,179.5,245.1,65.6,7.2,3.7,-3.5,1.3,2.9,1.6,2.1,2.2,0.1,1.7,0.4,-1.3,17.5,8.2,-9.3,4.6,1.4,-3.2,5.5,0,-5.5,0,53.4,53.4,0,0,0
1997-01-01,3877.1,1534.1,-2343,11644.9,10608.3,-1036.6,69846,52904,-16942,4587,0,-4587,7068.2,4616.6,-2451.6,10494,12359,1865,6795.3,5980.3,-815,4317.7,4327.2,9.5,19873.3,16650.7,-3222.6,13209.278064,11784.79467,-1424.483394,1899.271479,801.909923,-1097.361556,24326.1,14614.6,-9711.5,67271.9000000001,50590.1,-16681.8000000001,27483.9,15977.4,-11506.5,,,,488.2,1048.5,560.3,1553.8,420.8,-1133,0.4,0.2,-0.2,13686.1,11733.3,-1952.8,0,0,0,6187.2,4917.4,-1269.8,146.4,119.3,-27.1,7.2,10.4,3.2,92.4,102,9.59999999999999,133.7,152.3,18.6,26,18.9,-7.1,152,160,8,23.2,105.5,82.3,0.2,20.8,20.6,14.4,56.4,42,0,0.4,0.4,54.9,113.4,58.5,0.4,4.9,4.5,3.4,19.6,16.2,8.4,33.2,24.8,210.7,258.9,48.2,0,1.6,1.6,0.3,4.9,4.6,1.4,3.3,1.9,0.7,5.5,4.8,0.4,1.5,1.1,1.4,3.5,2.1,1.2,5.6,4.4,0.4,3.7,3.3,0.3,1.6,1.3,3.4,20.8,17.4,126.9,84.5,-42.4,54.3,32.3,-22,,,,,,,59.6,15,-44.6,0.5,5.2,4.7,0,2.8,2.8,296.9,382.3,85.4,1262.9,433.3,-829.6,5.5,11.9,6.4,5.7,16.8,11.1,0.1,0.7,0.6,121.6,136.7,15.1,168.6,122.8,-45.8,25.7,12.1,-13.6,259,300.2,41.2,869.9,1012.7,142.8,2.4,87.8,85.4,14.8,35.5,20.7,160.5,406.6,246.1,0,0,0,22.3,14.8,-7.5,496.8,261.9,-234.9,0,0.1,0.1,283.6,113.2,-170.4,165.1,83.9,-81.2,1,0.1,-0.9,158.5,133.1,-25.4,2543.5,2466.2,-77.3000000000002,392.5,345,-47.5,534.2,1445,910.8,543.3,1099.1,555.8,17.7,24,6.3,0,2,2,2,0.1,-1.9,1429.6,1233.3,-196.3,3082,1838.1,-1243.9,182.9,167.3,-15.6,0,0,0,42.5,28.8,-13.7,16.2,5.1,-11.1,62.3,32.6,-29.7,6.7,1.5,-5.2,580,386.8,-193.2,7,1.3,-5.7,14.9,14.4,-0.5,5.4,8.7,3.3,53.8,62.7,8.90000000000001,0,0,0,285.8,234.2,-51.6,7.4,6.5,-0.9,66.6,28.2,-38.4,0.2,9.6,9.4,0.1,5.4,5.3,0.2,9.5,9.3,19.8,5,-14.8,0.2,0.7,0.5,2.2,0.3,-1.9,0,0.4,0.4,0.3,43.3,43,12.8,9.6,-3.2,368.7,498.1,129.4,77.4,84.2,6.8,0.2,4.2,4,20.6,6.6,-14,0,0.9,0.9,0,0.1,0.1,1373.3,683.6,-689.7,0,0,0,7.3,15.5,8.2,20.2,8.4,-11.8,0.8,23.8,23,20.1,0.4,-19.7,0.8,2.1,1.3,,,,,,,,,,0.1,0.4,0.3,34.8,60.9,26.1,46.8,14.9,-31.9,15.8,2.3,-13.5,181.1,240.6,59.5,1.7,16,14.3,1.6,12.6,11,3.5,44.9,41.4,0,0.7,0.7,0,0.2,0.2,0,0,0,0,0,0,0,0,0,2.3,33.1,30.8,133.6,103.3,-30.3,0,0,0,764.8,439.3,-325.5,9.5,20.6,11.1,61.2,136.8,75.6,7.1,23.4,16.3,22.4,16.4,-6,7.9,18.5,10.6,0.8,0.9,0.1,555.5,250.3,-305.2,100.8,154.2,53.4,11.2,4.6,-6.6,144.5,31.8,-112.7,142.8,10.3,-132.5,9.8,7.6,-2.2,951.7,582.6,-369.1,43.3,22.9,-20.4,1.8,0.2,-1.6,0.9,1.7,0.8,1362.3,724.8,-637.5,1567.2,1496.5,-70.7,765,309.9,-455.1,,,,5,4.7,-0.3,736.9,556.8,-180.1,93.7,3.8,-89.9,0.8,0,-0.8,0.8,0.4,-0.4,4667.6,938.4,-3729.2,4.2,4.5,0.3,0,0,0,1793.1,1986,192.9,904.4,1053.8,149.4,2530.6,1443.9,-1086.7,9433,5073.1,-4359.9,345.1,872.5,527.4,0,0.4,0.4,0,0,0,0.2,0,-0.2,0,0,0,2.4,10.3,7.9,120,140,20,0.1,0.1,0,0.1,0,-0.1,0,2.1,2.1,0.1,0.9,0.8,0,0,0,1.6,0.1,-1.5,0,0,0,1,0.6,-0.4,0,0,0,4.5,2.5,-2,0,0,0,1.2,8.7,7.5,1.4,2.5,1.1,2,2.2,0.2,1.3,1.3,0,0,0.8,0.8,7,3.3,-3.7,0.2,0.2,0,24.8,14,-10.8,258.9,41.1,-217.8,9.2,35.4,26.2,0,0,0,52.1,287.5,235.4,0.5,5.1,4.6,,,,0,0,0,0.1,2.8,2.7,0,0.3,0.3,1.9,6.4,4.5,0.5,4,3.5,0.4,1.6,1.2,4.6,7.5,2.9,1.6,0.9,-0.7,37.5,10.4,-27.1,20.6,18.6,-2,0,0.3,0.3,0.1,1.3,1.2,0,0.7,0.7,621.2,49.1,-572.1,0,0.2,0.2,214.2,3,-211.2,0.2,0,-0.2,0,2.3,2.3,0,0.9,0.9,0,4.6,4.6,247,12.5,-234.5,89.7,4.7,-85,0,0,0,0,1.2,1.2,0,0,0,0.1,1.3,1.2,23.5,4.4,-19.1,0,0,0,0.7,5.6,4.9,0.1,0.1,0,0,0,0,0,0.8,0.8,0,0.4,0.4,1.5,1.1,-0.4,9.2,9.8,0.600000000000001,0.3,0,-0.3,0.5,0,-0.5,1.7,3.7,2,15.3,2.9,-12.4,3.3,3.9,0.6,7.9,0.7,-7.2,,,,0,0,0,0,0.2,0.2,0,0,0,183.5,228.2,44.7,7.6,1.7,-5.9,1.5,2.9,1.4,9.8,1.7,-8.1,10,0.8,-9.2,17.9,5.2,-12.7,5.9,1.1,-4.8,9.3,0,-9.3,0,0,0,0,0,0
1997-02-01,3175,1623.2,-1551.8,11764.7,12064.8,300.099999999999,70131,55077,-15054,4865.9,0,-4865.9,7095.1,4735.4,-2359.7,10152,12883,2731,5761.9,5713.6,-48.2999999999993,4235.2,4359.6,124.400000000001,20011.2,17431.4,-2579.8,13192.369405,13436.825244,244.455839,1528.342431,772.775463,-755.566968,22744.4,14705.3,-8039.1,65090.4,53152.9,-11937.5,25748.9,16127.4,-9621.5,,,,374,1024.6,650.6,1215.1,439.4,-775.7,0.3,0.2,-0.1,13477.6,12101.5,-1376.1,0,0.1,0.1,6533.6,5329.9,-1203.7,170.9,136.7,-34.2,5,6.7,1.7,86.6,97.8,11.2,174.6,151.3,-23.3,39.1,21.3,-17.8,175.2,169.5,-5.69999999999999,23.5,121.3,97.8,0.6,23.8,23.2,17.2,61.2,44,0,0,0,54.9,100.3,45.4,0.4,4.7,4.3,0.7,18.6,17.9,12,36.1,24.1,323.7,311,-12.7,0,1.3,1.3,1.5,5.9,4.4,2,2.7,0.7,0.6,7.3,6.7,0.6,1.5,0.9,0.6,2.5,1.9,15.3,6.3,-9,0.2,3.7,3.5,0.2,3.2,3,3,20,17,90.8,72.1,-18.7,128.9,52.4,-76.5,,,,,,,45.2,16.5,-28.7,0.2,6.7,6.5,0.3,3.1,2.8,386.6,363.5,-23.1,960,384.3,-575.7,7.9,13.4,5.5,5.6,9.6,4,0,1,1,181.7,111.2,-70.5,131.2,137.7,6.5,21.1,26.4,5.3,221.9,309.4,87.5,706.9,1048.8,341.9,3.9,74.3,70.4,12.1,36.6,24.5,222.5,377.8,155.3,0,0.1,0.1,17.4,12.9,-4.5,573.8,248.8,-325,0,0.2,0.2,251.2,140.9,-110.3,156.5,134.6,-21.9,0.8,0,-0.8,157.6,167.3,9.70000000000002,2405.3,3331.4,926.1,395.5,325.4,-70.1,461,1658.9,1197.9,589.3,1063.8,474.5,15.8,34.4,18.6,0,1.3,1.3,1.2,0.9,-0.3,1470.5,1212.8,-257.7,3233.6,2033.7,-1199.9,184.2,183.6,-0.599999999999994,0,0,0,32.3,25.9,-6.4,13.8,16.9,3.1,62.2,39.3,-22.9,5.8,0.4,-5.4,606.4,571.4,-35,3.2,1.7,-1.5,24.7,20.1,-4.6,2.3,4.4,2.1,44.8,68,23.2,0,0,0,260.1,222,-38.1,4.7,1.1,-3.6,37.1,36.1,-1,0.2,6,5.8,0.1,7.6,7.5,0.1,2.3,2.2,2.9,3.2,0.3,0.5,0.5,0,0.5,0.4,-0.1,0,0.2,0.2,1.1,14.8,13.7,1,10.2,9.2,334,524.8,190.8,71.4,89.8,18.4,0.1,0.4,0.3,16,9.5,-6.5,0,1,1,0,0,0,1449.7,750.1,-699.6,0,0,0,4.1,6,1.9,20.4,7.5,-12.9,0.9,40.1,39.2,8,0.7,-7.3,0.3,2.7,2.4,,,,,,,,,,3.1,0.4,-2.7,46.2,74.6,28.4,28.3,21,-7.3,14.1,6.5,-7.6,177.4,260.5,83.1,0.8,37.4,36.6,7.6,13.4,5.8,3.6,50.8,47.2,0,0,0,0,0,0,0,0,0,0,0,0,0,0,0,1.3,29,27.7,132.8,89,-43.8,0,0,0,640.5,510.4,-130.1,9.8,23.8,14,159.2,171.7,12.5,5.7,13.5,7.8,13.4,20,6.6,7,15.3,8.3,0.2,0.6,0.4,539.9,285,-254.9,108.2,85.7,-22.5,12.4,0.7,-11.7,126.6,19.6,-107,118.6,11,-107.6,11.8,1.2,-10.6,868.2,601.7,-266.5,48.1,23.6,-24.5,0.8,0.3,-0.5,1.1,2.4,1.3,1198.6,705.9,-492.7,1332.2,1206.5,-125.7,632.9,360.8,-272.1,,,,4.6,5.4,0.800000000000001,732.1,563.3,-168.8,72.2,2.1,-70.1,0,0.1,0.1,1.3,0.5,-0.8,4262.4,913.3,-3349.1,1.5,1.1,-0.4,0,0,0,1506.2,1986,479.8,623.1,1092.4,469.3,2300.5,1428.7,-871.8,9721.1,5434.8,-4286.3,244.3,882.4,638.1,0,0.2,0.2,0,0,0,0.1,0.1,0,0,0,0,1.3,4.8,3.5,112.9,118.9,6,0,0.1,0.1,0,0,0,0,3.5,3.5,0.1,0.3,0.2,0,0.1,0.1,0,0.1,0.1,0,0,0,0.1,0.2,0.1,0,0,0,7,1.5,-5.5,0,0,0,1.3,4.5,3.2,0.6,2.3,1.7,0.6,2.5,1.9,0.8,0.8,0,0,0.1,0.1,4.8,2,-2.8,0.1,0.2,0.1,15.6,63,47.4,251.8,37.7,-214.1,2,15.1,13.1,0,0,0,43.6,217.5,173.9,2.1,1.5,-0.6,,,,0,0,0,0.1,1.2,1.1,0.1,0.1,0,4,6.5,2.5,1.8,3.8,2,0.2,2,1.8,18.6,10.4,-8.2,1.5,1.1,-0.4,24.3,10.2,-14.1,12.9,23.7,10.8,0.1,0.7,0.6,8.2,2.1,-6.1,0,2.9,2.9,388.1,45.5,-342.6,0.1,1.3,1.2,156.9,2.6,-154.3,0,0.1,0.1,0,0.1,0.1,0,1.4,1.4,0,3.5,3.5,349.2,28,-321.2,20.2,2.7,-17.5,0,0.1,0.1,0,0.6,0.6,0,0,0,0,2.6,2.6,25.6,6.6,-19,0,0,0,0.2,0.3,0.1,0,0.1,0.1,0,0,0,0,1.1,1.1,0,0.4,0.4,1.3,4.8,3.5,10.5,14.2,3.7,0.1,0.7,0.6,0,0.1,0.1,1.5,3.6,2.1,15.4,2.8,-12.6,0.9,0.5,-0.4,3.8,1,-2.8,,,,0,0,0,0.4,0.3,-0.1,0,0,0,140.1,227.3,87.2,2,0.7,-1.3,1.5,1.1,-0.4,2.9,4.5,1.6,1.8,0.2,-1.6,10.2,8.6,-1.6,1.3,1.5,0.2,5.3,0,-5.3,0,0,0,0,0,0
1997-03-01,3409.3,2082.3,-1327,13616.9,13551.2,-65.6999999999989,70023,56931,-13092,4930.4,0,-4930.4,7569.3,5051.1,-2518.2,11972,16712,4740,6503.2,7276.5,773.3,4413.8,5178.6,764.8,21024.9,18425.3,-2599.6,15404.989887,15787.645354,382.655467,1697.048576,1076.791307,-620.257269,24513.4,17595.3,-6918.1,70606.1,61200.9,-9405.2,27564.3,19461.8,-8102.5,,,,500.6,1270.6,770,1396.3,583.4,-812.9,0.7,0.1,-0.6,14067.4,13000.8,-1066.6,0,0.1,0.1,6957.5,5424.5,-1533,176.5,146.8,-29.7,11.7,10.7,-1,111.1,121.2,10.1,194.7,170.2,-24.5,42.1,22.3,-19.8,199.8,157.5,-42.3,24.7,132.3,107.6,0.5,23.8,23.3,13.2,75.4,62.2,0,0.2,0.2,61.5,114.5,53,0.2,4.7,4.5,0.6,20.5,19.9,14.5,40.7,26.2,343.3,320.4,-22.9,0.1,2.3,2.2,0.4,4.7,4.3,2.3,3,0.7,0.7,7,6.3,0.7,1.8,1.1,0.5,1.8,1.3,1.6,7.7,6.1,0.3,2.5,2.2,0.1,3.1,3,3.4,25.6,22.2,95.7,89.8,-5.90000000000001,42,39.5,-2.5,,,,,,,62.2,19.7,-42.5,0,6.1,6.1,0.3,2.1,1.8,416.6,417.9,1.29999999999995,1097.3,483.4,-613.9,9.1,13.2,4.1,7.2,18,10.8,0,2.8,2.8,201.1,107.9,-93.2,91.9,183.8,91.9,14.2,21.8,7.6,221.1,441.5,220.4,750.1,1322.7,572.6,2.4,88.2,85.8,18,51.3,33.3,180.1,448.2,268.1,0,0,0,17.3,16.5,-0.800000000000001,713.5,314.5,-399,0,0.2,0.2,380.7,207.7,-173,192.9,150,-42.9,0.8,0.1,-0.7,183.4,209.1,25.7,2673.7,3837.5,1163.8,485.9,336.2,-149.7,585,1681.5,1096.5,675.7,1217.7,542,24.1,33.6,9.5,0,1.1,1.1,1.2,0.6,-0.6,1685.7,1432.6,-253.1,3772,2300.2,-1471.8,199.6,170.8,-28.8,0,0,0,45.3,141.8,96.5,12.5,6.9,-5.6,70.8,46.9,-23.9,6.5,4.1,-2.4,715.1,1128,412.9,4.7,5.6,0.899999999999999,15.5,16.2,0.699999999999999,3.2,5,1.8,53.9,77.3,23.4,0,0,0,377.1,262.4,-114.7,2.7,4.5,1.8,22.7,28.2,5.5,0.5,3.5,3,0.5,1.7,1.2,0.1,4.2,4.1,8.5,7.5,-1,0,0.8,0.8,0.6,1.6,1,0.5,0.1,-0.4,0,3.4,3.4,0.8,135.4,134.6,367,526.1,159.1,88.8,102.4,13.6,0.4,0.2,-0.2,22.3,11.5,-10.8,0,1.4,1.4,0,0,0,1680.6,811.3,-869.3,0,0,0,5.6,12,6.4,24.6,10.7,-13.9,0.9,6.9,6,10.4,0.7,-9.7,0.5,1.9,1.4,,,,,,,,,,0.9,0.2,-0.7,35.2,86,50.8,23.2,10.9,-12.3,12.5,9.7,-2.8,197.9,380.8,182.9,1.2,19.7,18.5,1.6,18.7,17.1,3.4,52.3,48.9,0,0,0,0,0.2,0.2,0,0,0,0,0,0,0,0,0,0.9,24.6,23.7,108.5,107.9,-0.599999999999994,0,0,0,778.5,795.1,16.6,9,20.4,11.4,52.1,193.7,141.6,0.2,11.7,11.5,21.7,20.3,-1.4,7.5,22.6,15.1,1.8,0.5,-1.3,623.8,394.5,-229.3,96.5,170.7,74.2,12.8,0.3,-12.5,104.6,23.9,-80.7,130.6,13.1,-117.5,9.5,0.7,-8.8,972.7,638.9,-333.8,29.2,29,-0.199999999999999,1.3,0.3,-1,2.6,3.2,0.6,1419.5,821.2,-598.3,1668.9,1672.5,3.59999999999991,607.6,359.7,-247.9,,,,4,9.1,5.1,865.6,679.2,-186.4,48.6,3.5,-45.1,0,0,0,1.1,0.4,-0.7,3628.6,1021.6,-2607,4.3,0.8,-3.5,0,0,0,1800.7,2482.4,681.7,605.4,1351.4,746,2428.2,1770.2,-658,10947.9,6183.5,-4764.4,342.8,1093.8,751,0,0.3,0.3,0,0,0,0,0,0,0,0.1,0.1,1.9,5.1,3.2,143.9,142.2,-1.70000000000002,0.1,0.1,0,0,0,0,0,3.1,3.1,0.2,1.3,1.1,0.1,0.2,0.1,0,0.1,0.1,0,0,0,0.1,0.1,0,0,0,0,2.8,3,0.2,0,0,0,1,10.3,9.3,0.5,3.3,2.8,1.1,2.9,1.8,0.9,1.5,0.6,0,0,0,5,2.6,-2.4,0.2,0.7,0.5,24.3,41,16.7,233.2,51.2,-182,2.1,21.3,19.2,0,0,0,40.6,379.9,339.3,0.5,1.7,1.2,,,,0,0,0,0.1,2.5,2.4,0.1,3.4,3.3,3.9,5.4,1.5,0.5,2.6,2.1,0.2,2,1.8,4.2,4.5,0.3,1.6,3.3,1.7,49.3,13.9,-35.4,19.3,35.4,16.1,0.5,2,1.5,0.2,1.8,1.6,4.1,1,-3.1,523.1,70.7,-452.4,0.9,0.4,-0.5,184.1,8.8,-175.3,0,0.9,0.9,0.3,0,-0.3,0,3.5,3.5,0,3.1,3.1,270.5,32.8,-237.7,53.9,6,-47.9,0,0.1,0.1,0,2,2,0,3.7,3.7,0.1,4.7,4.6,37.5,2.8,-34.7,0,0,0,0,6.1,6.1,0,0.1,0.1,0,0,0,0,0.7,0.7,0,0.3,0.3,2.6,3.8,1.2,9.4,55.8,46.4,0.1,0.8,0.7,0,0,0,1.8,10.5,8.7,13.4,3.8,-9.6,0.9,7.4,6.5,3.3,1,-2.3,,,,0,0,0,0,0.2,0.2,0,0,0,174.7,254,79.3,4.7,0.6,-4.1,2.4,1.3,-1.1,4.6,2.8,-1.8,1.1,0.1,-1,13.2,7.2,-6,1.2,3.1,1.9,6.1,0,-6.1,0,0,0,0,0,0
1997-04-01,3590.3,1950,-1640.3,13577.4,12450.5,-1126.9,71262,57365,-13897,5269.3,0,-5269.3,7490.2,5323,-2167.2,11793,14954,3161,6874,6656.5,-217.5,4296,5065,769,21243.5,19010.1,-2233.4,15139.604076,14490.390654,-649.213422000008,1741.47059,771.503284,-969.967306,25093.1,16024.4,-9068.7,71168.9,58179.8,-12989.1,28197,17772.2,-10424.8,,,,550.6,1063.1,512.5,1466.4,498.2,-968.2,0.5,0.3,-0.2,14146.6,13289.3,-857.300000000001,0.1,0.1,0,7096.9,5720.8,-1376.1,166.9,140.7,-26.2,4.7,11.4,6.7,104.3,126.7,22.4,169,166.7,-2.30000000000001,27.9,26.7,-1.2,189.5,152.3,-37.2,28.5,126.9,98.4,0.6,38.1,37.5,11.7,66.9,55.2,0,0.2,0.2,73.3,125.7,52.4,0.3,5.5,5.2,3.3,20.4,17.1,16.4,40.2,23.8,377.4,345.1,-32.3,0.1,1.9,1.8,1.2,7.8,6.6,2.4,3.3,0.9,0.7,6.9,6.2,0.7,1.8,1.1,0.8,4.2,3.4,1.7,6.8,5.1,0.7,4.6,3.9,0.2,2.1,1.9,3.5,23.6,20.1,85.2,79,-6.2,36.3,34,-2.3,,,,,,,50.7,21.4,-29.3,1.2,5.5,4.3,0,2.7,2.7,376.9,469.9,93,989.5,512.5,-477,10.2,11.6,1.4,4.3,12.7,8.4,0.1,72.9,72.8,165.6,107.6,-58,131.8,144,12.2,15.7,17.1,1.4,219.5,363.4,143.9,815.3,1208,392.7,3.7,79.8,76.1,24.5,42.2,17.7,179.7,424.2,244.5,0,0,0,15.7,17.3,1.6,670.8,297,-373.8,0,0.4,0.4,241.7,198.5,-43.2,235.5,114.8,-120.7,0.8,0,-0.8,167.9,154.6,-13.3,2730.8,3123.7,392.9,450.3,375.4,-74.9,561.4,1610.4,1049,742.1,1070.1,328,19.6,47.9,28.3,0,1.6,1.6,1.4,0.4,-1,1635.6,1376.5,-259.1,3820,2370,-1450,209,163.3,-45.7,0,0,0,47.5,67.3,19.8,12.5,3.8,-8.7,83.5,42.7,-40.8,12.3,1.5,-10.8,658.1,1079.1,421,4,2.6,-1.4,35,15.7,-19.3,4.4,12.2,7.8,49.2,126.6,77.4,0,0,0,317.9,325.1,7.20000000000005,3.6,2.3,-1.3,15,42.9,27.9,0.3,1.9,1.6,0.2,3.8,3.6,0.2,3.4,3.2,18.9,41.8,22.9,0.4,0.8,0.4,0.7,1.6,0.9,0.8,0,-0.8,0.1,0.5,0.4,10.5,12.7,2.2,390.5,456.5,66,86.9,71.3,-15.6,0.7,0.4,-0.3,15.7,11.2,-4.5,0.1,0.5,0.4,0,0,0,1546.5,842.1,-704.4,0,0,0,10.8,7.6,-3.2,22.3,8.3,-14,0.5,5.2,4.7,7.7,0.7,-7,0.8,2.8,2,,,,,,,,,,0.3,0.1,-0.2,35.6,76.4,40.8,40.2,26.2,-14,11.5,3.7,-7.8,191.2,257,65.8,1,10.2,9.2,0.7,14.6,13.9,4,49.4,45.4,25.7,0,-25.7,0,0.7,0.7,0,0,0,0,0,0,0,0.2,0.2,2.3,28.2,25.9,135.7,111.5,-24.2,0,0,0,782.2,559.6,-222.6,16.2,21,4.8,157.6,305,147.4,0.4,22.6,22.2,20.7,23.2,2.5,7,19,12,0.3,0.3,0,577,308.7,-268.3,108,74,-34,12.2,2.2,-10,97.9,20.1,-77.8,133.1,7,-126.1,8.7,0.6,-8.1,975.6,674,-301.6,38,25.3,-12.7,1.4,0.1,-1.3,2.5,2.7,0.2,1415,967.7,-447.3,1698.7,1349.9,-348.8,678.7,329.2,-349.5,,,,3.1,6.3,3.2,739,671.6,-67.4,61.6,3.2,-58.4,0,0,0,1,0.2,-0.8,4445,964.7,-3480.3,2.5,0.5,-2,0,0,0,1915.6,2460,544.4,683.1,1305.9,622.8,2576.6,1540.8,-1035.8,10343.9,5388.6,-4955.3,351.4,879.9,528.5,0,0,0,0,0,0,0.1,0,-0.1,0,0,0,29.7,13.6,-16.1,151.6,143.1,-8.5,0,0.1,0.1,0,0,0,0,2.6,2.6,0.2,0.9,0.7,0.1,0.2,0.1,0.1,0,-0.1,0,0,0,0.1,0.1,0,0,0,0,6,1.7,-4.3,0,0,0,5.8,13.2,7.4,0.2,2.1,1.9,0.7,1.8,1.1,0.9,1.1,0.2,0,0,0,3.5,2.4,-1.1,0.2,0.3,0.1,24.9,14.6,-10.3,165.5,54.8,-110.7,4.7,4.8,0.0999999999999996,0,0,0,69.3,199.1,129.8,1.6,2.7,1.1,,,,0,0,0,0,10.6,10.6,0,0.5,0.5,5.5,9,3.5,0.5,3.4,2.9,0.1,2.1,2,12.8,4.3,-8.5,1.2,1.9,0.7,50.5,10.8,-39.7,7.2,34.5,27.3,0.1,1.5,1.4,2.9,1.3,-1.6,0.3,1.8,1.5,639,55.6,-583.4,0,0.3,0.3,129.6,6.1,-123.5,0.3,0.1,-0.2,0.2,0,-0.2,0,0.8,0.8,0.7,2.1,1.4,268.3,30.3,-238,24.7,3.1,-21.6,0,0.1,0.1,0,0.4,0.4,0,0.1,0.1,1.1,2.7,1.6,25.2,3.9,-21.3,0,0.1,0.1,0.5,1.2,0.7,0,0.1,0.1,0,0,0,0.1,0.8,0.7,0,0.7,0.7,2.3,0.7,-1.6,11.4,16.7,5.3,0.3,0.3,0,10.2,0,-10.2,1.6,4.9,3.3,15.6,2.6,-13,1.4,2.5,1.1,3.9,0.6,-3.3,,,,0,0.3,0.3,0,0.2,0.2,0,0,0,210.2,254.3,44.1,2,0.6,-1.4,2.9,4.3,1.4,3.6,3.4,-0.2,1.8,0.2,-1.6,10.1,5.8,-4.3,11.8,1.3,-10.5,6.1,0.1,-6,0,6.9,6.9,0,0,0
1997-05-01,3935.3,2286,-1649.3,13528.9,12270.2,-1258.7,72137,57500,-14637,5231.7,0,-5231.7,7552.7,5114.2,-2438.5,11430,15242,3812,6949.5,6809.5,-140,4681.9,5331.4,649.5,21445.3,18397.1,-3048.2,15363.306698,14227.787435,-1135.519263,1733.268697,1031.45773,-701.810967,24560.9,16983.9,-7577,71430.4,58738.3999999999,-12692.0000000001,27617.4,18544.4,-9073,,,,587.6,1192.3,604.699999999999,1455.7,575.9,-879.799999999999,1,0.2,-0.8,14333.4,12977.4,-1356,0.1,0,-0.1,7111.9,5419.7,-1692.2,175,153.8,-21.2,9.1,10.3,1.2,113.6,109.7,-3.89999999999999,196.2,163.9,-32.3,38.8,24.4,-14.4,197,173.4,-23.6,36.8,128.3,91.5,0.7,32.6,31.9,13.1,61.3,48.2,0,0.1,0.1,57,131.1,74.1,0.3,5.9,5.6,3,24.4,21.4,16.9,36.3,19.4,379.3,342.8,-36.5,0,1.4,1.4,0.7,5.3,4.6,2.1,3.3,1.2,0.2,5.6,5.4,0.7,2.9,2.2,0.8,2.9,2.1,1.6,6.4,4.8,0.2,2.7,2.5,0.3,2.8,2.5,3.4,22,18.6,105.3,71.7,-33.6,27.1,38.2,11.1,,,,,,,67.3,20.1,-47.2,0.3,4.3,4,0.1,2.4,2.3,414.5,476.4,61.9,1190.4,569.1,-621.3,13.6,8.4,-5.2,9.7,14.7,5,0.3,69.9,69.6,172.7,132.2,-40.5,123,150.7,27.7,16.3,17.4,1.1,186.1,348.6,162.5,886.1,1341.1,455,2.3,70.2,67.9,32.2,44.5,12.3,187.6,497.9,310.3,0.2,0,-0.2,19.9,16.1,-3.8,609.9,285.8,-324.1,0,0.1,0.1,413.3,174.7,-238.6,228,155.5,-72.5,1.3,0,-1.3,176.8,145,-31.8,2798.9,3113,314.1,415.3,427.4,12.1,607,1760,1153,676.5,1137.2,460.7,21.4,28.8,7.4,0,1.4,1.4,1.4,0.2,-1.2,1622.3,1313.5,-308.8,3734.7,2010.3,-1724.4,198.5,163.8,-34.7,0,0,0,55.5,70.2,14.7,14,4.8,-9.2,103.7,39.2,-64.5,6.8,1.1,-5.7,705.4,916.2,210.8,5.7,3.5,-2.2,14.5,20.8,6.3,2.9,4.4,1.5,61.7,162.7,101,0,0,0,368.4,259.2,-109.2,5.6,1.2,-4.4,37.2,29.8,-7.4,0.5,7.8,7.3,0.3,4.4,4.1,0.5,7,6.5,4.7,36.1,31.4,0.3,1.6,1.3,2.9,4,1.1,0.4,2.5,2.1,0.2,5.6,5.4,0.7,10.2,9.5,405.3,462.6,57.3,103,101.9,-1.09999999999999,0.2,0.3,0.1,17.9,9.7,-8.2,0.1,0.2,0.1,0.2,0.5,0.3,1582.3,753.2,-829.1,0,0,0,12.7,8.6,-4.1,25.6,8.4,-17.2,0.8,4,3.2,16.1,0.9,-15.2,1.8,2.7,0.9,,,,,,,,,,0.5,0.2,-0.3,46.1,61.1,15,23.3,22.3,-1,9.6,17.4,7.8,199.5,421.2,221.7,1.5,27.6,26.1,0.8,11.5,10.7,7.1,31.6,24.5,51.1,3.8,-47.3,0,0,0,0,0,0,0,0,0,0,0,0,11.6,35,23.4,104.5,118.1,13.6,0,0,0,889.2,640.2,-249,9.5,23.7,14.2,41.2,302.2,261,0.4,6.4,6,22.5,25.6,3.1,8.6,16.1,7.5,0.5,0.2,-0.3,536,326.9,-209.1,111.5,69.1,-42.4,8.5,0.6,-7.9,110,15.4,-94.6,108.5,9.5,-99,6.7,0.5,-6.2,954.9,566.2,-388.7,28.1,24.1,-4,0.7,0.3,-0.4,2.9,1.6,-1.3,1398.3,1142.3,-256,1713.1,1535.9,-177.2,776.6,493.3,-283.3,,,,4.9,36.5,31.6,830.7,618.2,-212.5,64.5,5.7,-58.8,0,0.1,0.1,1.4,0.3,-1.1,4795.1,1056.8,-3738.3,2.1,0.1,-2,0,0.1,0.1,1908.3,2402.6,494.3,711.3,1306.5,595.2,2616.8,1564.5,-1052.3,9166.8,5654.9,-3511.9,407.5,1007.9,600.4,0,0.2,0.2,0,0,0,0,0.1,0.1,0.1,0,-0.1,0.5,7.9,7.4,166.5,151,-15.5,0,0.1,0.1,0.3,0.1,-0.2,0,3.3,3.3,0.3,1,0.7,0.1,0.1,0,0.1,0,-0.1,0.1,0,-0.1,0,0.1,0.1,0,0,0,4.6,3.6,-1,0,0,0,1.8,8.7,6.9,0.1,2,1.9,1,2.3,1.3,0.7,1.5,0.8,0,0,0,3.9,1.8,-2.1,0.2,0.6,0.4,24,23.1,-0.899999999999999,206.2,61.5,-144.7,6.7,16.2,9.5,0,0,0,40.8,354.7,313.9,1.6,2.7,1.1,,,,0,0,0,0.1,2.6,2.5,0,2.5,2.5,7.7,6,-1.7,0.4,2.1,1.7,0.2,2.7,2.5,11.8,5.2,-6.6,1.6,4.9,3.3,9.2,9.1,-0.0999999999999996,8.2,33.5,25.3,0.5,0.8,0.3,4.1,1.8,-2.3,0.1,1.1,1,666.6,74.1,-592.5,0,0.2,0.2,196,11.2,-184.8,0,0.1,0.1,0,0,0,0.1,0.9,0.8,3,3.3,0.3,167.6,20.6,-147,47.5,4.9,-42.6,0,0.1,0.1,0.2,1.7,1.5,0.1,0.1,0,0.1,7.3,7.2,25.2,4.2,-21,0,0,0,0.2,2.1,1.9,0,0.1,0.1,0,0,0,0,1.8,1.8,0,0.6,0.6,3.7,3,-0.7,10.2,54.6,44.4,0.3,0.1,-0.2,0.1,0,-0.1,1.9,10.3,8.4,15.6,3.5,-12.1,1.8,5.1,3.3,4.8,1.4,-3.4,,,,0.6,0,-0.6,0,0.1,0.1,0,0,0,215.2,261.6,46.4,8.6,1.1,-7.5,1.9,6.2,4.3,5.1,1.7,-3.4,1.1,0.6,-0.5,13.9,8.6,-5.3,6.5,1.7,-4.8,6.2,0.7,-5.5,0,13.6,13.6,0,0,0
1997-06-01,3644.1,1926.6,-1717.5,13183.1,11868.4,-1314.7,71658,58289,-13369,5360.8,0,-5360.8,7498.2,5008.7,-2489.5,12423,14895,2472,7284.1,6748.7,-535.400000000001,4458.8,5277.7,818.9,20923.1,18419.2,-2503.9,14822.659044,13936.215108,-886.443935999998,1620.548657,867.444038,-753.104619,26104.7,16995.6,-9109.1,71575.5,58048.2,-13527.3,29177.7,18006.4,-11171.3,,,,572.3,1529,956.699999999999,1324.3,491.7,-832.6,0.5,0.7,0.2,13814.8,12506.4,-1308.4,0,0,0,7108.3,5912.8,-1195.5,161.2,152.1,-9.09999999999999,3.6,8.7,5.1,120.7,118.4,-2.3,197.2,166.7,-30.5,39.3,35,-4.3,206.1,169.4,-36.7,36,135.6,99.6,1.4,35.7,34.3,11.6,70.2,58.6,0,0.2,0.2,59.5,108.3,48.8,0.4,5.6,5.2,1.7,27.7,26,17.4,36.9,19.5,378.3,328.9,-49.4,0,1,1,2.1,5.2,3.1,5.2,2.8,-2.4,0.1,5.4,5.3,0.8,1.5,0.7,0.3,2,1.7,1.9,8.2,6.3,0.3,4.3,4,0.4,2.5,2.1,3.7,22.1,18.4,73.9,134.4,60.5,66.9,39.1,-27.8,,,,,,,49.4,15.4,-34,0,4.7,4.7,0,2,2,357.5,444.7,87.2,1109.3,580.7,-528.6,7.9,10.2,2.3,6.3,17.1,10.8,0,2.8,2.8,192.5,130.7,-61.8,168.1,159.5,-8.59999999999999,13.3,20.4,7.1,157,331.2,174.2,804.4,1335.2,530.8,2.3,70.8,68.5,20.5,47.8,27.3,180.2,476.6,296.4,0.1,0,-0.1,16.5,15.9,-0.6,630.7,250.3,-380.4,0,0,0,298.8,114.2,-184.6,206,115,-91,0.6,0,-0.6,174.5,123.2,-51.3,2469.1,3204.1,735,469,391.1,-77.9,639.9,1493.5,853.6,622,1125.3,503.3,19.4,27.2,7.8,0,2.3,2.3,1.7,0.5,-1.2,1770.1,1330.9,-439.2,3485.7,1964,-1521.7,198.1,150.7,-47.4,0,0,0,55.2,32.7,-22.5,14.6,5.5,-9.1,93.1,47.6,-45.5,7.7,0.6,-7.1,710.1,1156.3,446.2,7,2.5,-4.5,11.1,17.9,6.8,2.9,6.5,3.6,54.5,183.6,129.1,0,0,0,325.1,244.6,-80.5,7.7,1.3,-6.4,29.8,58,28.2,0.4,4.5,4.1,1.5,6,4.5,0.1,16.9,16.8,8.7,41.4,32.7,0.1,1.4,1.3,1.3,0.7,-0.6,0.1,0,-0.1,0,1.4,1.4,6.8,3.6,-3.2,404.1,449.4,45.3,96.7,69.1,-27.6,0.4,0.6,0.2,15.6,7.7,-7.9,0,0.7,0.7,0,0.1,0.1,1664.1,751.6,-912.5,0,0,0,4.7,9.1,4.4,23.8,9.4,-14.4,1,4,3,13.8,3,-10.8,0.5,5.3,4.8,,,,,,,,,,0.6,0.2,-0.4,54.7,87.1,32.4,23.8,25.6,1.8,15.9,14.9,-1,161.8,334.9,173.1,1.1,22.1,21,0.8,10.1,9.3,2.8,53.8,51,17.7,8.6,-9.1,0,0,0,0,0,0,0,0.1,0.1,0,0,0,0.5,38.4,37.9,200.6,96.5,-104.1,0,0,0,698.9,529.4,-169.5,7.2,20.5,13.3,102.2,184.3,82.1,0.3,18,17.7,36.5,15.7,-20.8,8.9,15.4,6.5,0.5,0.6,0.1,582.6,282.7,-299.9,110.3,103.9,-6.39999999999999,8.9,0.4,-8.5,124.1,16.3,-107.8,118.7,8.3,-110.4,7.4,0.7,-6.7,1021.6,558.3,-463.3,33.1,18.9,-14.2,1,0.1,-0.9,8,2.7,-5.3,1509.4,947.3,-562.1,1717.2,1436.8,-280.4,755.3,409.2,-346.1,,,,4.9,9,4.1,807,674.7,-132.3,81.9,6.2,-75.7,0,0,0,1,0.1,-0.9,5213.5,920.3,-4293.2,5.1,0.6,-4.5,0,0,0,1984.7,2238.6,253.9,847.5,1338.7,491.2,2734.7,1734.6,-1000.1,9894.5,5774.9,-4119.6,366.7,1258,891.3,0,0.1,0.1,0,0,0,0.1,0,-0.1,0,0,0,2,6.6,4.6,185.4,240.7,55.3,0.3,0.1,-0.2,0.5,0,-0.5,0,2.7,2.7,0.2,1.3,1.1,0,0.1,0.1,0.2,0,-0.2,0,0,0,0.1,0.3,0.2,0,0,0,6.3,3,-3.3,0,0,0,2.3,9.6,7.3,0,1.3,1.3,0.7,1.4,0.7,0.9,1.4,0.5,0.1,0,-0.1,6.3,1.9,-4.4,0.2,0.5,0.3,24.9,48,23.1,224.2,39.5,-184.7,3.7,23.4,19.7,0,0,0,43.4,264.6,221.2,0.8,4.5,3.7,,,,0,0.1,0.1,0,6.5,6.5,0,1.2,1.2,2.2,11.4,9.2,0.4,4.6,4.2,0.6,2.4,1.8,7.5,5.7,-1.8,2.6,1.8,-0.8,7.8,10.2,2.4,19.7,24.8,5.1,0.2,0.7,0.5,10.8,3.2,-7.6,4.2,2.4,-1.8,528.6,58,-470.6,0.1,0.1,0,167.3,8.8,-158.5,0.3,0.1,-0.2,0,0,0,0,0.4,0.4,0.1,4.2,4.1,236.3,24,-212.3,35.8,6.5,-29.3,0,0.1,0.1,0,0.4,0.4,0,3.9,3.9,0.3,2.5,2.2,14.8,3.3,-11.5,1.1,0,-1.1,1.5,0.4,-1.1,0,0.1,0.1,0,0,0,0.1,0.6,0.5,0,0.6,0.6,12.1,0.9,-11.2,7.6,9.3,1.7,0.2,0.2,0,0,0,0,1.9,3.3,1.4,17.8,3.2,-14.6,0.9,2.5,1.6,3.6,0.3,-3.3,,,,0,0,0,0.1,0.1,0,0,0,0,201.9,242.6,40.7,2.6,1.8,-0.8,1.6,4.5,2.9,5,1.5,-3.5,1.7,1,-0.7,5.6,9.1,3.5,3.7,1.4,-2.3,6.8,0.1,-6.7,0,11.8,11.8,0,0,0
1997-07-01,3690,2188.1,-1501.9,14865.8,10657.2,-4208.6,73330,59590,-13740,5198.1,0,-5198.1,6726.3,5082.7,-1643.6,13091,14917,1826,7741.1,6935.4,-805.700000000001,4743.3,5232,488.7,19397.7,17096.9,-2300.8,16701.737761,12103.177395,-4598.560366,1664.451593,1068.941552,-595.510041,28104.7,16609.9,-11494.8,74815.3,54910,-19905.3,31697.6,18174.8,-13522.8,,,,610,1230.1,620.099999999999,1391,470.4,-920.6,0.6,0.6,0,12374.8,11112.6,-1262.2,0,0.1,0.1,7022.9,5984.3,-1038.6,190.8,141.2,-49.6,6.1,8.7,2.6,135.5,114.1,-21.4,214.9,171.9,-43,42,20.2,-21.8,205.9,158.1,-47.8,38.2,122.2,84,0.8,30.3,29.5,6.5,66.5,60,0,0.3,0.3,65.3,109.9,44.6,0.2,4.8,4.6,1.5,20.2,18.7,17.8,47.2,29.4,404.6,333.9,-70.7,0,1.2,1.2,3.6,6.2,2.6,2.6,2.8,0.2,0.3,5.8,5.5,0.5,1.2,0.7,0.9,2.7,1.8,1.8,7.3,5.5,0.2,3.3,3.1,0.2,3.2,3,4.4,22.1,17.7,114.1,71.9,-42.2,45.6,46,0.399999999999999,,,,,,,51.3,22.7,-28.6,0.6,4.6,4,0,2.9,2.9,408.5,434.1,25.6,1064.3,602.6,-461.7,7.2,14,6.8,7.9,15.9,8,0,70.7,70.7,177.9,136.9,-41,191.1,170.3,-20.8,15.6,34.7,19.1,172.8,333.8,161,945.9,1315.3,369.4,3.8,66.4,62.6,26.4,53.5,27.1,165.7,430.4,264.7,0,0,0,20.7,18.2,-2.5,656.2,233.5,-422.7,0,0.1,0.1,353.7,138,-215.7,227,130.1,-96.9,1.3,0.1,-1.2,191.2,121.6,-69.6,2866.3,2749.4,-116.9,568.9,348.6,-220.3,692.3,1433.1,740.8,801.8,1009.6,207.8,19.9,27.5,7.6,0,1.3,1.3,2.3,0.5,-1.8,2057.3,1232,-825.3,3770.8,1812.6,-1958.2,209.5,126.8,-82.7,0,0,0,59.4,30.4,-29,17.4,13.6,-3.8,102.4,34.7,-67.7,9.4,0.5,-8.9,794.9,588.7,-206.2,3.8,2.5,-1.3,9.9,16.3,6.4,8.2,5.5,-2.7,65.4,66.5,1.09999999999999,0,0,0,352.9,263.7,-89.2,6.8,3.7,-3.1,36.6,27.9,-8.7,0.8,6,5.2,0.8,5.1,4.3,1.6,25,23.4,15.6,6.6,-9,0.1,2.5,2.4,2.5,3.1,0.6,0,1.4,1.4,0.1,0.5,0.4,0.5,6.8,6.3,411.6,374.2,-37.4,101.7,69,-32.7,0.2,0.3,0.1,16.7,11.3,-5.4,0,0.3,0.3,0,0.1,0.1,1948.4,690.1,-1258.3,0,0,0,9.8,23.7,13.9,27,6.2,-20.8,1,2.7,1.7,14.2,15.9,1.7,0.9,4.5,3.6,,,,,,,,,,1.7,0.2,-1.5,31.9,91.4,59.5,26,10.5,-15.5,15.9,4,-11.9,165.6,284.3,118.7,0.9,20.5,19.6,6.9,14,7.1,2.8,48,45.2,24.4,13,-11.4,0.1,0,-0.1,0,0,0,0,0,0,0,0.2,0.2,0.8,24.2,23.4,202.2,186.1,-16.1,0,0,0,735.9,562.7,-173.2,12.5,23.6,11.1,123.8,310.9,187.1,0.4,8.5,8.1,16.1,25.5,9.4,12.9,159,146.1,0.7,1.9,1.2,650.6,261.3,-389.3,138.8,60.4,-78.4,8.8,1.2,-7.6,168,18.5,-149.5,155.9,19.3,-136.6,10.6,3.1,-7.5,1150.1,539.4,-610.7,22.2,20.7,-1.5,1.5,0.2,-1.3,10.4,0.4,-10,1557,940.5,-616.5,1711.2,1558.5,-152.7,859.5,357.7,-501.8,,,,5.8,56.6,50.8,939,606.9,-332.1,106.6,4.9,-101.7,0,0,0,1.6,0.1,-1.5,5777.2,1097.1,-4680.1,2.5,0.6,-1.9,0,2,2,2215.6,2342.4,126.8,995.1,1244.3,249.2,2819.2,1790.3,-1028.9,10527.5,5408.7,-5118.8,443.5,1028.9,585.4,0,1,1,0,0,0,0.1,0,-0.1,0,0,0,3.4,21.6,18.2,144.2,151.5,7.30000000000001,0.1,0.1,0,0.1,0,-0.1,0,3,3,0.2,0.8,0.6,0,0.1,0.1,0,0,0,0,0,0,0,0.2,0.2,0,0,0,2.2,2.4,0.2,0,0,0,3.1,10,6.9,2.6,1.3,-1.3,1.2,3.4,2.2,1.5,1.6,0.1,0,0,0,7.6,3.7,-3.9,0.2,0.5,0.3,26.3,33.7,7.4,173.3,69.6,-103.7,6.6,15.9,9.3,0,0,0,66.6,479.4,412.8,1.3,6.3,5,,,,0,0,0,0.7,2,1.3,0,7.2,7.2,10,5.6,-4.4,0.5,6.8,6.3,0.3,2,1.7,17,6.6,-10.4,2.1,0.7,-1.4,14.5,11.9,-2.6,13.1,20.2,7.1,0.2,0.6,0.4,0.1,1.4,1.3,0.1,0.8,0.7,493.8,61.8,-432,0,0.1,0.1,206,12.7,-193.3,0.5,0.2,-0.3,0.3,0,-0.3,0.2,1.4,1.2,0.1,6.9,6.8,226.7,22.2,-204.5,26.5,10,-16.5,0,0.2,0.2,0,0.3,0.3,0.1,0.1,0,0,2.1,2.1,29.4,1.2,-28.2,4.6,0.2,-4.4,0.1,8.2,8.1,0,0.3,0.3,0,0,0,0.9,1.3,0.4,0,0.7,0.7,3.2,3.2,0,10.1,9.7,-0.4,0.2,0.5,0.3,0.2,0.1,-0.1,2.2,2.5,0.3,20.7,2.1,-18.6,1.1,0.9,-0.2,5.4,0.8,-4.6,,,,0.2,0,-0.2,0,0.3,0.3,0,0,0,239.2,222.7,-16.5,12,5.6,-6.4,1.9,1.6,-0.3,4.4,3.6,-0.8,3,0.6,-2.4,14,5.9,-8.1,3.8,0.9,-2.9,10.8,0.2,-10.6,0,2.9,2.9,0,0,0
1997-08-01,3746.4,2074.4,-1672,12521.8,11042,-1479.8,73623,58251,-15372,5288.9,0,-5288.9,7289.4,5059.8,-2229.6,12511,14387,1876,7599.3,6683.8,-915.5,4502,5443.9,941.9,20835.7,18526.6,-2309.1,14142.267995,12464.362997,-1677.904998,1660.808423,1328.204046,-332.604377,27824.5,16178.5,-11646,72925.3,56660.9,-16264.4,31195.3,17621.8,-13573.5,,,,587.7,1264.5,676.8,1378.5,603.8,-774.7,1.2,1.4,0.2,13556.4,12255.5,-1300.9,0.2,0,-0.2,7279.3,6271.1,-1008.2,141.5,139.9,-1.59999999999999,9.5,10.3,0.800000000000001,111.6,128.7,17.1,200.2,179.2,-21,41.1,25.9,-15.2,182.2,164.8,-17.4,35.6,133,97.4,0.8,22.8,22,11.5,73.3,61.8,0,3.9,3.9,52.9,118.2,65.3,0.6,5.2,4.6,1.4,22.9,21.5,15.6,43.6,28,386.5,346.2,-40.3,0,1.1,1.1,0.7,4.7,4,1.8,4,2.2,0.2,9.5,9.3,0.6,1.8,1.2,1.4,3,1.6,1.8,7.4,5.6,0.2,3.8,3.6,0.2,4.1,3.9,3.2,21.4,18.2,95.8,75.3,-20.5,37.4,36.8,-0.600000000000001,,,,,,,57.1,27.1,-30,0.1,4.1,4,0.1,2.4,2.3,413.1,454.9,41.8,1077.7,623.1,-454.6,6.9,10.9,4,10.1,13.9,3.8,1.1,2.7,1.6,172,128.9,-43.1,175,166.4,-8.59999999999999,20.5,40.2,19.7,187.6,338.6,151,837.1,1371.9,534.8,2.5,78.3,75.8,21.5,44.3,22.8,185.1,545.4,360.3,0.2,0,-0.2,16.4,15.5,-0.899999999999999,392.2,252.2,-140,0,0.1,0.1,257.3,140,-117.3,187.3,135.8,-51.5,0.9,0,-0.9,156.1,125.5,-30.6,2557.1,2599.2,42.0999999999999,434.4,384.7,-49.7,582.9,1513.1,930.2,483.7,1127.5,643.8,17.9,193.2,175.3,0,3.5,3.5,1.6,0.7,-0.9,1654.7,1233,-421.7,3353.7,1989.5,-1364.2,182.9,152.3,-30.6,0,0,0,52.8,38.9,-13.9,9.9,4.6,-5.3,94.3,27,-67.3,6.8,0.4,-6.4,597.2,513,-84.2,9.8,2.3,-7.5,2.9,24.9,22,11.5,8,-3.5,62.1,87.8,25.7,0,0,0,389.7,255.2,-134.5,6.7,3.8,-2.9,43.4,26.3,-17.1,0.6,1.8,1.2,0.5,7.1,6.6,0.2,9.8,9.6,11.7,85.8,74.1,0.2,9.3,9.1,5.2,0.7,-4.5,5.6,4.6,-1,0.1,0.6,0.5,2.3,7,4.7,418.5,335.4,-83.1,116.5,72.6,-43.9,0,0.1,0.1,15.9,5.8,-10.1,0,1.2,1.2,0.2,0,-0.2,1661.1,646.3,-1014.8,0,0,0,4.3,3.9,-0.4,20.9,7,-13.9,0.4,3.9,3.5,9.6,0.7,-8.9,1,4.5,3.5,,,,,,,,,,0.5,0.4,-0.1,41.8,59.4,17.6,62.5,22.8,-39.7,23.1,11.2,-11.9,172.6,288.2,115.6,0.9,15.9,15,1.2,11.6,10.4,2.6,46.2,43.6,0,7.8,7.8,0,0,0,0,0,0,0,0,0,0,0.4,0.4,0.8,27.6,26.8,152.9,151,-1.90000000000001,0,0,0,823,512.7,-310.3,15,49.4,34.4,48.5,179.4,130.9,0.6,15.3,14.7,14.8,28.9,14.1,9.5,23.3,13.8,1.2,0.6,-0.6,639.4,367,-272.4,137,95.7,-41.3,7,0.8,-6.2,168.6,27.1,-141.5,143.8,14.5,-129.3,10.8,0.7,-10.1,1149.1,589.4,-559.7,31,29.2,-1.8,1.1,0.1,-1,10.2,0.4,-9.8,1670.4,832,-838.4,1812,1673.7,-138.3,807.2,326.6,-480.6,,,,3.6,15.3,11.7,950.8,619.6,-331.2,96.6,3.6,-93,0.1,0,-0.1,1.7,0.5,-1.2,6073.6,938,-5135.6,4.8,1.5,-3.3,0,0,0,1942.8,1916.2,-26.5999999999999,971.9,1344.3,372.4,2872.6,1749.6,-1123,10062.7,5519.3,-4543.4,423.3,1052.7,629.4,0,0.7,0.7,0,0,0,0,0,0,0,0,0,3.5,19.7,16.2,133.5,167.8,34.3,0,0.1,0.1,0.2,0.1,-0.1,0,2.5,2.5,0.2,1.1,0.9,0.1,0.1,0,0,0,0,0,0,0,0.1,0,-0.1,0,0,0,6,3.7,-2.3,0,0,0,9.9,7.8,-2.1,1.2,0.8,-0.4,1.3,2.6,1.3,1.4,1.2,-0.2,0,0.1,0.1,6.7,2.1,-4.6,0.3,1.4,1.1,26.4,53.2,26.8,203.5,88.4,-115.1,2.5,22.1,19.6,0,0,0,49.9,560.4,510.5,0.2,3.1,2.9,,,,0,0,0,0.3,1.3,1,0.1,0.7,0.6,2.6,5.2,2.6,0.3,4.6,4.3,0.3,2,1.7,10.2,3.8,-6.4,1,0.2,-0.8,16.4,15.8,-0.599999999999998,6.6,26.7,20.1,0,0.4,0.4,0,1.9,1.9,0.2,2.2,2,618.6,135.9,-482.7,0,0.1,0.1,261,7.6,-253.4,0.4,0.1,-0.3,0,0,0,0,0.9,0.9,0.1,5.4,5.3,133.5,21.8,-111.7,9.9,4.5,-5.4,0,1,1,0,1.2,1.2,0,3.7,3.7,1.9,5.9,4,18.9,2.4,-16.5,0.2,0,-0.2,0,2.9,2.9,0,0.8,0.8,0,0,0,0,3.7,3.7,0,0.6,0.6,4.1,7.1,3,7.9,13.1,5.2,0.1,0.4,0.3,0,0,0,2.5,4,1.5,21.5,2.5,-19,9.7,2.5,-7.2,4.7,3.2,-1.5,,,,1.2,0,-1.2,0,0.1,0.1,0,0,0,198.1,277.1,79,2.8,2.2,-0.6,1.4,4,2.6,6.1,2.2,-3.9,2.1,0.4,-1.7,4.6,7.1,2.5,9.8,1.2,-8.6,5.2,0,-5.2,0,10.7,10.7,0,0,0
1997-09-01,3998,2287.5,-1710.5,12894.2,11833.8,-1060.4,74408,58605,-15803,5550.7,0,-5550.7,7417.8,5465.6,-1952.2,13879,15268,1389,8049.6,6073.9,-1975.7,4676.9,5393.3,716.400000000001,22180.3,19733.1,-2447.2,14682.45898,13164.575169,-1517.883811,1687.122984,949.801026,-737.321958,29074.1,15131.6,-13942.5,76750.9000000001,57470.4,-19280.5000000001,32947.7,16962.7,-15985,,,,575.1,1234.6,659.5,1425.6,533.6,-892,0.8,0.1,-0.7,14473.6,13407.3,-1066.3,0.4,0.1,-0.3,7706.7,6325.8,-1380.9,154.6,139.3,-15.3,4.9,8,3.1,124.7,100.1,-24.6,213,178.8,-34.2,39.6,18.9,-20.7,212.8,161.2,-51.6,30.4,119.8,89.4,1,21.9,20.9,14.2,65.2,51,0,0.1,0.1,77.3,124.6,47.3,0.9,4.2,3.3,1.4,22.7,21.3,16.8,45.9,29.1,395.9,323,-72.9,0,1.3,1.3,0.6,4.1,3.5,2.1,2.8,0.7,0.1,6.3,6.2,0.1,0.8,0.7,0.6,2.7,2.1,1.9,7.1,5.2,0.4,3.9,3.5,1,4.1,3.1,3.6,23.6,20,99.8,78.4,-21.4,32.8,31,-1.8,,,,,,,45.4,22.5,-22.9,0.4,3.3,2.9,0.1,2,1.9,392.8,402.6,9.80000000000001,1258.5,608.6,-649.9,14.6,12.5,-2.1,9.4,14.1,4.7,0.4,40,39.6,181.6,130.1,-51.5,172.3,183.2,10.9,17.6,29.4,11.8,170.8,368.3,197.5,762.2,1439.9,677.7,3.9,83.4,79.5,15.9,44.9,29,200.5,508.7,308.2,0,0,0,15.8,11,-4.8,589.7,272.4,-317.3,0,0,0,303.3,111,-192.3,190.4,129.9,-60.5,1.5,0,-1.5,188.3,137.5,-50.8,2730.4,2933.8,203.4,564.8,345,-219.8,674.2,1866.6,1192.4,723.4,1086.6,363.2,18.3,29.7,11.4,0,0.9,0.9,1.8,0.1,-1.7,1782.5,1283.9,-498.6,3199,2006.8,-1192.2,195.5,278.1,82.6,0,0,0,50.2,30.4,-19.8,15.8,5.2,-10.6,98.6,38.9,-59.7,11.9,1,-10.9,709.2,494.6,-214.6,14.2,5.5,-8.7,1.8,15.9,14.1,17.8,8.5,-9.3,64.4,82.4,18,0,0,0,446.3,309.1,-137.2,6.2,3.5,-2.7,33.5,48.6,15.1,0.5,7.5,7,0.5,4.1,3.6,0.2,25.7,25.5,17.8,6.4,-11.4,0,0.8,0.8,7.7,1.1,-6.6,0.6,1.5,0.9,0.3,0.6,0.3,2,13.9,11.9,308.9,384.5,75.6,92.4,53.4,-39,0.3,1.4,1.1,18.3,7.8,-10.5,0,0.3,0.3,0.2,0.1,-0.1,1304.8,687,-617.8,0,0,0,7.3,7.2,-0.0999999999999996,22.2,8,-14.2,0.7,1.5,0.8,9.4,1,-8.4,1.3,2.5,1.2,,,,,,,,,,0.4,0.1,-0.3,26.9,109.7,82.8,33.3,23,-10.3,14.7,13,-1.7,161.7,239.2,77.5,1.6,26.5,24.9,1.1,15.7,14.6,33.6,45.4,11.8,0,13.2,13.2,0,0,0,0,0,0,0,0,0,0,0,0,1.1,35.9,34.8,188.2,70.7,-117.5,0,0,0,869.3,748.5,-120.8,10.7,69.6,58.9,50.8,314.2,263.4,0.1,12.2,12.1,16.8,24.7,7.9,8.5,20,11.5,0.4,1.8,1.4,740.7,295.7,-445,144.5,139.4,-5.09999999999999,9.2,1.7,-7.5,213.9,18.9,-195,162.2,7.7,-154.5,9.9,1.8,-8.1,1179.9,751.1,-428.8,24.3,22.7,-1.6,0.7,0,-0.7,15.4,0.4,-15,1701.8,861.3,-840.5,1874.9,1526.7,-348.2,930.1,322.7,-607.4,,,,5.6,11.5,5.9,1020.2,578.2,-442,118.7,3.1,-115.6,0,0.1,0.1,1.9,0.3,-1.6,6561.4,1039.8,-5521.6,5.2,15.6,10.4,0,0.3,0.3,2094,1707.4,-386.6,1113,1231.4,118.4,2967.7,1608.4,-1359.3,10140.9,5037.6,-5103.3,424.7,1044.3,619.6,0,0.1,0.1,0,0.1,0.1,0,0,0,0,0.1,0.1,6.1,5.4,-0.699999999999999,115.1,153.7,38.6,0,0.1,0.1,0.6,0,-0.6,0,3.4,3.4,0.2,1.1,0.9,0.1,0.1,0,0,0,0,0.2,0,-0.2,0.1,0.4,0.3,0,0,0,4,4.6,0.6,0,0,0,2.8,9.1,6.3,0.6,1.6,1,0.7,2.4,1.7,1.3,1.5,0.2,0,0,0,18.4,6,-12.4,0.4,0.7,0.3,27.3,24.7,-2.6,176.7,68.5,-108.2,5.4,22.8,17.4,0,2.2,2.2,51.9,299.8,247.9,0.6,2.2,1.6,,,,0,0,0,0,4,4,0,0.3,0.3,2.6,6.3,3.7,0.6,3.9,3.3,0.3,3.6,3.3,16.7,7.9,-8.8,0.8,0.1,-0.7,9.8,13.6,3.8,8.4,26.6,18.2,0,0.5,0.5,0.1,2.6,2.5,0.1,9.1,9,513.6,71.6,-442,0,0.3,0.3,182.8,4.2,-178.6,0.4,1,0.6,0,0,0,0,1.7,1.7,0.1,7,6.9,215,21,-194,79.4,8.3,-71.1,0,0.3,0.3,0.1,0.6,0.5,0,0,0,0.9,1.8,0.9,26.6,2,-24.6,2.3,0,-2.3,0.3,3.1,2.8,0,0.2,0.2,0,0,0,0,0.6,0.6,0,0.2,0.2,2.6,2.1,-0.5,10.8,7.5,-3.3,0.1,1.3,1.2,0,0.1,0.1,3.2,3.4,0.2,33.2,2.6,-30.6,1.2,5.7,4.5,6.7,0.6,-6.1,,,,0.4,0,-0.4,0,0.1,0.1,0,0.3,0.3,256.5,283.6,27.1,6.7,0.5,-6.2,2.5,5.8,3.3,3.3,1.9,-1.4,7,0.6,-6.4,9.5,7.4,-2.1,10.1,1.1,-9,8.1,0.5,-7.6,0,31.9,31.9,0,0,0
1997-10-01,4038,2047.2,-1990.8,15134,12773.9,-2360.1,74641,58765,-15876,6053.9,0,-6053.9,7975.1,5896.7,-2078.4,13915,15787,1872,8031.1,6646.5,-1384.6,4711.4,6102.7,1391.3,23422.4,21258.3,-2164.1,16959.84684,14266.70234,-2693.1445,1812.135764,917.92475,-894.211014,30114.7,17011.3,-13103.4,81348.6000000001,62401.8000000001,-18946.8,33856.3,18416.7,-15439.6,,,,585.5,1308.1,722.599999999999,1471.9,533.8,-938.1,1,0.8,-0.2,14964,14093.1,-870.9,0.6,0.9,0.3,8458.4,7165.2,-1293.2,158.8,156.2,-2.60000000000002,6.8,12.3,5.5,123.7,124.6,0.899999999999991,215.6,165.5,-50.1,38.6,28.3,-10.3,213.9,188.6,-25.3,37.2,147.3,110.1,1.9,35.7,33.8,15.6,68.7,53.1,0,0.2,0.2,67,132.1,65.1,0.5,4.5,4,2,24.9,22.9,18.3,46.9,28.6,407,380,-27,0.1,2.1,2,0.6,6.1,5.5,2.9,3.1,0.2,0.7,6.4,5.7,0,1.4,1.4,0.8,2.3,1.5,1.6,7.7,6.1,0.6,10.3,9.7,1.4,5,3.6,3.4,25.4,22,94.1,147.1,53,44.4,41.2,-3.2,,,,,,,51.1,24.3,-26.8,0.1,4.7,4.6,1.4,7,5.6,428.2,508.2,80,1206.9,683.5,-523.4,10.5,12.4,1.9,11,19.8,8.8,0,77.5,77.5,209.6,151.4,-58.2,130.3,188.6,58.3,27,31,4,161.3,387,225.7,786.4,1568.1,781.7,5.6,92.2,86.6,14,46.1,32.1,210.5,527,316.5,0,0,0,22.6,14.6,-8,696.2,302,-394.2,0,0,0,310.1,121.5,-188.6,201.7,257.6,55.9,1.5,0,-1.5,199,177.9,-21.1,3208,2906,-302,544.6,425,-119.6,717.6,1931.5,1213.9,738.2,1175.8,437.6,20.9,29.9,9,0,1,1,2.1,0.3,-1.8,2008.1,1465.5,-542.6,3883.2,2136.6,-1746.6,236.7,180.7,-56,0,0,0,71,46.3,-24.7,13.8,4.5,-9.3,101.5,39.6,-61.9,15.4,0.6,-14.8,784.3,513.5,-270.8,4.1,7.5,3.4,7.7,17.6,9.9,12.7,6.4,-6.3,67.6,92.6,25,0,0,0,375.6,294.3,-81.3,4.5,5.8,1.3,32.4,29.3,-3.1,0.8,1.9,1.1,0.2,6.8,6.6,2.5,10.5,8,3.4,97.2,93.8,0.3,5.4,5.1,11.9,1.7,-10.2,0,3,3,0,28.6,28.6,0.2,3.5,3.3,384.3,544.3,160,121.7,84.5,-37.2,0.1,0.5,0.4,23.8,9.4,-14.4,0.1,0.5,0.4,0,0.2,0.2,1807.5,811.3,-996.2,0,0,0,3.6,10.7,7.1,25.5,9.4,-16.1,0.4,4.8,4.4,11.1,4.7,-6.4,0.6,5.8,5.2,,,,,,,,,,2.1,0.3,-1.8,36.1,92.5,56.4,33,28.6,-4.4,12.5,10.8,-1.7,194.1,286.5,92.4,2.4,19.7,17.3,1.8,18.7,16.9,4.8,37.5,32.7,76.1,8.2,-67.9,0,0,0,0,0,0,0,0.1,0.1,0,0,0,1,48.3,47.3,176.5,134.1,-42.4,0,0,0,838.1,550.4,-287.7,24.8,28.4,3.6,30.2,172.8,142.6,0.2,10.9,10.7,20.7,43.5,22.8,10.7,24.5,13.8,1,0.9,-0.1,794.6,280.1,-514.5,135.4,98.5,-36.9,5.9,7,1.1,186.6,21.4,-165.2,157.7,19.3,-138.4,11.1,0.6,-10.5,1171.7,677.3,-494.4,20.7,18.4,-2.3,1.9,0.1,-1.8,18.3,0.6,-17.7,1736.5,1200.3,-536.2,1772.5,1431.9,-340.6,881.8,360.7,-521.1,,,,6.5,6.7,0.2,967.4,648.9,-318.5,112.9,3.3,-109.6,0,0.1,0.1,2.1,0.4,-1.7,6606.5,1438.8,-5167.7,2.9,6.4,3.5,0,0,0,2112.5,2069.3,-43.1999999999998,1078.6,1288.9,210.3,3067.5,1856.4,-1211.1,11203.4,5424.1,-5779.3,462.8,1009.2,546.4,0,0.1,0.1,0,0.1,0.1,0,0,0,0,0,0,2.6,9.9,7.3,103.3,262.9,159.6,0.1,0.1,0,0.1,0.1,0,0,3.5,3.5,0.2,0.8,0.6,0,0.4,0.4,0.1,0.1,0,0,0,0,0.1,0.3,0.2,0,0,0,3.2,3.1,-0.1,0,0,0,1.2,9.3,8.1,0,2.5,2.5,1.2,2,0.8,1.1,1,-0.1,0,0,0,9.1,2.1,-7,0.4,0.6,0.2,26.5,55,28.5,232.9,51.8,-181.1,10.1,22.9,12.8,0,0,0,70.4,254.1,183.7,2.5,3.5,1,,,,0,0,0,28.2,1.1,-27.1,0,3,3,7.8,5.9,-1.9,0.5,5.8,5.3,0.3,2.2,1.9,9,10.5,1.5,1.5,0.6,-0.9,7.6,14.6,7,10.3,21.5,11.2,0.3,1.3,1,0.1,3,2.9,0.1,1.3,1.2,570.6,57.3,-513.3,0,0.4,0.4,191.8,7.7,-184.1,0.3,0.2,-0.1,0.2,0,-0.2,0.3,3.4,3.1,0.1,4,3.9,277.3,25.4,-251.9,17.5,10.5,-7,0,0.1,0.1,0,0.5,0.5,0,1.3,1.3,0.1,6.8,6.7,13.1,1.9,-11.2,1,0,-1,0,0.8,0.8,0,0.1,0.1,0,0,0,0,0.7,0.7,0,0.8,0.8,0.9,1.3,0.4,8,10.4,2.4,0.1,0.9,0.8,0,0,0,2.7,7.2,4.5,32.8,1.3,-31.5,1.9,4.6,2.7,5.1,0.8,-4.3,,,,0.1,0,-0.1,0.1,0.3,0.2,0,0.1,0.1,231.4,269.3,37.9,4,6.3,2.3,2.7,5.4,2.7,2.1,3.3,1.2,3,0.4,-2.6,11.6,7.1,-4.5,13.7,1.1,-12.6,6.5,0.6,-5.9,0,129.3,129.3,0,76.4,76.4
1997-11-01,3520,2101.2,-1418.8,13311.3,11994.2,-1317.1,73588,57657,-15931,5464,0,-5464,7497.5,5086.3,-2411.2,12037,14638,2601,7070.7,6147.6,-923.099999999999,4097.9,5769.2,1671.3,21702.7,19485.4,-2217.3,14986.334568,13392.41256,-1593.922008,1490.061628,848.959088,-641.10254,26052.6,15862,-10190.6,72049.4,58162.9,-13886.5,29274.7,17428.7,-11846,,,,497.2,1146.5,649.3,1236.1,502,-734.1,0.3,0.2,-0.1,14184.3,12867.1,-1317.2,0.2,0.3,0.1,7518.4,6618.3,-900.099999999999,149,152,3,5,8.3,3.3,98.1,154,55.9,185.1,191,5.90000000000001,28.9,26.7,-2.2,185.8,185.6,-0.200000000000017,28.2,136.2,108,0.8,25.3,24.5,10.6,72.7,62.1,0,3.4,3.4,52.6,129.8,77.2,0.6,4.1,3.5,0.2,23.6,23.4,15.1,45.7,30.6,325.2,323.4,-1.80000000000001,0.2,1.5,1.3,0.8,4.6,3.8,2.7,3.1,0.4,0.3,6.1,5.8,0,0.6,0.6,0.4,2.8,2.4,1.6,10,8.4,0.5,6.4,5.9,1.1,4,2.9,3.9,28.6,24.7,62.3,114.6,52.3,36.9,41.4,4.5,,,,,,,25.7,16.7,-9,0,4.9,4.9,0.2,2.7,2.5,406.1,419.6,13.5,1135.2,620.6,-514.6,9,12,3,3.8,15.8,12,0.4,79.8,79.4,126.6,133.4,6.80000000000001,132.9,162.6,29.7,18.7,19.3,0.600000000000001,139.5,368.7,229.2,721.8,1484.9,763.1,2.9,65.5,62.6,12.5,47.5,35,166.7,609.7,443,0,0,0,25.2,13.7,-11.5,588.4,286.6,-301.8,0,0.2,0.2,324.4,112.2,-212.2,213.9,178.3,-35.6,1.9,0,-1.9,185.3,124.8,-60.5,2603,2841.1,238.1,598.9,465.8,-133.1,552.7,1669.3,1116.6,647.6,1192.2,544.6,20.9,29.7,8.8,0.1,1.1,1,1.2,0.3,-0.9,1629.3,1390.6,-238.7,3667.3,2007.5,-1659.8,187.2,153.7,-33.5,0,0,0,47.8,40.4,-7.4,12.8,5.1,-7.7,91.3,46.7,-44.6,12.5,0.2,-12.3,745.6,411.8,-333.8,9.9,8.1,-1.8,5.5,13.4,7.9,4.2,5.6,1.4,52.2,82.8,30.6,0,0,0,310.1,444.5,134.4,4.3,3.7,-0.6,20.8,22.7,1.9,0.7,6.7,6,0.5,4.3,3.8,0.1,16.1,16,0.7,7.3,6.6,0.2,3.1,2.9,11.1,1.2,-9.9,0.4,1.8,1.4,0,0.4,0.4,0.6,8.1,7.5,398.8,482.1,83.3,86.9,81,-5.90000000000001,0.1,0.1,0,20.3,9.8,-10.5,0,0.3,0.3,0,0.2,0.2,1634.4,768.5,-865.9,0,0,0,4.1,23.6,19.5,19.7,18.5,-1.2,0.4,1.4,1,13.2,3.7,-9.5,0.9,3.6,2.7,,,,,,,,,,0.6,0.3,-0.3,31.1,74.5,43.4,31.3,33.6,2.3,9,9.3,0.300000000000001,154.9,262.6,107.7,2.2,18.1,15.9,0.9,20.7,19.8,4.6,47.2,42.6,67.8,11.9,-55.9,0,0,0,0,0,0,0,0.1,0.1,0,0.1,0.1,1.7,39.5,37.8,143.9,133.4,-10.5,0,0,0,776.6,586.7,-189.9,10.4,48.6,38.2,45.9,172.2,126.3,0.2,7.4,7.2,13.6,42.7,29.1,15.4,30.6,15.2,0.7,2.8,2.1,516.3,286.5,-229.8,117.7,79.5,-38.2,6.2,0.8,-5.4,121.9,26.8,-95.1,110.6,17.5,-93.1,8.1,1.8,-6.3,1056.2,647.9,-408.3,24.6,26,1.4,0.9,0.8,-0.1,14.6,1.5,-13.1,1514.6,799.5,-715.1,1527.8,1391.2,-136.6,760.1,422.1,-338,,,,3,8.2,5.2,931.7,606.9,-324.8,74.6,21.3,-53.3,0.1,0,-0.1,2.2,0.1,-2.1,5425.7,1300.7,-4125,3.1,1.2,-1.9,0,0.1,0.1,1880.4,1821.7,-58.7,906.1,1249.8,343.7,2756.4,1685,-1071.4,9790,5433.4,-4356.6,387.1,964.9,577.8,0,0.1,0.1,0,0,0,0,0,0,0,0,0,3.9,5.4,1.5,91.1,151.8,60.7,0,0,0,0.3,0,-0.3,0,2.6,2.6,0.2,0.6,0.4,0.1,0.5,0.4,0,0.1,0.1,0,0,0,0,0.2,0.2,0,0,0,3.9,3,-0.9,0,0,0,2.2,6.6,4.4,0.1,2.2,2.1,0.6,4,3.4,0.7,1.5,0.8,0,0,0,6.7,2.5,-4.2,0.3,0.5,0.2,23.8,28.6,4.8,174.9,49.9,-125,4.2,32.7,28.5,0,5.1,5.1,50.9,235.4,184.5,0.4,3.1,2.7,,,,0,0,0,0.6,4.4,3.8,0,0.5,0.5,1.5,49.3,47.8,0.4,6.8,6.4,0.5,1.3,0.8,7.4,7,-0.4,1.3,0.1,-1.2,7,13.3,6.3,13.8,18.6,4.8,0.3,0.3,0,3.1,2.8,-0.3,0.1,1.2,1.1,405.2,55.8,-349.4,0,0.2,0.2,175.4,6,-169.4,0,0.3,0.3,0,0,0,0,0.9,0.9,0.1,3.7,3.6,249.5,21.1,-228.4,24.6,7.8,-16.8,0,0.1,0.1,0,0.6,0.6,0,0.1,0.1,0,2.7,2.7,26.7,2.2,-24.5,1.4,0.1,-1.3,0,3.3,3.3,0,0.2,0.2,0,0,0,0.1,1.9,1.8,0,1.2,1.2,1.2,5.1,3.9,7,15.3,8.3,0.4,0.7,0.3,0,0,0,3.3,6.3,3,17,2.4,-14.6,6,4.5,-1.5,4.6,0.8,-3.8,,,,0,0,0,0,0.1,0.1,0,0.2,0.2,228.4,218.7,-9.70000000000002,1.8,0.5,-1.3,2.5,4.4,1.9,6.2,1.3,-4.9,1.9,0.1,-1.8,18.2,4.5,-13.7,8.1,2.5,-5.6,6.7,0.1,-6.6,0,91.4,91.4,0,0,0
1997-12-01,3401.9,3424.8,22.9000000000001,14853,12816.9,-2036.1,75056,58247,-16809,5036.7,0,-5036.7,7769.7,5009.7,-2760,13588,17497,3909,7504.3,6552.7,-951.6,4562.1,5539.5,977.4,21111.6,18721.1,-2390.5,16834.819894,14217.620267,-2617.199627,1389.744684,953.4001,-436.344584,26854.3,16028.1,-10826.2,74670.3,59663.7,-15006.6,30235.5,19051.8,-11183.7,,,,535,1138.1,603.1,1140.6,516.5,-624.1,0.7,0.1,-0.6,14155.1,12422.4,-1732.7,0.5,0.1,-0.4,6956.5,6298.7,-657.8,198.5,151.7,-46.8,3.9,9,5.1,123.9,102.7,-21.2,228,161.3,-66.7,35.8,21.3,-14.5,203.1,184,-19.1,24.9,127.8,102.9,20.7,27.1,6.4,15.2,71.7,56.5,0,0.4,0.4,61.9,108.6,46.7,0.6,4.4,3.8,0.3,24.8,24.5,19.1,46.4,27.3,394.9,310.3,-84.6,0.1,1.4,1.3,0.8,5.1,4.3,2.3,3.3,1,0.3,12.6,12.3,0,0.4,0.4,0.6,6.9,6.3,2.1,8.7,6.6,0.2,5.1,4.9,1.1,4.8,3.7,3.2,25.6,22.4,90.5,87.1,-3.40000000000001,27.2,43.2,16,,,,,,,45.4,16.9,-28.5,0,3.6,3.6,0,1.7,1.7,439.7,423,-16.7,1125.1,500,-625.1,10.3,11.8,1.5,10.5,14.4,3.9,0,72.8,72.8,152,119,-33,156.2,183.7,27.5,17.4,25.4,8,196.7,477.8,281.1,739.2,1466,726.8,4.8,56.7,51.9,16.6,53.4,36.8,189,557.6,368.6,0,0,0,20.9,12.6,-8.3,680.8,309.1,-371.7,0,0,0,334,149.4,-184.6,187.3,155.5,-31.8,1.9,0.4,-1.5,199.2,137.2,-62,3073.1,3319.9,246.8,546.6,472.6,-74,684.7,1764,1079.3,668.3,1115.3,447,22.8,206,183.2,0.1,4.2,4.1,1.6,2.3,0.7,1890.6,1460.1,-430.5,4119.4,1989,-2130.4,184.3,183.4,-0.900000000000006,0,0,0,50.4,36.7,-13.7,12.3,6,-6.3,115.2,50.1,-65.1,14.7,0.6,-14.1,798.8,547.6,-251.2,3.6,4.6,1,1.8,24.5,22.7,4.3,12.2,7.9,66,77,11,0,0,0,510,250.5,-259.5,5.7,3.3,-2.4,34.9,25,-9.9,0.7,5,4.3,0.4,5.9,5.5,1.1,10.2,9.1,16.2,7.9,-8.3,0,1.4,1.4,7.2,3.3,-3.9,0.1,3.1,3,0,17.9,17.9,0.9,13.1,12.2,413.7,500.5,86.8,94.6,75,-19.6,0,0.2,0.2,20.8,20.6,-0.199999999999999,0.1,0.4,0.3,0.1,0,-0.1,1754.8,799.6,-955.2,0,0,0,8.5,10.9,2.4,24.6,11.3,-13.3,0.5,4.1,3.6,13.6,1.5,-12.1,1.1,10.7,9.6,,,,,,,,,,0.8,0.3,-0.5,33,75.7,42.7,28.1,18.6,-9.5,16.6,6.9,-9.7,163.1,283.6,120.5,1,10.8,9.8,2.8,18.9,16.1,4.8,44.9,40.1,48.9,14.8,-34.1,0,0,0,0,0,0,0,0,0,0,0,0,1,38.7,37.7,137,88.5,-48.5,0,0,0,768,2002.9,1234.9,22.8,29.4,6.6,47.2,163.8,116.6,0.4,3.5,3.1,23,54.2,31.2,12.5,41.7,29.2,2,0.3,-1.7,566.1,268.8,-297.3,133.5,108.9,-24.6,10.3,6.4,-3.9,112.7,19.2,-93.5,137.5,17,-120.5,10.5,0.5,-10,1149.7,522.7,-627,45.8,25.9,-19.9,1.2,0.1,-1.1,16.2,1.2,-15,1543.4,837.1,-706.3,1678.9,1416.1,-262.8,733.5,470.3,-263.2,,,,4.8,8.9,4.1,924.5,593.1,-331.4,89,4.2,-84.8,0,0.1,0.1,3.3,2.2,-1.1,5101.1,1232.7,-3868.4,4.2,1.3,-2.9,0,0,0,2019.3,1633.5,-385.8,848.4,1309.8,461.4,2957.7,2193.4,-764.3,10431.6,5215.7,-5215.9,403.1,968.4,565.3,0,0.6,0.6,0,0.1,0.1,0,0.1,0.1,0.1,0,-0.1,7.2,6.5,-0.7,111.7,138.5,26.8,0.4,0.4,0,0.1,0,-0.1,0,4.8,4.8,0.2,0.9,0.7,0,0.2,0.2,0,0,0,0,0,0,0.1,0.3,0.2,0,0,0,1.4,2.4,1,0,0,0,2.6,7.4,4.8,0.1,1.7,1.6,0.9,1.4,0.5,1.3,0.9,-0.4,0,0,0,5.7,2.4,-3.3,0.2,1.1,0.9,27,35.8,8.8,138.4,77.6,-60.8,5.8,19.8,14,0,10.7,10.7,78.2,303,224.8,0.1,0,-0.1,,,,0,0,0,0.1,8.2,8.1,0,1.1,1.1,7.3,4.4,-2.9,0.5,3.3,2.8,0.4,2.4,2,7.9,9.5,1.6,1.6,0,-1.6,55.3,17,-38.3,15.1,30.8,15.7,0.6,0.6,0,0.1,1.7,1.6,0.1,1.1,1,381,77.6,-303.4,0.1,0.1,0,137.1,5.8,-131.3,0.5,0.1,-0.4,0,0.2,0.2,0.3,2,1.7,3.5,3.6,0.1,138.3,20.9,-117.4,41.7,5.8,-35.9,0,0.4,0.4,0.1,0.4,0.3,0,0,0,0.1,2.4,2.3,15.3,2.9,-12.4,3.2,0.1,-3.1,0.5,1,0.5,0,0.7,0.7,0,0,0,0,2.2,2.2,0,0.9,0.9,2.1,2.1,0,11.8,9.2,-2.6,0.2,0.3,0.1,0,0,0,2.3,5.2,2.9,20.1,1.8,-18.3,1.5,5.5,4,8.7,0.3,-8.4,,,,0,0,0,0,0.1,0.1,0,0,0,230.9,258,27.1,8.4,3.3,-5.1,1.7,1.6,-0.0999999999999999,2.7,1.4,-1.3,9.7,0.2,-9.5,10.7,5.5,-5.2,7,0.7,-6.3,9.5,0.1,-9.4,0,42.4,42.4,0,0,0
1998-01-01,3252.2,2376.2,-876,12883.4,12269.4,-614,74523,58296,-16227,4904.4,0,-4904.4,8194.2,4861.2,-3333,11413,14177,2764,7158.3,4971.6,-2186.7,4049.1,4943.5,894.4,20234.1,18352,-1882.1,14572.695771,13578.763729,-993.932042000006,1574.099372,965.19386,-608.905512,25768.9,14291,-11477.9,70223.9000000001,55171.5,-15052.4000000001,29281.3,16200,-13081.3,,,,512.6,1132.3,619.699999999999,1309.9,495.9,-814,0.3,0,-0.3,13228.5,12117.8,-1110.7,0,0.1,0.1,7005.6,6234.2,-771.400000000001,165.4,160.1,-5.30000000000001,7.9,11.3,3.4,99.4,108.3,8.89999999999999,163.7,160.1,-3.59999999999999,33.2,26.9,-6.3,166.7,177.2,10.5,21.6,146.4,124.8,0.4,28.1,27.7,14.5,64.8,50.3,0,0,0,58.2,107.4,49.2,0.3,5,4.7,3.3,21.8,18.5,14.3,38.4,24.1,204.2,262.3,58.1,0,1.3,1.3,0.5,6.4,5.9,1.8,3,1.2,0.2,8.2,8,0,0.3,0.3,0.3,4.2,3.9,1.2,7.8,6.6,0.4,35.8,35.4,0.6,4.5,3.9,1.9,20.3,18.4,78,88.5,10.5,21.9,47.2,25.3,,,,,,,60.5,22.8,-37.7,0.8,4.2,3.4,0,3.4,3.4,447.4,401.3,-46.1,918,608.3,-309.7,13.6,9.6,-4,13.2,14.9,1.7,2.2,0.8,-1.4,147.8,122.8,-25,125.5,165.5,40,17.9,22.6,4.7,205,330.4,125.4,799.3,1123.2,323.9,3.5,60.2,56.7,27,40.5,13.5,207.2,467.5,260.3,0,0,0,15.4,75.9,60.5,506.6,253.4,-253.2,0,0,0,239.7,138.5,-101.2,223.1,124,-99.1,1.1,0,-1.1,160.8,126.5,-34.3,2658.9,2950.9,292,624.2,519.3,-104.9,564.5,1707.2,1142.7,625.9,1207.6,581.7,23.5,33.3,9.8,0,4.4,4.4,0.6,0.8,0.2,1661.4,1501,-160.4,3290.9,1979.6,-1311.3,190.7,149.8,-40.9,,,,52.5,34.6,-17.9,13,3,-10,91.3,35.2,-56.1,10.9,0.9,-10,613.6,448.2,-165.4,4.6,2.9,-1.7,5.2,12.2,7,4.3,4.8,0.5,72.5,79.5,7,,,,418.7,247.1,-171.6,6.5,2.1,-4.4,42.8,29.2,-13.6,1.8,2,0.2,0.8,9.5,8.7,0.2,16.4,16.2,7,5.6,-1.4,0.1,1.4,1.3,5.1,1.1,-4,0,0,0,0.1,3.8,3.7,0.6,2.8,2.2,380.6,536.6,156,84.5,71.5,-13,0.3,1.4,1.1,26.5,10.1,-16.4,0.1,0.1,0,0,0.1,0.1,1558.2,812.9,-745.3,,,,2.7,5.2,2.5,22.9,8.5,-14.4,0.7,2.4,1.7,18.3,0.5,-17.8,1.2,11.9,10.7,,,,,,,,,,0.7,0.5,-0.2,34.8,80.2,45.4,29.7,23.4,-6.3,55.9,20.1,-35.8,214.8,254,39.2,2,24.7,22.7,3.4,10.4,7,6,39.6,33.6,24.6,36.9,12.3,0,0,0,183.7,327.2,143.5,0,0,0,0,0.2,0.2,0.9,20.3,19.4,139,112,-27,,,,713,944.4,231.4,21.6,45,23.4,47.5,200.8,153.3,0.6,11.3,10.7,30.5,30.6,0.100000000000001,15.9,36.5,20.6,0.3,0.3,0,652.1,241.1,-411,140,92.9,-47.1,12.5,0.4,-12.1,165.6,31.8,-133.8,167.8,11.6,-156.2,17,0.7,-16.3,1032.8,560.9,-471.9,55.1,18.5,-36.6,1.3,1.2,-0.1,19.3,0.7,-18.6,1416.6,902.6,-514,1489.5,1203,-286.5,798.8,283.4,-515.4,,,,5.3,5.1,-0.2,913.9,583,-330.9,105,3.6,-101.4,0,0,0,3,0.6,-2.4,5453.2,1271.1,-4182.1,2.7,0.2,-2.5,0,0,0,1953.8,1088.8,-865,960.1,1024.5,64.4,2755,1655.4,-1099.6,9426.1,5161,-4265.1,353.6,927.2,573.6,0,0,0,0,0,0,0,0,0,0,0,0,7.5,6.6,-0.9,130.6,175.7,45.1,0,0.1,0.1,0.1,0,-0.1,0,0.2,0.2,0.3,0.8,0.5,0,1,1,0.1,0,-0.1,0,0,0,0,0.4,0.4,0,0,0,3.6,2,-1.6,0,0,0,3,7.3,4.3,0.1,1.7,1.6,0.8,2.1,1.3,2.1,1.3,-0.8,0,0,0,10.7,2.3,-8.4,0.1,3.6,3.5,26.1,44.7,18.6,175.5,80.5,-95,4.5,26.7,22.2,0,0,0,57.9,316.7,258.8,2.1,0,-2.1,,,,0,0,0,10,7.3,-2.7,0,0.5,0.5,5,10.9,5.9,0.8,2.8,2,0.4,1.2,0.8,11.2,4.3,-6.9,2.4,0.2,-2.2,76.3,20.4,-55.9,17.2,18.5,1.3,0.5,0.6,0.1,0.2,1.9,1.7,0.1,1.5,1.4,414.2,65,-349.2,0,0.2,0.2,179.2,4.1,-175.1,0.1,0.1,0,0,0,0,0,0.5,0.5,0,2.1,2.1,242,43.1,-198.9,2.3,20.4,18.1,0.1,0.1,0,0,1,1,0,0.1,0.1,0,2.7,2.7,21.1,3.9,-17.2,2.1,0.1,-2,0.4,2.5,2.1,0,0,0,0,0.4,0.4,0,0.3,0.3,0,0.8,0.8,2,1.1,-0.9,7.7,14.9,7.2,0.1,0.2,0.1,0.1,0,-0.1,3.8,2.5,-1.3,18.1,1.8,-16.3,0.6,1.2,0.6,8.1,1,-7.1,,,,0,0,0,0,0.3,0.3,0,0.1,0.1,229.3,235.5,6.19999999999999,10.5,1.2,-9.3,1.3,6.6,5.3,3.6,1.7,-1.9,1.7,0,-1.7,12.6,5.6,-7,8.3,0.4,-7.9,11.9,0,-11.9,0,0,0,0,0,0
1998-02-01,2587.1,1974.8,-612.3,12954.5,12840.7,-113.799999999999,74184,57456,-16728,5028.8,0,-5028.8,9138.1,4675.6,-4462.5,11141,14083,2942,6043.6,5118.8,-924.8,3968.1,5000.5,1032.4,20926.5,19345.1,-1581.4,14553.718276,14027.483274,-526.235001999999,1338.099307,757.31406,-580.785247,24074.3,13415,-10659.3,68394.0000000001,55233.2,-13160.8000000001,27036.7,14844.1,-12192.6,,,,570.7,1259.1,688.4,1095.6,475.1,-620.5,0.2,0,-0.2,13966.8,12924,-1042.8,0.3,0,-0.3,6959.7,6421.1,-538.599999999999,176.8,145.5,-31.3,3.8,9.7,5.9,130.9,115.5,-15.4,224.7,178.4,-46.3,35.5,22.6,-12.9,195.2,189.9,-5.29999999999998,21.1,135.7,114.6,0.9,35.1,34.2,13.2,69.1,55.9,0,0.5,0.5,58.2,103.4,45.2,0.3,4.3,4,2.1,23.1,21,19.9,36.6,16.7,357.1,318,-39.1,0.1,1.8,1.7,0.3,4,3.7,2.2,3.5,1.3,0.1,7.8,7.7,0,0.2,0.2,0.2,4.9,4.7,1.8,8,6.2,0.2,48.5,48.3,0.9,4.7,3.8,3.1,19.6,16.5,80.2,85.3,5.09999999999999,27.8,41,13.2,,,,,,,51.4,15.7,-35.7,0.1,4.9,4.8,0,2.2,2.2,361.1,416.4,55.3,793.2,609.2,-184,11.8,10,-1.8,2.8,13.4,10.6,0,66.4,66.4,149.6,132.3,-17.3,117.8,189.7,71.9,13.4,26.7,13.3,218.6,310.8,92.2,701.9,1077.9,376,2.3,47.1,44.8,19.6,35.4,15.8,167.8,425.3,257.5,0,0.2,0.2,20.2,14.3,-5.9,572.4,288.9,-283.5,0,0.3,0.3,192.5,122.1,-70.4,182.1,159.2,-22.9,1.2,0.1,-1.1,183.1,163.7,-19.4,2549.7,3312.8,763.1,502.8,461.7,-41.1,536.2,1679,1142.8,694.5,1240.4,545.9,26.1,35.5,9.4,0,1.6,1.6,0.8,1.5,0.7,1675.4,1478.3,-197.1,3509.8,2139.2,-1370.6,194.3,207.5,13.2,,,,58.7,31.4,-27.3,10.3,4.6,-5.7,87.9,42.8,-45.1,17.3,0.4,-16.9,637.8,422.2,-215.6,3.6,3.1,-0.5,5.3,16.1,10.8,7.2,3.6,-3.6,59.1,78.3,19.2,,,,405,257.1,-147.9,11.8,4.2,-7.6,22.2,23.6,1.4,0.4,14.8,14.4,0,8.9,8.9,0.4,11,10.6,17.9,6.7,-11.2,0,1.1,1.1,11.5,0.9,-10.6,0.5,0.4,-0.1,0,7.2,7.2,0.7,2.9,2.2,348.6,461.3,112.7,96.9,68.2,-28.7,0,0.5,0.5,22.9,13.4,-9.5,0,0.7,0.7,0,0.3,0.3,1579.3,757.9,-821.4,,,,12.5,12.9,0.4,19.1,10.4,-8.7,0.7,0.6,-0.1,9.3,0.9,-8.4,0.6,7.3,6.7,,,,,,,,,,0.9,0.2,-0.7,27.1,162.5,135.4,40.6,17.4,-23.2,12.1,9.8,-2.3,182.2,234.6,52.4,1.9,21.1,19.2,3,18.5,15.5,4.2,45.1,40.9,0,6.1,6.1,0,0,0,169.7,198.5,28.8,0,0,0,0,0,0,0.5,21,20.5,97.6,70.1,-27.5,,,,480.7,831.2,350.5,18.9,35,16.1,73.7,152.3,78.6,0.2,9.1,8.9,20.5,23.9,3.4,13.7,27.3,13.6,10.4,0.5,-9.9,641,208.2,-432.8,143.6,46.8,-96.8,13.2,0.3,-12.9,155.4,21.7,-133.7,139.6,13.4,-126.2,11.8,1.2,-10.6,977.2,409.8,-567.4,32.9,23.4,-9.5,2.6,0.2,-2.4,20,0.7,-19.3,1319,654.2,-664.8,1341.2,1359.3,18.0999999999999,666.4,163.1,-503.3,,,,7,4.3,-2.7,944.8,578.5,-366.3,68.5,2.8,-65.7,0,0.2,0.2,2.9,0.9,-2,4559.6,1019.3,-3540.3,2.5,2.3,-0.2,0,0,0,1726.1,1126.5,-599.6,649.3,1035.6,386.3,2327.2,1597.4,-729.8,9909.8,4635.9,-5273.9,437.1,1092.9,655.8,0,0.6,0.6,0,0,0,0,0.1,0.1,0,0,0,1.9,4.2,2.3,116.6,141,24.4,0.1,0.2,0.1,0.2,0.2,0,0,0.2,0.2,0.4,0.6,0.2,0,0.6,0.6,0,0,0,0,0,0,0.1,0.5,0.4,0,0,0,3.1,2,-1.1,0,0,0,1.5,7.7,6.2,0.5,1.4,0.9,0.9,1.5,0.6,0.5,0.9,0.4,0,0,0,7.7,3.2,-4.5,0.1,1.3,1.2,23.5,19.1,-4.4,155.8,42.9,-112.9,8.7,24.9,16.2,0,0,0,54.6,194.9,140.3,0.5,0.1,-0.4,,,,0,0,0,14.5,2.9,-11.6,0.1,2.9,2.8,2.3,4.8,2.5,0.5,5.1,4.6,0.1,3,2.9,8.3,6.3,-2,0.8,0.6,-0.2,81.5,12.2,-69.3,6,28.1,22.1,0.2,0.5,0.3,0,1,1,0.1,0.8,0.7,300.8,65.1,-235.7,0.1,0.4,0.3,127.8,3.4,-124.4,0.2,1.1,0.9,0,0,0,0.1,0.6,0.5,0.1,2,1.9,183.3,31.1,-152.2,43.8,3.4,-40.4,0,0.2,0.2,0,0.9,0.9,0,3.7,3.7,3.6,2.6,-1,9.5,3,-6.5,0.3,0,-0.3,0,1.2,1.2,0,0.1,0.1,0,0,0,0,0.7,0.7,0,0.7,0.7,1.1,1.5,0.4,6.5,24.7,18.2,0.1,1.1,1,0,0,0,2.4,3.1,0.7,19.4,1,-18.4,0.8,7.8,7,4.1,0.7,-3.4,,,,0.2,0.1,-0.1,0,0.2,0.2,0,0.1,0.1,238.7,223.3,-15.4,1.3,2.1,0.8,1.5,6.5,5,3.8,1.1,-2.7,2.6,0.3,-2.3,15.4,5.3,-10.1,0.6,0.6,0,6.5,0,-6.5,0,0,0,0,0,0
1998-03-01,2907.7,2475.7,-432,15970.6,14479.3,-1491.3,76369,57814,-18555,6056.8,0,-6056.8,10011.9,5320.7,-4691.2,13835,16971,3136,7070.1,5449.1,-1621,4218,5721.7,1503.7,23717.7,21484.5,-2233.2,17836.088522,16226.503758,-1609.58476399999,1420.81109,876.558307,-544.252783,26810.7,14744.4,-12066.3,78095.7,62297.9,-15797.8,30260.5,16640.6,-13619.9,,,,641.5,1345.3,703.8,1203.5,541.1,-662.4,0.8,0.2,-0.6,15392.1,14573.1,-819,0.3,0,-0.3,8325.6,6911.4,-1414.2,192,171.2,-20.8,3.7,10.1,6.4,133.9,148.2,14.3,263.4,223.7,-39.7,43.3,30.7,-12.6,213.8,199.2,-14.6,23.1,158.4,135.3,0.8,32.5,31.7,14.8,84.1,69.3,0,0.1,0.1,71.8,112.9,41.1,0.3,4.2,3.9,1,25.8,24.8,21.8,46.1,24.3,397.3,369.6,-27.7,0.1,2.1,2,0.4,4.9,4.5,3,3.6,0.6,0.2,12.3,12.1,0,0.5,0.5,0.6,2.9,2.3,2,8.7,6.7,0.3,45.6,45.3,1,4.1,3.1,3.5,24.5,21,76,114,38,24.4,44.9,20.5,,,,,,,41,21.4,-19.6,0.1,5.5,5.4,0.1,2.7,2.6,370.8,495.7,124.9,768.5,664.9,-103.6,11.6,14.3,2.7,9,14.9,5.9,0.1,3,2.9,157.5,147.1,-10.4,116.1,179.8,63.7,22.1,30.6,8.5,245.2,293.9,48.7,779.6,1293.7,514.1,3.7,95.3,91.6,15.9,54.7,38.8,184.2,517,332.8,0,2.4,2.4,15.3,15.2,-0.100000000000001,663,340.1,-322.9,0,0,0,255,151.1,-103.9,263.6,228.7,-34.9,1,0.6,-0.4,216.1,246.8,30.7,3003.1,3963.6,960.5,667.3,477.9,-189.4,604.7,1749.2,1144.5,780.2,1392.3,612.1,28,29.9,1.9,0,1.2,1.2,1.4,0.1,-1.3,2060.9,1721.9,-339,4692.1,2329.2,-2362.9,199.9,150.6,-49.3,,,,60.1,71.6,11.5,11.3,5.4,-5.9,111.9,40.2,-71.7,26.4,0.3,-26.1,742.6,455,-287.6,4.5,4.1,-0.4,7.7,18.1,10.4,4.2,8.3,4.1,87.2,89.5,2.3,,,,440.5,556.5,116,6.4,3.5,-2.9,41.2,45,3.8,1.1,5.7,4.6,0.1,8.5,8.4,2.1,5.9,3.8,13.2,11.2,-2,0.1,0.7,0.6,11.6,1.6,-10,0.3,0,-0.3,0.2,0.4,0.2,0.2,8.4,8.2,403.5,502.9,99.4,101.5,114.1,12.6,0.2,3,2.8,27.7,52.1,24.4,0.7,1.1,0.4,0.1,0,-0.1,1888.4,822.1,-1066.3,,,,7.7,11.6,3.9,33,10.8,-22.2,0.5,2,1.5,21.2,0.9,-20.3,1.1,6.5,5.4,,,,,,,,,,0.7,0.3,-0.4,47.9,94.8,46.9,32.2,30.4,-1.8,15.8,6.1,-9.7,226.7,414.5,187.8,2.7,15,12.3,6.4,18,11.6,3.2,59,55.8,55.9,10,-45.9,0,0,0,183.8,187.8,4,0,0,0,0,0.3,0.3,1.4,64.9,63.5,156.1,298.6,142.5,,,,609.1,960.4,351.3,17.7,28,10.3,52.7,187.4,134.7,0.5,34.2,33.7,19.9,21.9,2,8.5,26.5,18,1.4,1.1,-0.3,760.2,322.2,-438,128.3,54.1,-74.2,15.6,2.4,-13.2,128.6,27.7,-100.9,150.4,27.6,-122.8,13.9,0.9,-13,1131.2,463.8,-667.4,28.3,26.3,-2,0.7,0.6,-0.1,20.2,0.9,-19.3,1523.5,971.7,-551.8,1714.5,1377.6,-336.9,679.6,158.7,-520.9,,,,5.6,6.9,1.3,1065.3,572.6,-492.7,54.4,3.6,-50.8,0,0.1,0.1,3.5,0.3,-3.2,4798.1,1034.2,-3763.9,2.9,0.9,-2,0,4,4,1949.5,1288.9,-660.6,707.6,1146.7,439.1,2698.5,1635.9,-1062.6,10986.1,5227.7,-5758.4,474.6,1133.1,658.5,0,0.4,0.4,0,0,0,0,0,0,0,0,0,7.4,5.6,-1.8,145.8,181.3,35.5,0,0.1,0.1,0.1,0.1,0,0.1,0,-0.1,0.3,0.9,0.6,0.1,0.2,0.1,0,0.1,0.1,0,0,0,0.1,0.4,0.3,0,0,0,1.3,1.6,0.3,0,0,0,2,11.3,9.3,0.5,1.9,1.4,0.9,2.4,1.5,1.5,1.1,-0.4,0,0.1,0.1,6.6,4,-2.6,0.2,0.6,0.4,26.8,21,-5.8,119,76,-43,7.2,13.3,6.1,0,0,0,63.4,225.1,161.7,0,0,0,,,,0,0,0,13.7,6.7,-7,0,0.3,0.3,2.5,7.3,4.8,0.5,6.5,6,0.3,1.2,0.9,13.3,2.2,-11.1,1.3,1,-0.3,71.3,11.3,-60,13.6,16.9,3.3,0.3,0.8,0.5,0.2,1.7,1.5,0.2,1.2,1,449.1,91.7,-357.4,0,0.2,0.2,95.4,5.2,-90.2,0.2,0.1,-0.1,0,0,0,0,0.4,0.4,2,3.6,1.6,181.5,22.3,-159.2,16.8,6.9,-9.9,0,0.3,0.3,0,0.3,0.3,0.1,0,-0.1,3.8,1.7,-2.1,13.6,3.8,-9.8,0.4,0,-0.4,0.2,0.4,0.2,0,0.3,0.3,0,0,0,0,1.8,1.8,0,1.4,1.4,1.3,3.6,2.3,7.6,17.9,10.3,0,1.1,1.1,0,0,0,2,9.5,7.5,17.9,1.2,-16.7,1,1.1,0.1,5.6,0.3,-5.3,,,,0,0.1,0.1,0,0.2,0.2,0.9,0.2,-0.7,246.7,274.5,27.8,6.3,4.5,-1.8,1.2,1.9,0.7,4.6,2.3,-2.3,2.1,0.8,-1.3,14.1,10.2,-3.9,0.6,0.5,-0.1,6.5,0.8,-5.7,0,2.1,2.1,0,0,0
1998-04-01,3037.7,1878.4,-1159.3,15144,12271.3,-2872.7,76350,56014,-20336,5674.8,0,-5674.8,9716.8,5126.2,-4590.6,12338,14426,2088,6866.5,5152.3,-1714.2,4164.9,5336,1171.1,22793.7,20316.9,-2476.8,17154.74795,13747.619421,-3407.12852900001,1555.414063,831.742025,-723.672038,26318.1,13831.2,-12486.9,75743.9000000001,56674.4,-19069.5000000001,29428.2,15282.2,-14146,,,,645.5,1147.4,501.9,1290.4,489.6,-800.8,1.2,0,-1.2,14981,13920.7,-1060.3,0,0.1,0.1,7812.7,6396.2,-1416.5,165.1,166.7,1.59999999999999,4.8,9.5,4.7,113.1,127.9,14.8,193.8,201.2,7.39999999999998,33.1,38.8,5.7,198.5,207.3,8.80000000000001,22.6,152.2,129.6,0.7,32.5,31.8,10.9,79.2,68.3,0,0.1,0.1,75.8,101.7,25.9,0.5,3.8,3.3,2.4,24.5,22.1,21.2,45.9,24.7,388.2,320.7,-67.5,0.3,2,1.7,0.5,6.7,6.2,2.7,2.9,0.2,0.3,8.3,8,0,0.5,0.5,0.4,10.4,10,1.7,8.4,6.7,0.5,32.9,32.4,0.9,5.1,4.2,2.6,21.5,18.9,72.1,118.8,46.7,31.9,47.4,15.5,,,,,,,25,22,-3,0.2,5.1,4.9,0.1,2.4,2.3,372,439.3,67.3,783.2,573.1,-210.1,12.2,10.5,-1.7,11.9,14.4,2.5,0,2.5,2.5,148.7,134.6,-14.1,137.3,176.5,39.2,11.1,27.8,16.7,235.9,326.2,90.3,838.5,1217.2,378.7,2.4,74.6,72.2,17.1,58.8,41.7,224.8,473.9,249.1,0,0.4,0.4,17.6,15.6,-2,642.2,291.3,-350.9,0,0.1,0.1,223.1,163.7,-59.4,201.8,172.1,-29.7,0.9,0,-0.9,177,119.6,-57.4,2991.2,2981.3,-9.89999999999964,742,500.4,-241.6,646.4,1452.1,805.7,662.6,1179.2,516.6,25.6,18.4,-7.2,0,1.8,1.8,1.4,0.2,-1.2,1976.3,1543.9,-432.4,4315.4,2192.8,-2122.6,203.3,140.9,-62.4,,,,50.9,81.3,30.4,10.9,9.8,-1.1,113.2,47.2,-66,20.8,0.3,-20.5,836.1,561.2,-274.9,11.3,11.6,0.299999999999999,6.7,11.9,5.2,4.9,6.9,2,62.9,70.5,7.6,,,,541.8,296.6,-245.2,10.8,3.8,-7,31.9,36.5,4.6,1,6.5,5.5,0.8,10.2,9.4,0.1,7.7,7.6,30.1,8.9,-21.2,0,0.5,0.5,4.5,2.5,-2,0.2,0.8,0.6,0.3,4.5,4.2,0.5,13.6,13.1,419.4,475.2,55.8,101.6,68.8,-32.8,0,0.2,0.2,27.2,52.5,25.3,0.4,0.3,-0.1,0.1,0.2,0.1,1673.7,731.5,-942.2,,,,4.6,15.9,11.3,25.1,13.2,-11.9,0.5,1.6,1.1,10.3,1,-9.3,1.2,5.4,4.2,,,,,,,,,,0.6,0.8,0.2,50.4,89.4,39,33,68.8,35.8,10.4,5.5,-4.9,227.8,241.6,13.8,2.3,9.5,7.2,1.2,14.6,13.4,2.4,51.5,49.1,88.5,13,-75.5,0,0,0,158.4,198.5,40.1,0,0,0,0,0,0,1,35.9,34.9,129.7,104.4,-25.3,,,,583.8,766.9,183.1,22.6,16.1,-6.5,56.4,142.1,85.7,0.3,16.4,16.1,14.6,24,9.4,12.5,20.8,8.3,0.2,0.7,0.5,684.2,277.3,-406.9,132.9,53.8,-79.1,13.2,1.4,-11.8,126.8,19.7,-107.1,141,18.4,-122.6,8.8,0.7,-8.1,987.2,420.2,-567,41.6,22.9,-18.7,1.5,0.7,-0.8,20.5,0.7,-19.8,1510.6,992.4,-518.2,1539.7,1176.5,-363.2,732.8,160.5,-572.3,,,,8.2,5.9,-2.3,923.9,573.8,-350.1,58.2,2.8,-55.4,0,0.1,0.1,3.2,0.2,-3,5262.9,984.9,-4278,2,2.4,0.4,0,0,0,1924.1,1395.1,-529,749.9,1072.2,322.3,2652.8,1508.5,-1144.3,10326.9,4868.9,-5458,473.3,962.9,489.6,0,0.1,0.1,0,0,0,0,0,0,0,0,0,15.1,4.4,-10.7,139.8,122.4,-17.4,0,0.1,0.1,0.2,0,-0.2,0,0.1,0.1,0.5,0.9,0.4,1.4,0.1,-1.3,0.1,37.3,37.2,0,0,0,0.1,0.1,0,0,0,0,2.1,1.5,-0.6,0,0.1,0.1,2.5,7,4.5,1.5,2.6,1.1,1.2,3.9,2.7,1,1.4,0.4,0,0,0,6.5,2.1,-4.4,0.2,0.5,0.3,33.6,32.5,-1.1,177.6,53.9,-123.7,3.5,23.3,19.8,0,0,0,49.9,231.9,182,0,0,0,,,,0,0,0,0.5,4.7,4.2,0,0.1,0.1,2.1,4.6,2.5,0.4,2.9,2.5,0.1,2.3,2.2,9.5,5.9,-3.6,1.3,1.9,0.6,43.7,6,-37.7,11.6,20.4,8.8,0.1,0.4,0.3,0.4,1.4,1,0.3,6.6,6.3,463.3,48.4,-414.9,0,0.2,0.2,124.2,5,-119.2,0.4,0.1,-0.3,0.1,0,-0.1,0,0.6,0.6,0.2,3.3,3.1,204.2,34.2,-170,42.8,5.1,-37.7,0,0,0,0,1.1,1.1,0,4.8,4.8,1.5,4.1,2.6,16.8,4.3,-12.5,0.8,0.1,-0.7,0.1,2.6,2.5,0,0,0,0,0,0,0.1,5.3,5.2,0,1.7,1.7,2.2,4.4,2.2,10.5,13.7,3.2,0,0.9,0.9,0,0,0,1.9,4,2.1,19.9,1.1,-18.8,0.8,2.9,2.1,3.3,1.3,-2,,,,0,0,0,0,0.3,0.3,0.1,0,-0.1,286.6,265.1,-21.5,8.8,1.6,-7.2,2,3.2,1.2,3.3,2,-1.3,1.3,0.2,-1.1,8.9,4.5,-4.4,3.8,2.5,-1.3,3.7,0,-3.7,0,12.5,12.5,0,0,0
1998-05-01,2943.5,1828.5,-1115,14374.4,12951,-1423.4,76492,55986,-20506,5837.5,0,-5837.5,8505.5,5096.1,-3409.4,12435,14752,2317,6794.2,5170.3,-1623.9,4205.2,5548,1342.8,22711.8,19951.3,-2760.5,16271.962568,14500.872561,-1771.090007,1409.344931,771.977292,-637.367639,25735.9,13469.1,-12266.8,73997.7000000001,56672.7,-17325.0000000001,28764.6,14773.7,-13990.9,,,,635.1,1118.4,483.3,1162.6,520,-642.6,0.1,0.1,0,14769.2,13543,-1226.2,0,0.7,0.7,7942.6,6408.3,-1534.3,171.8,157.2,-14.6,3.9,10.6,6.7,114.8,124.8,10,215.5,205.2,-10.3,42.3,26.5,-15.8,189.2,194.8,5.60000000000002,33.3,151.9,118.6,0.9,29.8,28.9,8.5,63.2,54.7,0,0.2,0.2,64.9,106,41.1,0.5,4,3.5,2.3,26.4,24.1,21.3,47.8,26.5,387.2,330.5,-56.7,0.2,1.3,1.1,0.1,4.8,4.7,2.4,4.3,1.9,0.1,7.3,7.2,0,0.4,0.4,0.3,6.1,5.8,1.9,7.5,5.6,0.4,56,55.6,1.1,4.1,3,3,20.1,17.1,90.2,92.8,2.59999999999999,14,39.6,25.6,,,,,,,46.2,27.8,-18.4,0.2,5.5,5.3,0.5,1.7,1.2,375.2,407,31.8,805.9,624.1,-181.8,10.7,16.1,5.4,11.8,15.3,3.5,0.1,1.3,1.2,154.7,122.9,-31.8,147.9,164.6,16.7,16.6,28.8,12.2,186.3,515.2,328.9,872.9,1310.9,438,2.1,43.1,41,18.2,45,26.8,185.7,495.7,310,0,0,0,21.6,16.8,-4.8,614.5,330.2,-284.3,0,0.2,0.2,266.9,141.1,-125.8,197.6,230.7,33.1,0.9,0.1,-0.8,139.8,155.2,15.4,2816.2,3748.5,932.3,605.5,483.8,-121.7,579.9,1468.3,888.4,674.7,1123.4,448.7,24.5,30.4,5.9,0,2.2,2.2,1.3,0.5,-0.8,1957.1,1520.9,-436.2,4046.9,2148.4,-1898.5,201.7,172.3,-29.4,,,,51.5,77.5,26,13.6,8.3,-5.3,122.1,35.8,-86.3,23.1,0.3,-22.8,757.5,577.2,-180.3,8,9.8,1.8,8.1,20.2,12.1,3.9,6.2,2.3,57.1,73,15.9,,,,473.6,362.8,-110.8,11.6,2.7,-8.9,52.8,27.7,-25.1,1,1.9,0.9,0.1,7,6.9,2.8,13.8,11,4.3,10,5.7,0,1.9,1.9,14.5,1.7,-12.8,0.7,5,4.3,0.1,2.7,2.6,0.6,21.3,20.7,426.6,422.8,-3.80000000000001,94.2,73.4,-20.8,0.3,0.9,0.6,32.6,16.2,-16.4,0.4,0.6,0.2,0.1,0,-0.1,1636.5,690.2,-946.3,,,,2.9,4.5,1.6,20.5,11.9,-8.6,0.6,3.4,2.8,10.5,1.1,-9.4,1,10.2,9.2,,,,,,,,,,0.8,0.5,-0.3,38.2,82.9,44.7,25.7,60.2,34.5,13.8,11,-2.8,208,260.5,52.5,3.1,10.6,7.5,5.8,10.2,4.4,27.1,36.8,9.7,52.1,0,-52.1,0,0,0,158.7,305.1,146.4,0.1,0.1,0,0,0.1,0.1,1.4,14,12.6,130.2,94.3,-35.9,,,,550.5,674.3,123.8,18.1,30.3,12.2,48.4,182.4,134,0.3,7.5,7.2,13.4,35.3,21.9,19.7,22.7,3,0.7,0.4,-0.3,632.3,273.3,-359,134.6,62.2,-72.4,9.3,0.6,-8.7,119.8,12.3,-107.5,115.5,23.4,-92.1,10.6,6.1,-4.5,1001,383.4,-617.6,43,19.4,-23.6,1.9,0.1,-1.8,15.4,0.4,-15,1462.1,813,-649.1,1530.2,1247.6,-282.6,707.2,132.8,-574.4,,,,4.3,44.5,40.2,889,542.6,-346.4,66.5,3.8,-62.7,0,0.1,0.1,3,0.1,-2.9,5539.4,911.3,-4628.1,4.2,1.3,-2.9,0,0,0,1895.2,1237.5,-657.7,788.8,1239.9,451.1,2580,1445.4,-1134.6,9654.5,4752.8,-4901.7,481.8,975.4,493.6,0,0.2,0.2,0,0,0,0,0,0,0,0,0,6.4,5,-1.4,130.6,117.5,-13.1,0,0.2,0.2,0.1,0.6,0.5,0,0,0,0.5,1.3,0.8,0,0.1,0.1,0.4,0,-0.4,0,0.1,0.1,0.1,0.1,0,0,0,0,2.9,1.6,-1.3,0,0,0,2.9,8.2,5.3,0.6,1.3,0.7,0.8,2.8,2,0.4,1.1,0.7,0,0,0,7.1,2.3,-4.8,0.3,0.7,0.4,33.1,34.9,1.8,157.1,38.9,-118.2,3,14.9,11.9,0,0,0,53.3,163.2,109.9,0,0.5,0.5,,,,0,0,0,0.1,3.5,3.4,0.1,0.8,0.7,1.8,9.7,7.9,0.3,6,5.7,0.4,1.8,1.4,7.9,5.4,-2.5,0.6,0.7,0.1,19.6,10.8,-8.8,8.6,16.6,8,0.3,1,0.7,0,1.1,1.1,0.1,3.6,3.5,474.1,51.6,-422.5,1.3,0.2,-1.1,113.7,5.5,-108.2,0.6,0.5,-0.1,0,0,0,0,1.3,1.3,0.1,7.1,7,200.9,17.7,-183.2,12,7.1,-4.9,0,0,0,0,1.4,1.4,0,0,0,0.7,4.7,4,18,2.4,-15.6,0.3,0.1,-0.2,0.1,1.1,1,0.3,0.1,-0.2,0,0,0,0,0.7,0.7,0.4,2.1,1.7,0.8,2.1,1.3,9.4,52.5,43.1,0.1,1.2,1.1,0,0.1,0.1,1.7,3.2,1.5,14.5,4,-10.5,1.2,2.3,1.1,5,1.6,-3.4,,,,0,0,0,0,0.1,0.1,0,0,0,230.5,263.8,33.3,3.1,2.5,-0.6,1.1,2.9,1.8,3.7,2.6,-1.1,2.2,0.3,-1.9,11.7,3.3,-8.4,2.8,1.9,-0.9,6.3,0,-6.3,0,7.5,7.5,0,0,0
1998-06-01,2740,2106.8,-633.2,15502.9,12666.8,-2836.1,74911,56145,-18766,5772.2,0,-5772.2,9097.5,5210.9,-3886.6,13393,15448,2055,7444.4,5042.1,-2402.3,4350.1,5368.1,1018,22353.3,19828,-2525.3,17496.179992,14326.978221,-3169.201771,1346.028054,1004.176477,-341.851577,27492.9,13531.4,-13961.5,76918.1,56994.6,-19923.5,30703.8,15362,-15341.8,,,,668,1086.2,418.2,1111.6,696.6,-415,0.6,0,-0.6,14370.5,13379.3,-991.200000000001,0.2,0.7,0.5,7982.8,6448.7,-1534.1,196.2,148.5,-47.7,9.7,10.3,0.600000000000001,139.3,129.3,-10,234.8,205.6,-29.2,35.4,22.5,-12.9,212.3,173.1,-39.2,32.5,144.6,112.1,0.7,29,28.3,5.5,66.1,60.6,0,0.4,0.4,62.2,115.8,53.6,0,4.2,4.2,0.5,24.4,23.9,24.6,44.6,20,410.8,327.4,-83.4,0.1,1.2,1.1,0.5,4.7,4.2,5.6,3.4,-2.2,0.2,6,5.8,0,0.2,0.2,0.6,3.9,3.3,1.9,7.4,5.5,0.1,13.4,13.3,1.1,3.5,2.4,3.4,20.8,17.4,89.1,73.7,-15.4,19.3,33.7,14.4,,,,,,,50.5,29.7,-20.8,0.2,3.6,3.4,0.1,1.8,1.7,371.8,471,99.2,757.8,572.9,-184.9,11.1,11.3,0.200000000000001,9.7,15,5.3,0,1.6,1.6,137,130.9,-6.09999999999999,172.1,166.4,-5.69999999999999,31.9,31.6,-0.299999999999997,181.1,320.9,139.8,936,1283.1,347.1,2.2,57.3,55.1,16.1,46.4,30.3,185.9,606.8,420.9,0,0,0,20.6,13.1,-7.5,641.1,278.6,-362.5,0,0.2,0.2,241.1,121.9,-119.2,247.1,132.9,-114.2,0.7,0.7,0,212.5,173.3,-39.2,3011.8,3255.5,243.7,736.1,497.1,-239,668.4,1580,911.6,728.1,1196.5,468.4,36.9,51.8,14.9,0,1.2,1.2,1.2,0.8,-0.4,2193.2,1367.9,-825.3,4022.3,2291.1,-1731.2,211.1,150.7,-60.4,,,,59.9,36,-23.9,18.9,8.2,-10.7,125,39.9,-85.1,18.7,0.7,-18,697.9,487.7,-210.2,8.4,12.3,3.9,16.1,25.3,9.2,11.6,6.7,-4.9,61.6,69.4,7.8,,,,615.9,460.2,-155.7,11.5,3.1,-8.4,55.5,46.2,-9.3,1.1,1.2,0.0999999999999999,0.6,17.8,17.2,0.5,8.5,8,13.1,8.1,-5,0,0.6,0.6,8.1,0.8,-7.3,0.3,0.9,0.6,0.1,2.9,2.8,2.6,39.8,37.2,446.9,436.4,-10.5,114.8,100.7,-14.1,0.1,0.4,0.3,26.6,17.4,-9.2,0.6,0.2,-0.4,0,0.1,0.1,1833.4,750.5,-1082.9,,,,6.9,11.8,4.9,28.2,9.7,-18.5,0.7,1.5,0.8,14,1.7,-12.3,1.4,4,2.6,,,,,,,,,,0.7,0.4,-0.3,39.3,168.3,129,39.7,26.4,-13.3,13.4,15.9,2.5,226.5,381.8,155.3,3.5,10.7,7.2,4.4,12,7.6,3.9,44.3,40.4,73.4,10.4,-63,0,0,0,170.3,261.4,91.1,0,0.1,0.1,0,0.3,0.3,1.4,47.2,45.8,83.2,231.8,148.6,,,,461,823.3,362.3,9.6,24.1,14.5,53.6,160.5,106.9,0.2,16.9,16.7,18.6,22.7,4.1,11.1,29.9,18.8,0.3,0.4,0.1,689.1,310.7,-378.4,150.4,57.5,-92.9,12.6,1.3,-11.3,184.4,20.5,-163.9,156,11.2,-144.8,11.5,3.6,-7.9,1136.4,363.4,-773,44,22,-22,2.6,0,-2.6,34,1.3,-32.7,1489,639.7,-849.3,1615.7,1411.7,-204,764.9,168,-596.9,,,,31.1,6.8,-24.3,1022,566.4,-455.6,101.3,4.1,-97.2,0.7,0,-0.7,2.5,0.2,-2.3,6020.2,1282.7,-4737.5,4.9,0.5,-4.4,0,0.1,0.1,2101.1,1189.7,-911.4,947.6,1114.7,167.1,2780.1,1326,-1454.1,9970.8,4755.9,-5214.9,482.9,938.5,455.6,0,0.2,0.2,0,0,0,0,0,0,0,0,0,2.8,5.7,2.9,163.5,121.5,-42,0.1,0.1,0,0.2,0,-0.2,0,0,0,0.6,0.4,-0.2,0,0.2,0.2,0.2,0.1,-0.1,0,0,0,0.1,0.3,0.2,0,0,0,3.1,1.2,-1.9,0,0,0,2.1,8.1,6,0.1,2.8,2.7,1.1,3.7,2.6,1.4,1.2,-0.2,0,0.1,0.1,9,1.6,-7.4,0.8,0.5,-0.3,27.3,37.8,10.5,148.7,45.2,-103.5,3.6,14.4,10.8,0,0,0,54.7,210.2,155.5,0,1.2,1.2,,,,0,0,0,0.4,6.5,6.1,0,3.6,3.6,4.7,5,0.3,0.6,6.9,6.3,0.3,1.3,1,11.6,8.9,-2.7,0.6,1.3,0.7,29.3,10.1,-19.2,15.6,15.4,-0.199999999999999,0.2,1.3,1.1,0.1,1,0.9,0.5,1.4,0.9,388,70.6,-317.4,0,0.2,0.2,78.7,5,-73.7,1.3,0.2,-1.1,0.1,0,-0.1,0.3,2.2,1.9,0,5.8,5.8,180.1,19.9,-160.2,21.9,5.1,-16.8,0,0.2,0.2,0,0.3,0.3,0.1,0,-0.1,2.1,6.4,4.3,19.9,3,-16.9,0.5,0.1,-0.4,0,0.6,0.6,0.1,0.1,0,0,1.5,1.5,0.1,2.8,2.7,0,1.7,1.7,0.9,3.2,2.3,6,6,0,0.6,0.4,-0.2,0,0.1,0.1,1.9,17.9,16,25,1.2,-23.8,1.5,3.9,2.4,3.9,0.9,-3,,,,0.1,0,-0.1,0,0.2,0.2,0,0.1,0.1,281.8,443.8,162,3.3,5,1.7,2.2,2.3,0.0999999999999996,5.6,1.7,-3.9,1.3,4,2.7,7.7,5.9,-1.8,2.6,1.6,-1,7.2,0,-7.2,0,17.6,17.6,0,0,0
1998-07-01,2915.1,1801.3,-1113.8,16224.6,11275.9,-4948.7,74594,55477,-19117,5280.7,0,-5280.7,7093.8,4580.3,-2513.5,13337,14047,710,7392.9,4778.8,-2614.1,4336.4,5408.8,1072.4,19611.8,16658.9,-2952.9,18268.021072,12750.678827,-5517.342245,1328.230381,971.259296,-356.971085,28410.4,13449.2,-14961.2,76336.4,51578,-24758.4,32145.9,14636.2,-17509.7,,,,645,1144.6,499.6,1112.6,525.7,-586.9,1.4,0.6,-0.8,12266,10517,-1749,0.1,0.1,0,7345.8,6141.9,-1203.9,191,162.5,-28.5,6.3,9.8,3.5,139.2,123.8,-15.4,232.1,180.2,-51.9,39.3,29,-10.3,208.6,181.9,-26.7,36.1,154.1,118,2.5,41.6,39.1,7.5,63.3,55.8,0,0.3,0.3,61.9,111.9,50,0.1,5,4.9,1.3,48.1,46.8,27.6,44.8,17.2,432.2,375.3,-56.9,0.3,1.1,0.8,0.7,6.1,5.4,2.7,2.8,0.0999999999999996,0.1,6.4,6.3,0.1,0.4,0.3,0.8,3.2,2.4,1.9,7.3,5.4,0.1,7.5,7.4,1.1,5.7,4.6,3.4,25.6,22.2,114.4,69.7,-44.7,28.4,200.8,172.4,,,,,,,27.4,28.2,0.800000000000001,0.4,3.1,2.7,0.1,2.6,2.5,367.6,366.7,-0.900000000000034,757,570.5,-186.5,13.4,11.2,-2.2,8.2,18.8,10.6,0.4,0.8,0.4,141,176.9,35.9,174.8,158.9,-15.9,15.8,39.8,24,180.3,310.6,130.3,913.1,1204.8,291.7,2.4,54,51.6,17.2,54.5,37.3,177.7,539.1,361.4,0,0.1,0.1,17.4,15.7,-1.7,739.5,237.8,-501.7,0,0,0,317.2,103.3,-213.9,214.3,141.1,-73.2,0.3,0.2,-0.1,225.5,163.9,-61.6,2920.8,2752.3,-168.5,801.4,381.8,-419.6,672.6,1416.5,743.9,843.7,1084.4,240.7,31.5,125.8,94.3,0,1.7,1.7,1.3,0.6,-0.7,2233.5,1243.2,-990.3,4290.5,2046.8,-2243.7,245.3,197.8,-47.5,,,,64.6,40.3,-24.3,13.5,9.1,-4.4,134.1,41.5,-92.6,21.2,0.8,-20.4,808.7,520.4,-288.3,10,16.8,6.8,8.2,22,13.8,4.4,3.7,-0.7,67.3,75.9,8.60000000000001,,,,458.9,344.9,-114,8.7,2,-6.7,57.9,68.3,10.4,0.6,1.7,1.1,0.3,11,10.7,2.1,11.3,9.2,19.4,11.5,-7.9,0,0.4,0.4,9.7,0.5,-9.2,17.8,2.1,-15.7,0.1,0.5,0.4,6.7,9.9,3.2,429.8,365.5,-64.3,132.1,54.9,-77.2,0.3,0.4,0.1,42.1,19.7,-22.4,0.3,0.4,0.1,0,0,0,2034.2,692.9,-1341.3,,,,10.7,5.2,-5.5,27.9,7.9,-20,0.5,6,5.5,18.8,1.3,-17.5,0.9,3.5,2.6,,,,,,,,,,0.7,4.3,3.6,35.5,125.1,89.6,37.9,21.9,-16,23.9,9.6,-14.3,200.9,315.4,114.5,2.3,9.3,7,1.3,15,13.7,2.7,44.1,41.4,72.5,29.8,-42.7,0,0,0,161.4,182.4,21,0,0,0,0,0,0,0.8,28,27.2,137.4,82.7,-54.7,,,,534.2,627.7,93.5,22.9,28.4,5.5,61.4,143.6,82.2,0.2,7.3,7.1,17.3,23.5,6.2,13.2,15.3,2.1,0.2,0.1,-0.1,748.5,275.2,-473.3,164.3,47,-117.3,11.9,1.2,-10.7,220.5,14.6,-205.9,175.2,12.6,-162.6,14.1,8,-6.1,1186.7,356.2,-830.5,49.3,22.4,-26.9,1.7,0,-1.7,36.2,0.7,-35.5,1576.1,728.5,-847.6,1513.5,1345.8,-167.7,866.5,181.1,-685.4,,,,27.7,6.3,-21.4,1040.7,564.5,-476.2,117.4,4.1,-113.3,0,1.3,1.3,2.5,0.2,-2.3,6556.2,1100.8,-5455.4,3.7,0.9,-2.8,0,0,0,2022.9,1211.3,-811.6,1015.8,934,-81.8,2840.6,1287.6,-1553,10210.2,4967.7,-5242.5,444.5,989.7,545.2,0,0.2,0.2,0,0,0,0,0.2,0.2,0,0,0,15.4,4.2,-11.2,162.6,123.6,-39,0.2,0,-0.2,0.2,3,2.8,0,0,0,0.7,0.8,0.1,0,0.2,0.2,0.3,1.6,1.3,0,0,0,0.1,0.2,0.1,0,0,0,1,1.2,0.2,0,0,0,6.8,9.6,2.8,0.2,1.9,1.7,1.2,3.3,2.1,1.1,1,-0.1,0,0.5,0.5,9.9,2.9,-7,0.8,0.5,-0.3,30.8,146.7,115.9,124.2,74.6,-49.6,4.8,9.8,5,0,4.6,4.6,55.5,214.4,158.9,0,0,0,,,,0,0,0,13.3,3.3,-10,0.1,0.7,0.6,7.2,5.6,-1.6,0.3,5.7,5.4,0.3,1.9,1.6,10.7,5.2,-5.5,1.4,1.4,0,18.3,13.9,-4.4,17.1,22.1,5,0.2,2.1,1.9,0.1,0.6,0.5,0.2,1.2,1,339.1,63,-276.1,0.1,0.4,0.3,95.7,7.1,-88.6,0.9,0.5,-0.4,0,0,0,0,0.4,0.4,0.6,1.9,1.3,201.1,38.8,-162.3,23.5,8.6,-14.9,0,0,0,0,1,1,0,0,0,5.1,4.4,-0.699999999999999,15.2,4.5,-10.7,1.4,0.1,-1.3,0.5,1,0.5,0,0.1,0.1,4.8,34,29.2,0.1,0.3,0.2,0,2.5,2.5,0.6,2.5,1.9,10.4,10.6,0.199999999999999,0.2,2.7,2.5,0,0,0,3,7.3,4.3,28.6,2.7,-25.9,2.8,3,0.2,7,0.9,-6.1,,,,0.3,0.1,-0.2,0,0.2,0.2,0,0,0,262.6,272.4,9.79999999999995,2.7,2.3,-0.4,2,2.3,0.3,4.2,1.6,-2.6,1.9,0.2,-1.7,9.4,13.2,3.8,5.3,0.4,-4.9,14.5,0.4,-14.1,0,6.6,6.6,0,0,0
1998-08-01,2942.5,1627.5,-1315,14233.6,12022.3,-2211.3,75707,55081,-20626,5837.6,0,-5837.6,8638.6,4665.4,-3973.2,12997,14006,1009,7472.5,4851.1,-2621.4,4190.1,5262.4,1072.3,21713.9,18305.3,-3408.6,15825.408439,13482.134793,-2343.273646,1335.433716,942.898079,-392.535637,28623.4,13030,-15593.4,76014,53420.1,-22593.9,32315.7,14151.7,-18164,,,,631.9,1265.5,633.6,1090.9,515.7,-575.2,0.8,0.8,0,13753,12124,-1629,0.3,0.2,-0.1,7960.9,6181.3,-1779.6,181.3,165.9,-15.4,7.1,11.6,4.5,116.5,117,0.5,222.6,215.2,-7.40000000000001,48.5,23.1,-25.4,229.7,190.1,-39.6,24.5,155.2,130.7,1.4,29.8,28.4,9.6,59.9,50.3,0,0.3,0.3,67.7,112.2,44.5,0.6,5.2,4.6,1.6,28.6,27,23.1,48.5,25.4,387.1,354.8,-32.3,0.2,0.8,0.6,1.3,7,5.7,1.9,2.6,0.7,0.1,5.1,5,0,0.5,0.5,0.6,2.4,1.8,2,6.3,4.3,0.3,11.3,11,0.9,4.4,3.5,2.3,24.6,22.3,84.1,68.1,-16,25.7,60.7,35,,,,,,,8.8,21.6,12.8,0.1,4.4,4.3,0.1,2.2,2.1,375,360.1,-14.9,726.1,446.1,-280,10.7,11.5,0.800000000000001,7.8,14.3,6.5,0,85.1,85.1,154.2,225.2,71,162.1,156.2,-5.90000000000001,14.3,31.4,17.1,177.2,278,100.8,901.1,1295.9,394.8,2,69.9,67.9,34.6,51,16.4,175.7,498.6,322.9,0,0,0,15.5,14.3,-1.2,472.1,267.6,-204.5,0.8,0.3,-0.5,187.9,147.3,-40.6,186.1,156.5,-29.6,0.1,0.5,0.4,175.7,156.1,-19.6,2779.6,3361.4,581.8,718.6,418.5,-300.1,619.5,1556.5,937,472.3,1164.8,692.5,33.5,19.3,-14.2,0,0.6,0.6,0.8,0.5,-0.3,1816.4,1267.3,-549.1,4029.9,2032.6,-1997.3,209.8,147.9,-61.9,,,,49.1,30.2,-18.9,20.2,8.9,-11.3,121.5,41.3,-80.2,15.3,0.6,-14.7,553.5,629.6,76.1,17.9,7.5,-10.4,10.8,27.6,16.8,12.5,4,-8.5,60,60.2,0.200000000000003,,,,445.4,288,-157.4,6.2,1.2,-5,71,27.8,-43.2,0.5,4.6,4.1,1.4,13.1,11.7,0.5,11.3,10.8,8.2,6.6,-1.6,0,0.5,0.5,6.4,1.4,-5,0.4,0,-0.4,0.1,1.3,1.2,9.4,7.5,-1.9,380.6,349.4,-31.2,120.6,59.2,-61.4,0,0.3,0.3,29.8,15.2,-14.6,0.6,1.1,0.5,0,0,0,1834.1,604.3,-1229.8,,,,2.5,4.8,2.3,20.1,10.5,-9.6,0.7,0.5,-0.2,20.5,1.5,-19,1.4,4,2.6,,,,,,,,,,0.6,1,0.4,40.8,243.1,202.3,39.2,19,-20.2,18.3,4.4,-13.9,184.4,266,81.6,2.4,12.4,10,11.7,7.5,-4.2,10.9,31.4,20.5,189.2,0,-189.2,0,0,0,156.8,192.7,35.9,0,0.3,0.3,0,1.4,1.4,1.4,23,21.6,104.5,63.6,-40.9,,,,509.9,655.9,146,19.2,22.3,3.1,70.8,154.9,84.1,22.3,19.5,-2.8,20.4,19.3,-1.1,10.6,21,10.4,0.6,0.1,-0.5,784.1,324.5,-459.6,152.6,58.2,-94.4,8,0.6,-7.4,210.6,29.3,-181.3,169.4,18.5,-150.9,17.2,0.5,-16.7,1220.8,327.9,-892.9,75.7,17.7,-58,2.8,0.1,-2.7,41.4,0.5,-40.9,1753.5,595.2,-1158.3,1515.9,1305.6,-210.3,846.4,155.4,-691,,,,12.3,3.4,-8.9,1142.5,540,-602.5,113.9,2.8,-111.1,0,0.6,0.6,2.1,0.3,-1.8,6779.9,869.9,-5910,4.5,0.7,-3.8,0,0.3,0.3,1997.8,1219.3,-778.5,1058.8,991.2,-67.5999999999999,2900,1335,-1565,9889.6,4770.2,-5119.4,442,1059.5,617.5,0,0.1,0.1,0,0,0,0,0,0,0,0,0,17.9,9.2,-8.7,153,173.3,20.3,0,0,0,0.2,0.2,0,0,0,0,0.8,0.9,0.1,1,0.2,-0.8,0.5,1.1,0.6,0,0,0,0.1,0.1,0,0,0,0,0.2,2,1.8,0,0,0,1.5,8.9,7.4,0.1,1.8,1.7,1,3,2,0.8,1.3,0.5,0,0,0,12.1,3.5,-8.6,0.7,0.4,-0.3,28.1,38.1,10,133.1,58.6,-74.5,7.7,11.4,3.7,0,0,0,75.6,318.5,242.9,0.5,0,-0.5,,,,0,0,0,11.8,7.3,-4.5,0,0.7,0.7,9.7,4.1,-5.6,0.3,5.2,4.9,0.3,6.2,5.9,13.9,2.1,-11.8,0.7,9.7,9,8.8,8.5,-0.300000000000001,12.2,16.1,3.9,0,0.4,0.4,0.1,1.2,1.1,0.1,1.7,1.6,343.3,70.8,-272.5,1,0.2,-0.8,111.7,5.7,-106,0.7,0.2,-0.5,0,0,0,0,1.6,1.6,0.1,4.8,4.7,179.9,17.1,-162.8,33.3,5.7,-27.6,0,0,0,0.1,0.9,0.8,0,0,0,0.1,6.9,6.8,6.2,2.6,-3.6,0.5,0.9,0.4,0.5,1.6,1.1,0,0.8,0.8,0.6,4.2,3.6,0,5.6,5.6,0,1.7,1.7,1.9,1.2,-0.7,9.4,9,-0.4,0.2,0.6,0.4,0,0.1,0.1,2.6,3.4,0.8,24,1.8,-22.2,2,1,-1,5.9,0.9,-5,,,,0,0.1,0.1,0,0.3,0.3,0,0,0,273.8,279.3,5.5,5.1,7.9,2.8,1.2,1.3,0.1,3.6,1.9,-1.7,2.3,0.1,-2.2,8.1,9.4,1.3,4.4,2,-2.4,8.3,0,-8.3,0,9.3,9.3,0,0,0
1998-09-01,2736.5,1829.1,-907.4,14563.5,12656.2,-1907.3,76107,56324,-19783,5917.5,0,-5917.5,9956,4917.9,-5038.1,14123,15913,1790,7655.3,5154,-2501.3,4148.5,4759.3,610.8,23493.1,20151,-3342.1,16438.396939,13860.54001,-2577.85692899999,1173.376663,815.023701,-358.352962,28972.2,13298.7,-15673.5,78434.7,55626.4,-22808.3,32593.4,14898.3,-17695.1,,,,586.8,1122.7,535.899999999999,965.3,501.8,-463.5,0.6,1.4,0.8,15158,13254.9,-1903.1,0.4,0.1,-0.3,8335.1,6896.1,-1439,152.9,157.8,4.90000000000001,4.7,9,4.3,115.6,114.3,-1.3,208.8,183.2,-25.6,35.9,23.6,-12.3,262.2,185,-77.2,23.8,143.5,119.7,0.7,27.8,27.1,10.4,69.3,58.9,0,0.1,0.1,55.7,87.1,31.4,0.5,4.6,4.1,0.9,22.1,21.2,25.2,35.4,10.2,359.1,283.6,-75.5,0.4,0.8,0.4,0.5,3,2.5,2.1,2.2,0.1,0.2,6.6,6.4,0,0.5,0.5,0.4,2.1,1.7,2.1,6.2,4.1,0.3,2.7,2.4,1,5.1,4.1,2.5,24.2,21.7,75.4,67.2,-8.2,24,36.2,12.2,,,,,,,30.7,19.7,-11,0,7.2,7.2,0,1.6,1.6,384.3,323.2,-61.1,709.6,426.1,-283.5,16,10.7,-5.3,8,15.5,7.5,0.5,1.5,1,163.2,122.8,-40.4,188.1,155,-33.1,16.4,32.3,15.9,198.8,351.9,153.1,868.5,1198.1,329.6,3.6,80.8,77.2,27.5,47.5,20,168,461.8,293.8,0,0.2,0.2,24.7,13,-11.7,692.3,404.2,-288.1,0,0.1,0.1,226.5,167.1,-59.4,194.3,125,-69.3,1.1,0.7,-0.4,223.1,138,-85.1,2982.4,3593.5,611.1,873.8,421.4,-452.4,618.8,1377.5,758.7,766,1106,340,38.2,22.1,-16.1,0.1,1.8,1.7,1.8,0.3,-1.5,1978,1379,-599,3759.2,2263.7,-1495.5,225.2,337.7,112.5,,,,51.2,31.4,-19.8,13.9,12.4,-1.5,176.9,33.8,-143.1,21.9,0.5,-21.4,694.1,606.3,-87.8000000000001,24.5,2.2,-22.3,2.5,7.8,5.3,6.4,3.8,-2.6,67.5,59.3,-8.2,,,,547.7,108.5,-439.2,6.3,1.3,-5,51.4,15.3,-36.1,0.6,4.7,4.1,0.2,8.5,8.3,0.6,16,15.4,17.3,10.5,-6.8,0,8.3,8.3,11.6,0.7,-10.9,0.3,1,0.7,0.4,1.3,0.9,3.6,22.1,18.5,300.9,400.4,99.5,100.6,61,-39.6,0.2,1.2,1,26.5,28.1,1.6,0.3,1.5,1.2,0,0,0,1375.6,742.7,-632.9,,,,6.5,4.1,-2.4,21.6,7,-14.6,0.7,4.1,3.4,16.8,0.8,-16,1.2,2.9,1.7,,,,,,,,,,0.5,1.8,1.3,41.8,84.7,42.9,30.5,20.1,-10.4,17.5,8.8,-8.7,190.4,170.9,-19.5,2.5,13.7,11.2,1.9,11.3,9.4,4.8,37,32.2,194.5,0,-194.5,0,0,0,183.1,146.5,-36.6,0,0.5,0.5,0.1,0,-0.1,1.1,19,17.9,68.3,72.9,4.60000000000001,,,,451.3,896.9,445.6,14.6,35.4,20.8,46,149.4,103.4,9.8,14.1,4.3,14,19.8,5.8,14.8,23.2,8.4,0.1,1.4,1.3,773.5,371.2,-402.3,153.4,43.8,-109.6,10.2,0.8,-9.4,189.6,21.3,-168.3,162,13.7,-148.3,16.5,6.7,-9.8,1233.1,344.9,-888.2,51.3,27.8,-23.5,2,0.1,-1.9,38.7,0.8,-37.9,1746.5,609.4,-1137.1,1588.7,1337.1,-251.6,880,152.6,-727.4,,,,36.1,4.4,-31.7,1104.7,529.6,-575.1,122.6,2.7,-119.9,0,0.1,0.1,2.4,0.1,-2.3,7125.2,1214.9,-5910.3,3.9,0.6,-3.3,0,0,0,2061.9,1299,-762.9,1058.2,1197.9,139.7,2946.5,1319.9,-1626.6,9736.4,4572.3,-5164.1,433.6,900.8,467.2,0,0.1,0.1,0,0,0,0.1,0,-0.1,0,0,0,23.2,9.3,-13.9,108.8,148.7,39.9,0,0.1,0.1,0.2,0,-0.2,0,4.7,4.7,0.8,1.1,0.3,0.1,0.1,0,0.5,0.1,-0.4,0,0,0,0.1,0.1,0,0,0,0,0.9,1.6,0.7,0,0,0,2,8.2,6.2,0.1,1.1,1,1.5,1.6,0.1,1.4,0.9,-0.5,0,0.1,0.1,12.8,43.7,30.9,0.5,0.3,-0.2,26.8,28.4,1.6,119.2,35.1,-84.1,5.1,12.8,7.7,0,4.4,4.4,56.8,235.8,179,0,0,0,,,,0,0,0,0.2,4.3,4.1,0,5,5,5.8,7.5,1.7,0.3,4.8,4.5,0.3,0.8,0.5,5.8,5.8,0,0.5,1.5,1,10.5,23.9,13.4,8.5,13,4.5,0,0.3,0.3,0.3,1.2,0.9,0.1,1,0.9,253,60.7,-192.3,0.1,0.3,0.2,77.2,3,-74.2,0.7,0.1,-0.6,0,0,0,0,2.4,2.4,0.1,2.9,2.8,186.6,37.6,-149,37,7.1,-29.9,0,0.2,0.2,0,0.2,0.2,0,0.5,0.5,1.7,3.6,1.9,10.4,2.6,-7.8,0.6,0.1,-0.5,0.5,0.5,0,0,0,0,1.8,6.5,4.7,0.1,3.3,3.2,0,2.6,2.6,0.9,2.4,1.5,9.2,10.3,1.1,0.4,0.4,0,0.1,0.1,0,3.5,4.4,0.9,34.9,2.2,-32.7,5.1,5.2,0.100000000000001,6,3.2,-2.8,,,,0.1,0.1,0,0.1,0.6,0.5,0,0.2,0.2,257.8,254.2,-3.60000000000002,2.5,2.8,0.3,2.4,1.4,-1,4.9,0.9,-4,4.4,0.2,-4.2,8.3,7.5,-0.800000000000001,13.7,1.9,-11.8,9.5,0.1,-9.4,0,18.4,18.4,0,0,0
1998-10-01,2988.1,2152.1,-836,16813.6,13194.3,-3619.3,77880,58131,-19749,6391.8,0,-6391.8,10434.2,5078.7,-5355.5,14275,17177,2902,7561.1,5421.9,-2139.2,4394.3,5642.6,1248.3,24693.6,21278.9,-3414.7,18864.718944,15106.193307,-3758.525637,1144.951855,949.249375,-195.70248,30451.5,15218.6,-15232.9,83711.4,61312.8,-22398.6,33961.3,16695.3,-17266,,,,650.7,1432.3,781.6,907.5,575.8,-331.7,0.6,1.1,0.5,15714.1,14010.1,-1704,1.2,0.3,-0.9,8979.5,7268.8,-1710.7,154.8,164.3,9.5,5.7,9.4,3.7,118.2,135.6,17.4,208.1,202.4,-5.69999999999999,42.3,27.8,-14.5,277.1,213.9,-63.2,24.2,137.9,113.7,1,31.1,30.1,16.3,67.8,51.5,0,0.5,0.5,59.8,126.9,67.1,0.7,7.3,6.6,0.7,31.1,30.4,26.2,60.6,34.4,398.9,379.7,-19.2,0,1.3,1.3,1.1,4.7,3.6,2.4,5.9,3.5,0.1,8.4,8.3,0,0.4,0.4,0.6,5.6,5,2.1,8.8,6.7,0.7,9.1,8.4,1.3,5.5,4.2,3.1,26.7,23.6,88.2,68.1,-20.1,41.8,59.7,17.9,,,,,,,50.5,26.4,-24.1,0,5.4,5.4,0.1,1.9,1.8,428.4,408.4,-20,816.5,527.9,-288.6,6.5,16.6,10.1,7.6,18.9,11.3,0,1,1,154.1,134.1,-20,171.9,211.2,39.3,22.1,61.1,39,182.6,303,120.4,855.3,1470.5,615.2,3.2,80.6,77.4,30.1,51.5,21.4,189.8,523.6,333.8,0.1,0,-0.1,21.5,15.4,-6.1,777.7,429.7,-348,0,0.1,0.1,235.4,142.4,-93,243.5,157.6,-85.9,0.8,0.1,-0.7,238,157.4,-80.6,3124.1,3230,105.9,807.2,500,-307.2,790,1582.7,792.7,772.7,1132,359.3,42.7,38.2,-4.5,0,1.7,1.7,13.6,0.1,-13.5,2347.7,1542.1,-805.6,4643.3,2559.4,-2083.9,235.6,181.5,-54.1,,,,58.7,45.2,-13.5,17.6,13.5,-4.1,157.1,41.4,-115.7,23.3,1,-22.3,845.7,964.5,118.8,8.7,8.8,0.100000000000001,5,5.9,0.9,6.2,3,-3.2,65.5,74.7,9.2,,,,463.8,246.3,-217.5,8,2.1,-5.9,40.2,12.1,-28.1,6,4.6,-1.4,0.2,12.5,12.3,3.9,14,10.1,20,13.5,-6.5,0,0.8,0.8,10.2,6.4,-3.8,8.1,0.1,-8,0.8,0.6,-0.2,0.5,6.5,6,374.2,495.2,121,121.3,64.5,-56.8,0.3,0.2,-0.1,26.4,15.6,-10.8,0,1.7,1.7,0,0,0,1894,829.7,-1064.3,,,,7.3,8.5,1.2,22.9,9.1,-13.8,0.5,2.4,1.9,15.9,1.7,-14.2,0.9,5.8,4.9,,,,,,,,,,4.5,0.4,-4.1,31.7,64.2,32.5,35.1,19.8,-15.3,11.6,8.1,-3.5,272.9,418.6,145.7,1.8,12.9,11.1,2.1,13.3,11.2,3.7,53.7,50,157.1,0,-157.1,0,0,0,192.6,184.6,-8,0,0.4,0.4,0,0,0,2.9,30.2,27.3,126.2,107.3,-18.9,,,,488.7,778.9,290.2,9.3,33,23.7,49.3,372,322.7,0.1,23,22.9,15,28.1,13.1,9.6,26.2,16.6,1,0.8,-0.2,756.7,266.6,-490.1,141.1,108.1,-33,8.3,5.5,-2.8,139.1,43.8,-95.3,152.7,17.3,-135.4,16.1,1.4,-14.7,1265,379.6,-885.4,43.3,31.2,-12.1,2.1,0.2,-1.9,35.3,1.6,-33.7,1887.2,786.9,-1100.3,1536.6,1206.7,-329.9,902.1,177.9,-724.2,,,,8.1,4.7,-3.4,1047.7,597.9,-449.8,112.7,3,-109.7,0,0.1,0.1,1.9,0.7,-1.2,7377.7,1855.2,-5522.5,4.3,3.3,-1,0,0,0,2097.4,1504.3,-593.1,978.2,1051.3,73.0999999999999,2948.9,1659.6,-1289.3,10924.4,4964.5,-5959.9,488.9,1082.4,593.5,0,0.2,0.2,0.1,0.1,0,0,0.1,0.1,0,0,0,18.1,5,-13.1,123.2,319.2,196,0.1,0.1,0,0.1,0.1,0,0,0.3,0.3,0.8,0.9,0.1,0.1,0.1,0,0.7,0,-0.7,0,0.1,0.1,0.1,0.2,0.1,0,0,0,0.9,1.1,0.2,0,0,0,3.8,9.4,5.6,0.1,3.1,3,1.1,3.1,2,1.2,1.9,0.7,0,0.1,0.1,10.6,4.3,-6.3,0.8,0.6,-0.2,31.8,40.6,8.8,144.3,51,-93.3,8.5,10.9,2.4,0,0,0,52.9,270,217.1,0,1,1,,,,0,0,0,0.2,9.4,9.2,0,2,2,6.3,7.6,1.3,0.3,4,3.7,0.6,1.6,1,6.2,8.7,2.5,0.9,2.5,1.6,4.2,16.3,12.1,11.4,18.9,7.5,0,1,1,0.1,3.2,3.1,0.1,1.3,1.2,294.7,104.1,-190.6,0.1,0.3,0.2,98.9,6.6,-92.3,1.5,0.1,-1.4,0,0.1,0.1,0,3.1,3.1,0,2.9,2.9,126.8,32.5,-94.3,24.9,10.2,-14.7,0,0,0,0,0.6,0.6,0.5,0.1,-0.4,1.7,3.3,1.6,12,0.9,-11.1,0.4,0.7,0.3,0.9,3.1,2.2,0,0.4,0.4,1.1,19.4,18.3,0.1,1.7,1.6,0.1,2.7,2.6,1.6,2.4,0.8,7.5,17.2,9.7,0.3,0.3,0,0.1,0.2,0.1,1.9,4.5,2.6,27.6,2.2,-25.4,1.2,7.8,6.6,7.5,0.8,-6.7,,,,0,0,0,0.1,0.3,0.2,0,0.2,0.2,222,269.1,47.1,2.4,1.9,-0.5,1.7,1.7,0,7.1,2.8,-4.3,2.3,0.2,-2.1,13.9,7,-6.9,4.7,0.4,-4.3,8.7,0,-8.7,0,130.5,130.5,0,0,0
1998-11-01,2574.4,2911.9,337.5,15689,12476.9,-3212.1,77912,58424,-19488,6028.4,0,-6028.4,10174.9,4588.3,-5586.6,13855,16616,2761,7244,5438.8,-1805.2,4041.5,5195.6,1154.1,23390.3,20555.2,-2835.1,17633.212704,14212.918539,-3420.294165,1162.949228,1090.43548,-72.5137479999999,28060,13624.9,-14435.1,78020.1,58394.7,-19625.4,31245,16145.2,-15099.8,,,,545.9,1095.8,549.9,1013.9,631,-382.9,0.4,0.7,0.3,15190.1,13576.1,-1614,0.6,0.3,-0.3,8200.2,6979.1,-1221.1,141.6,172.8,31.2,4.5,9.4,4.9,99.7,136.7,37,166.4,183.5,17.1,29.5,31.4,1.9,290.9,214.8,-76.1,21.5,142.3,120.8,0.8,29.1,28.3,14,65.1,51.1,0,0.7,0.7,58.1,113.1,55,0.5,7.8,7.3,1.1,35.9,34.8,21.5,44.8,23.3,365,321.6,-43.4,0.3,1.6,1.3,0.7,4.1,3.4,2.5,6.2,3.7,0.1,10.8,10.7,0,0.4,0.4,0.6,2.9,2.3,1.9,8.3,6.4,0.7,8.7,8,1.3,5.1,3.8,3.1,28.1,25,68.7,72.3,3.59999999999999,28.1,57.9,29.8,,,,,,,39.1,90.3,51.2,0.1,5.5,5.4,0,1.6,1.6,385.8,356.3,-29.5,735.6,487.8,-247.8,7.5,12.6,5.1,5.8,17.8,12,0,81.6,81.6,118.2,95.9,-22.3,220,159.5,-60.5,16,38,22,217.2,249.7,32.5,787.9,1330.1,542.2,2.8,71.3,68.5,16.2,48.4,32.2,166.1,433.7,267.6,0,0,0,27.9,13.9,-14,716.4,418.9,-297.5,0,0.1,0.1,237,165.3,-71.7,217.6,156.4,-61.2,1.3,0.3,-1,220.3,154.9,-65.4,2989.8,3002.6,12.7999999999997,726.6,467.5,-259.1,639.4,1737.7,1098.3,734.2,1029.3,295.1,29.5,19.6,-9.9,0,3.2,3.2,1,0.8,-0.2,2108.8,1438.4,-670.4,4323.2,2216.5,-2106.7,218.8,145.5,-73.3,,,,57,46.6,-10.4,9.9,14.8,4.9,145.6,41.2,-104.4,24.6,0.8,-23.8,777.6,921.5,143.9,10,2.9,-7.1,19,9,-10,5.4,6.6,1.2,69.4,87.9,18.5,,,,501.3,208.7,-292.6,8.1,1.8,-6.3,31.3,24,-7.3,1.3,1.5,0.2,0.2,12,11.8,0.7,7.2,6.5,9.6,6.9,-2.7,0,1.9,1.9,3.4,1.7,-1.7,4.1,0.4,-3.7,0.3,1.2,0.9,3.2,4,0.8,425.4,518,92.6,99.5,86.2,-13.3,0.3,0.2,-0.1,26.1,12.1,-14,0,0.7,0.7,0,0.1,0.1,1830.7,765.3,-1065.4,,,,3.1,6.6,3.5,23.4,9.9,-13.5,0.7,4.9,4.2,11.6,2.5,-9.1,0.8,3.1,2.3,,,,,,,,,,0.8,2.2,1.4,40.6,77.3,36.7,21,16.9,-4.1,14.1,6.3,-7.8,258.9,315.5,56.6,2.7,11.8,9.1,2.6,12.8,10.2,5.6,37.6,32,160.7,0.1,-160.6,0,0,0,203.8,188.1,-15.7,0,0.2,0.2,0,0,0,1.5,24.2,22.7,41.2,174.5,133.3,,,,406.4,1651.3,1244.9,29.2,34.6,5.4,58.6,312.3,253.7,3,4,1,15.5,30.9,15.4,12,23.8,11.8,0.4,0.8,0.4,568.9,221.2,-347.7,121.3,41.9,-79.4,10,0.6,-9.4,101.6,28.9,-72.7,121,13.3,-107.7,11.4,0.5,-10.9,1165,370.1,-794.9,43.9,21.6,-22.3,1.1,0.1,-1,37.9,1.3,-36.6,1720.2,614.9,-1105.3,1433.4,1177.4,-256,778.4,147.8,-630.6,,,,34.4,3.9,-30.5,955.2,523.2,-432,88.2,3.7,-84.5,0.1,0.1,0,2.8,0.8,-2,6374.1,1317.2,-5056.9,3,6.2,3.2,0,0,0,2101.6,1541.6,-560,839.9,1009,169.1,2869.1,1710.8,-1158.3,10333.9,4498.6,-5835.3,402.4,948,545.6,0,0.1,0.1,0,0,0,0,0.1,0.1,0,0,0,4.6,3,-1.6,124.6,125.7,1.10000000000001,0.1,0.1,0,0.3,0.4,0.1,0,0,0,0.7,1.1,0.4,0.1,0.1,0,1,0.1,-0.9,0,0,0,0.1,0.2,0.1,0,0,0,2,1.9,-0.1,0,0,0,2.9,6.5,3.6,0.1,1.6,1.5,0.6,2,1.4,0.8,1.2,0.4,0.1,0,-0.1,4.6,2.3,-2.3,0.9,1.4,0.5,24.1,33.2,9.1,85.1,46.9,-38.2,2.3,16.3,14,0,0,0,37.6,362.4,324.8,0,0.5,0.5,,,,0,0,0,0,5.5,5.5,0,0.4,0.4,1.7,3.5,1.8,0.5,2.7,2.2,0.2,1.9,1.7,6.4,4.8,-1.6,1.4,1.5,0.1,8.8,5.5,-3.3,11,15.9,4.9,0,0.4,0.4,0.2,1.5,1.3,0.2,2,1.8,279.4,56.4,-223,0,0.2,0.2,95.6,6.7,-88.9,0.7,0.1,-0.6,0,0,0,0,2.7,2.7,0,4.9,4.9,215.7,28.2,-187.5,35.6,7.7,-27.9,0,0,0,0,0.9,0.9,0,0.1,0.1,2.2,6,3.8,15.5,1.3,-14.2,0.3,1.3,1,0.6,3,2.4,0.1,0.6,0.5,0.5,5.2,4.7,0,0.6,0.6,0,0.7,0.7,0.6,1.5,0.9,5.9,13,7.1,0.2,0.6,0.4,0,0,0,3.4,3,-0.4,20.7,1.7,-19,7.3,8.3,1,7.5,1.7,-5.8,,,,0,0,0,0,0.1,0.1,0,0.2,0.2,258.5,397.6,139.1,2.7,14.5,11.8,1.9,2.3,0.4,1,2.3,1.3,1.6,0.9,-0.7,9.4,11.4,2,7,0.2,-6.8,7.9,0,-7.9,0,98.8,98.8,0,0,0
1998-12-01,2300,2191.2,-108.8,16195.7,12862.9,-3332.8,76867,56989,-19878,5595.1,0,-5595.1,9713.2,4222.1,-5491.1,13607,18828,5221,7257.5,6720.2,-537.3,4199.9,5208.4,1008.5,22245.2,19149,-3096.2,17958.556867,14187.729728,-3770.827139,1035.910817,1191.002842,155.092025,27024.8,15463.2,-11561.6,76006.8000000001,58762.2,-17244.6000000001,29925.9,17937.4,-11988.5,,,,639.7,1066.8,427.1,855.3,726.1,-129.2,0.4,1.2,0.8,14466.7,12663.5,-1803.2,1.5,0.4,-1.1,7778.5,6485.5,-1293,182.7,165.3,-17.4,3.9,9.5,5.6,117.2,132,14.8,210.7,178.7,-32,34.4,33.6,-0.799999999999997,300.7,169.3,-131.4,28,130.7,102.7,0.6,53.9,53.3,17.2,63.8,46.6,0,0.4,0.4,60.7,105.8,45.1,0.5,8.3,7.8,1.1,110.1,109,25,55.1,30.1,354,300.4,-53.6,0.2,1.3,1.1,0.9,6.3,5.4,2.5,4.6,2.1,0.1,9.4,9.3,0,0.3,0.3,0.8,3.5,2.7,1.8,7.6,5.8,0.8,2.8,2,0.8,4.6,3.8,2.7,25.2,22.5,60.6,64.5,3.9,21,81.4,60.4,,,,,,,38.5,25.7,-12.8,0.1,9.6,9.5,0,2.3,2.3,416.7,370.6,-46.1,610,404.9,-205.1,11.9,11.3,-0.6,10.2,14.1,3.9,0,0.9,0.9,126.2,137.6,11.4,241.7,179.6,-62.1,26,46.1,20.1,224.3,388.8,164.5,847.7,1336.4,488.7,3.4,51.6,48.2,16.3,57.6,41.3,198,442.8,244.8,0,0,0,50.2,13.3,-36.9,810.3,281.4,-528.9,0,0.1,0.1,249.2,145.5,-103.7,224.6,130.6,-94,2,0.2,-1.8,223,118.9,-104.1,3010.7,2905.7,-105,595.3,517.4,-77.9,658.9,1671,1012.1,685.2,1062.1,376.9,33.1,181.6,148.5,0,0.9,0.9,0.6,0.3,-0.3,2007.3,1724.9,-282.4,4918.4,2457.9,-2460.5,225.3,160.9,-64.4,,,,59.2,42.8,-16.4,12.6,12.7,0.0999999999999996,180,42.3,-137.7,19.2,0.8,-18.4,725,653.5,-71.5,14,5.4,-8.6,20.2,10.7,-9.5,9.8,4.6,-5.2,53.7,63.9,10.2,,,,434.6,176,-258.6,9.4,2.5,-6.9,33.1,11.9,-21.2,1.2,2.2,1,0.3,4.3,4,0.3,13.4,13.1,8.6,3.6,-5,0,2.6,2.6,12.8,1.3,-11.5,0.1,1.2,1.1,0.3,1.6,1.3,5.5,8.5,3,443.9,489.7,45.8,97.7,65.8,-31.9,3.9,0.1,-3.8,25.8,14.6,-11.2,0.7,0.6,-0.1,0,0,0,1821,790.9,-1030.1,,,,5.1,5.8,0.7,22.4,14.2,-8.2,0.6,10.7,10.1,8.2,0.9,-7.3,1,9.8,8.8,,,,,,,,,,1,2.4,1.4,38.5,82.6,44.1,28.6,12.4,-16.2,12.3,6.7,-5.6,149.1,232,82.9,4.6,10.2,5.6,2.2,17.9,15.7,8,33.8,25.8,114.9,0.2,-114.7,0,0,0,200.2,206.8,6.60000000000002,0,0.3,0.3,0,0,0,2.1,25.3,23.2,52.7,111.9,59.2,,,,452.7,908.9,456.2,16.9,22.2,5.3,41.7,208.1,166.4,0.2,14.5,14.3,17.2,22.7,5.5,14,21.2,7.2,0.9,0.5,-0.4,546.6,473,-73.6,129.3,54.1,-75.2,14.7,0.5,-14.2,104,47,-57,115.9,9.4,-106.5,14.9,1.8,-13.1,1100,858.6,-241.4,45.7,20.7,-25,0.6,0.2,-0.4,46.1,1.1,-45,1595.7,648.5,-947.2,1536.9,1545.4,8.5,717.6,417.8,-299.8,,,,31,26.6,-4.4,897.6,564.4,-333.2,99.8,3.7,-96.1,0,0.1,0.1,3,0.3,-2.7,5322.1,1379.7,-3942.4,3.2,0.9,-2.3,0,0,0,2110.3,2383.4,273.1,784,1108.4,324.4,2826.2,1682.9,-1143.3,10476.4,4655.5,-5820.9,472.3,907.1,434.8,0,0.1,0.1,0,0.1,0.1,0.1,0,-0.1,0,0,0,9.3,3.1,-6.2,145.7,136.7,-9,0,0.1,0.1,1.1,0.2,-0.9,0,0,0,0.5,0.8,0.3,0.1,0,-0.1,1,0.1,-0.9,0,0,0,0.2,0.1,-0.1,0,0,0,0.4,1.5,1.1,0,0,0,1.6,7.5,5.9,0,3.8,3.8,1.5,1.7,0.2,1.5,0.7,-0.8,0,0,0,3.6,1.8,-1.8,0.7,1.4,0.7,31.1,84.4,53.3,98.5,47.9,-50.6,2.5,16.8,14.3,0,0,0,48.3,315.6,267.3,0,3.4,3.4,,,,0,0,0,2.1,25.3,23.2,0,2.6,2.6,4.2,4.4,0.2,0.3,6.6,6.3,0.1,2.2,2.1,10.6,5.9,-4.7,0.5,1,0.5,53.6,12.4,-41.2,10.3,23.1,12.8,0.2,0.5,0.3,0.1,2.3,2.2,0.1,3.1,3,195,69.3,-125.7,0,1.7,1.7,60.8,4.3,-56.5,0.2,0.3,0.1,0,0,0,0,0.5,0.5,0.4,2.3,1.9,138.8,32.2,-106.6,21.6,4.8,-16.8,0,0,0,0,1,1,0,0,0,2.6,3.9,1.3,13.6,1.7,-11.9,0.1,1.4,1.3,0.2,4.1,3.9,0,0,0,1,4.3,3.3,0,2,2,0,1.7,1.7,1.2,3.9,2.7,8.4,9.1,0.699999999999999,0.1,0.6,0.5,0.1,0.1,0,3.6,4.2,0.6,21,2.1,-18.9,1.5,1.1,-0.4,7.6,1.6,-6,,,,0,0.1,0.1,0,0.1,0.1,0,0.1,0.1,260.7,449.6,188.9,3,4.9,1.9,1.4,3.2,1.8,1.8,0.7,-1.1,1.4,1,-0.4,7.7,9.7,2,6.5,2,-4.5,9.1,0,-9.1,0,20.1,20.1,0,0,0
1999-01-01,2542.5,1534,-1008.5,13700.7,12507.6,-1193.1,77781,56272,-21509,4771.2,0,-4771.2,8154,4067.4,-4086.6,12147,15594,3447,6937.6,5352.3,-1585.3,3883,4507.6,624.6,21992.9,18155.1,-3837.8,15110.808941,13456.148518,-1654.660423,1213.60983,817.662333,-395.947497,25623.1,13085.7,-12537.4,71766.3000000001,52436.1,-19330.2000000001,29016.8,14508,-14508.8,,,,548.1,990.8,442.7,1025.8,530.1,-495.7,0.3,0.8,0.5,14550.1,12134,-2416.1,0.5,0.1,-0.4,7442.8,6021.1,-1421.7,163.1,143.4,-19.7,4.4,7.9,3.5,97.5,130.7,33.2,154.7,174.1,19.4,36,27.9,-8.1,254.6,195.4,-59.2,31.6,114.7,83.1,1.5,20.4,18.9,19.5,58.4,38.9,0,0.2,0.2,50.9,104,53.1,0.1,7.9,7.8,3.1,29.8,26.7,14.3,43.9,29.6,181.6,320.4,138.8,0.3,2.1,1.8,1.1,4.9,3.8,2.2,3.4,1.2,0.3,8.1,7.8,0,0.2,0.2,3.1,3.5,0.4,1.3,7.6,6.3,0.9,10.3,9.4,1,5.4,4.4,2.6,24.7,22.1,76.4,76.7,0.299999999999997,21.7,46.1,24.4,,,,,,,44.1,22,-22.1,0.1,4.7,4.6,0.2,3.2,3,437.7,283.8,-153.9,643.6,436.3,-207.3,8.5,11.4,2.9,4.4,15,10.6,0,1,1,131.4,107.8,-23.6,203.7,146.5,-57.2,19.3,50.8,31.5,282,262.2,-19.8,767.6,1106.6,339,1.9,55.6,53.7,16.4,44.2,27.8,198.5,384.3,185.8,0,0,0,24.2,13.8,-10.4,495.6,330.9,-164.7,0,0,0,168.1,106.4,-61.7,216.5,122.9,-93.6,1.5,0.8,-0.7,191.3,220,28.7,2759.7,3267.5,507.8,591.3,571.5,-19.8,599.9,1504.5,904.6,736.7,948.9,212.2,25.6,16.4,-9.2,0,0.5,0.5,0.8,0.6,-0.2,1872.1,1709.2,-162.9,3550.9,1989,-1561.9,214.8,271,56.2,,,,52,28.6,-23.4,12.7,12.3,-0.399999999999999,111.9,36.1,-75.8,17,0.8,-16.2,625.6,514.8,-110.8,14.8,10.1,-4.7,3.8,16.2,12.4,5.1,4,-1.1,58.7,66.1,7.39999999999999,,,,232.8,78.2,-154.6,10,1.2,-8.8,34.1,9.9,-24.2,1.3,2.8,1.5,1.7,2.8,1.1,0.1,5,4.9,21.6,4.8,-16.8,0.1,0.8,0.7,4.7,0.6,-4.1,2.4,0.2,-2.2,0.6,0.3,-0.3,0.8,3.9,3.1,414.9,472.6,57.7,90.8,72.3,-18.5,0.8,0.5,-0.3,20.6,12.7,-7.9,0.4,2,1.6,0,0.1,0.1,1604.4,739.2,-865.2,,,,3.2,4.6,1.4,17.8,11.4,-6.4,0.8,6.2,5.4,18.4,1.2,-17.2,0.9,6.8,5.9,,,,,,,,,,2.4,0.5,-1.9,38,65.9,27.9,29.3,7.3,-22,18.1,3.9,-14.2,188.4,167.3,-21.1,0.8,8.4,7.6,3.7,20.7,17,4.4,39.9,35.5,157.6,0.1,-157.5,0,0,0,230.4,221.5,-8.90000000000001,0,0.7,0.7,0,0.1,0.1,1.1,14.6,13.5,39.9,62.3,22.4,,,,453.9,598.1,144.2,17,14.6,-2.4,43.8,169.2,125.4,0.2,14.7,14.5,19.8,17,-2.8,17.6,16.3,-1.3,1.6,2.8,1.2,663.5,331.4,-332.1,132.8,27.8,-105,14.8,1.2,-13.6,178.6,34.9,-143.7,164.3,10,-154.3,17.1,0.4,-16.7,1073.5,329.1,-744.4,44.9,19.7,-25.2,0.9,0,-0.9,56.5,1.4,-55.1,1502.2,651.4,-850.8,1397.2,1475.3,78.0999999999999,787.2,125.7,-661.5,,,,17.4,6.2,-11.2,886.9,570.6,-316.3,103.3,3.5,-99.8,0.1,0.1,0,2.8,1.4,-1.4,5654,781.3,-4872.7,3.8,0.2,-3.6,0,0,0,2065.7,1543.8,-521.9,804.6,889,84.4,2670,1444.1,-1225.9,9213.3,4623.9,-4589.4,396.9,828.9,432,0,0.2,0.2,0.1,0.1,0,0,0,0,0,0,0,4.3,2.8,-1.5,120.1,139.2,19.1,0,0.1,0.1,0.1,0.5,0.4,0,0,0,0.4,0.9,0.5,0.1,0.1,0,0.3,0.1,-0.2,0,0.2,0.2,0.1,0.6,0.5,0,0,0,1.9,1.5,-0.4,0,0,0,5.9,7.2,1.3,1.9,1.5,-0.4,0.6,1.2,0.6,1.8,0.7,-1.1,0.2,0,-0.2,12.9,4.8,-8.1,0.5,0.4,-0.1,29.3,16.1,-13.2,111.6,40.3,-71.3,4.8,8.6,3.8,0,0,0,42.2,222.3,180.1,0,0.8,0.8,,,,0,0,0,0.2,5.8,5.6,0,0.6,0.6,2.1,5.1,3,0.4,3.6,3.2,0.1,2.2,2.1,10.3,7,-3.3,0.5,0.6,0.1,64.5,7.2,-57.3,17.7,18.8,1.1,0,1.3,1.3,0.1,1.5,1.4,0.2,3.1,2.9,287.9,87.4,-200.5,0,0.5,0.5,81.3,3.1,-78.2,0.3,0.7,0.4,0,0,0,0,0.9,0.9,2.1,1.9,-0.2,148.6,24.1,-124.5,31.2,4.6,-26.6,0.1,0,-0.1,0,0.6,0.6,0.1,0,-0.1,0.4,4.3,3.9,18.5,3.4,-15.1,0.1,0.1,0,0,1.1,1.1,0,0.1,0.1,1.4,11,9.6,0,1.1,1.1,0,0.6,0.6,1.7,1,-0.7,9.6,15,5.4,0,0.1,0.1,0,0,0,2.9,8.8,5.9,21.9,5.9,-16,1.4,0.7,-0.7,5.3,1.4,-3.9,,,,0,0,0,0,0.1,0.1,0,0,0,255,194.1,-60.9,2.7,1.4,-1.3,1.1,2.4,1.3,8.7,1.7,-7,2.6,0.2,-2.4,24.7,5.1,-19.6,11.6,0.5,-11.1,9.3,0,-9.3,0,0,0,0,0,0
1999-02-01,2214.3,1786.1,-428.2,14788.6,12899.7,-1888.9,79842,55522,-24320,5212.2,0,-5212.2,9114.9,4247.4,-4867.5,12591,14975,2384,6450.9,4622.8,-1828.1,3993.4,4312.3,318.9,23224.8,19064.4,-4160.4,16500.915774,13975.630094,-2525.28568,993.254855,663.74306,-329.511795,25524.2,12637.4,-12886.8,73848.6,53278.9,-20569.7,28658.2,14301.9,-14356.3,,,,477.4,960.3,482.9,825.9,377.2,-448.7,0.6,0.1,-0.5,15294.6,13047.8,-2246.8,0.3,0.7,0.4,7930.2,6016.6,-1913.6,193.4,149.3,-44.1,7.5,11.2,3.7,126.9,137,10.1,208.7,198,-10.7,41.1,33.5,-7.6,351,195.2,-155.8,28.4,117.6,89.2,0.7,24.3,23.6,15.5,76.5,61,0,0.2,0.2,60.4,99,38.6,0.5,6.1,5.6,1.3,24.9,23.6,22.3,46.7,24.4,336.3,316,-20.3,0.2,2.2,2,0.7,3.7,3,3.2,5.2,2,0,8,8,0,0.9,0.9,2.4,4.2,1.8,1.8,6.7,4.9,0.3,4.5,4.2,1.1,4.6,3.5,3.1,23.5,20.4,74.6,82.9,8.30000000000001,25.6,46.4,20.8,,,,,,,50,22.1,-27.9,0.1,5.3,5.2,0.1,2,1.9,362.7,284.9,-77.8,574.6,489.2,-85.4,8.2,13.4,5.2,8,13.9,5.9,0,0.9,0.9,125.1,104.5,-20.6,146.5,118.3,-28.2,12.2,23.4,11.2,259.3,248.7,-10.6,756.1,916.2,160.1,3.6,25.4,21.8,11.5,34.2,22.7,167.7,381.5,213.8,0.9,0,-0.9,25,13.1,-11.9,561.1,368.1,-193,0,0.1,0.1,200.2,104.1,-96.1,219.5,156,-63.5,2.9,1.3,-1.6,222.6,154.7,-67.9,2885.2,3312.1,426.9,961.8,484.9,-476.9,534.7,1646.9,1112.2,678.5,1121.2,442.7,24.2,38.2,14,0,0.6,0.6,0.3,0.5,0.2,1932.4,1604.7,-327.7,4052.9,2171.2,-1881.7,252.5,199.7,-52.8,,,,49.5,74.4,24.9,12,19.4,7.4,117.7,37.6,-80.1,20.4,1,-19.4,693.3,571.3,-122,10.9,3.8,-7.1,5.5,17.5,12,4.8,11.4,6.6,57.7,60.4,2.7,,,,468.1,89,-379.1,5.5,1.3,-4.2,21.4,21.2,-0.199999999999999,0.5,8.4,7.9,0.2,2.1,1.9,0.2,2.7,2.5,6.9,4,-2.9,0,1.1,1.1,4.5,0.4,-4.1,9.1,0.4,-8.7,0.6,0.9,0.3,4.5,13.5,9,391.1,481.3,90.2,84.2,65.6,-18.6,1.8,0.3,-1.5,17.2,13.3,-3.9,0.4,0.6,0.2,0,0.3,0.3,1651.8,734.1,-917.7,,,,7.5,5.4,-2.1,20.8,7.3,-13.5,0.4,8.8,8.4,18.7,1.2,-17.5,0.6,7.6,7,,,,,,,,,,0.7,0.3,-0.4,38.8,104.4,65.6,28.2,14.9,-13.3,19.2,8.1,-11.1,171,191.5,20.5,1.1,11.4,10.3,3.7,20.7,17,5.3,25.9,20.6,162.4,8.6,-153.8,0,0.4,0.4,194.6,179.2,-15.4,0,0.1,0.1,0.1,0.2,0.1,1.8,20.4,18.6,43.4,86.6,43.2,,,,420.8,820.3,399.5,23.4,14.9,-8.5,41.9,155.9,114,0.3,8,7.7,20.3,13.5,-6.8,16.8,30.6,13.8,0.8,1.7,0.9,668.1,233,-435.1,129.1,32.8,-96.3,16.1,1.7,-14.4,143.8,14.4,-129.4,145.6,14.4,-131.2,16.1,1.1,-15,950.4,326.8,-623.6,45.2,22.5,-22.7,2,0,-2,53.9,1.6,-52.3,1437.6,635.8,-801.8,1230.1,1102.3,-127.8,653.7,114.4,-539.3,,,,19.9,9.7,-10.2,837.7,548.8,-288.9,98.8,3,-95.8,0,0,0,2,2.2,0.2,5563.1,923.9,-4639.2,2.6,0.5,-2.1,0,0.1,0.1,2023,1415.9,-607.1,727.3,888.9,161.6,2470.5,1215.7,-1254.8,9999.1,4836.4,-5162.7,344.2,807.3,463.1,0,0.1,0.1,0,0,0,0,0,0,0.1,0,-0.1,3.2,3,-0.2,116,132.4,16.4,0,0,0,0.2,0.1,-0.1,0,0,0,0.3,0.7,0.4,0.1,0.1,0,0.5,0.1,-0.4,0,0.1,0.1,0.1,0.3,0.2,0,0,0,1.8,1.8,0,0,0,0,2.1,6.7,4.6,0.8,1.5,0.7,0.7,1.7,1,0.8,1,0.2,0,0,0,6.2,3.1,-3.1,0.4,0.4,0,33,47.6,14.6,83.4,39.6,-43.8,3.7,8.1,4.4,0,0,0,47,190.7,143.7,0,0.8,0.8,,,,0,0,0,2.8,2.6,-0.2,0,0.5,0.5,4.7,1.8,-2.9,0.3,4,3.7,0.1,3.3,3.2,11.1,2.7,-8.4,1,0.2,-0.8,55,7.5,-47.5,12.1,22.2,10.1,0,0.3,0.3,0.1,2.2,2.1,0.1,2.8,2.7,210.7,56.1,-154.6,0.2,0.3,0.1,97.6,4.9,-92.7,0.2,0.1,-0.1,0,0,0,0,0.5,0.5,0,3.8,3.8,121,18.5,-102.5,24.7,2.3,-22.4,0,0.3,0.3,0,0.6,0.6,0,0,0,5.2,2.6,-2.6,9.8,7.7,-2.1,0.3,0,-0.3,0,0.4,0.4,0,0.5,0.5,0.8,5.3,4.5,0,0.7,0.7,0,0.9,0.9,0.7,3,2.3,8,15.4,7.4,0,0.4,0.4,0.1,0,-0.1,3.2,2.1,-1.1,17.5,1.5,-16,1.1,2.3,1.2,5,1,-4,,,,0,0,0,0,0.5,0.5,0,0,0,202.5,187.6,-14.9,1.8,1.1,-0.7,1.3,1.7,0.4,2.7,2.1,-0.6,9.3,0.1,-9.2,7,4.6,-2.4,1.4,0.4,-1,6.8,0,-6.8,0,0,0,0,0,0
1999-03-01,2771.3,2111.7,-659.6,17131.3,14465.6,-2665.7,79569,55749,-23820,6037.2,0,-6037.2,10270.5,5087.3,-5183.2,14597,18082,3485,7440.8,5906,-1534.8,4507.1,4677.4,170.299999999999,26404.3,21894.1,-4510.2,19250.22979,15708.367651,-3541.86213899999,1231.70263,859.867476,-371.835154,28381.2,14803.2,-13578,84071.9,60889.4,-23182.5,32180.9,16656.9,-15524,,,,496.5,1091.9,595.4,987.7,481.8,-505.9,1.2,0.4,-0.8,17100.1,14984.4,-2115.7,0.4,0.4,0,9304.2,6909.7,-2394.5,203.6,151.3,-52.3,9.3,11.6,2.3,145.3,143.6,-1.70000000000002,258.6,241.3,-17.3,43.3,33.8,-9.5,309.4,208.3,-101.1,38.9,175.8,136.9,0.9,31.3,30.4,23.7,76,52.3,0,0.1,0.1,58,111.3,53.3,0.2,6.5,6.3,0.2,26.5,26.3,26.3,51.1,24.8,401.8,380.5,-21.3,0.1,1.2,1.1,1.2,4,2.8,2.9,3.8,0.9,0.2,8.1,7.9,0,0.3,0.3,1,3.3,2.3,2.4,8.7,6.3,0.8,9.2,8.4,1.9,6.5,4.6,4.3,29.7,25.4,76.8,78.2,1.40000000000001,26.5,55.1,28.6,,,,,,,31.5,25.9,-5.6,0.2,8.2,8,0.1,4.3,4.2,451.6,310.4,-141.2,625.7,524.3,-101.4,8.1,12.6,4.5,10.1,11.7,1.6,0,0.8,0.8,150.4,69.8,-80.6,166.4,152.7,-13.7,8.4,21.7,13.3,304.4,236.2,-68.2,859.8,979.5,119.7,2.5,38.9,36.4,14.7,38.7,24,235.4,384.7,149.3,0,0,0,30.8,13.1,-17.7,723.9,318,-405.9,0,0.1,0.1,281.5,150.1,-131.4,232.6,157.7,-74.9,2.3,0.7,-1.6,261.9,261.5,-0.399999999999977,3238.8,3352,113.2,734.3,643.1,-91.1999999999999,729.5,1672.8,943.3,959.9,1197.1,237.2,26.2,191.6,165.4,0,0.4,0.4,0.6,0.3,-0.3,2177.7,1768.4,-409.3,4851.7,2793.3,-2058.4,241.8,242.5,0.699999999999989,,,,58.8,124.6,65.8,11.4,13.3,1.9,162.1,41.1,-121,26.4,1.4,-25,860.2,504.6,-355.6,15.7,6.4,-9.3,13.1,18.9,5.8,8,7.9,-0.0999999999999996,75.5,75.1,-0.400000000000006,,,,497.6,110.9,-386.7,5.2,1.7,-3.5,28.8,19.7,-9.1,1.2,1.2,0,0.1,7.8,7.7,0.8,2.9,2.1,13.6,13.3,-0.299999999999999,0,0.3,0.3,11.7,1,-10.7,3.7,1.6,-2.1,1,0.7,-0.3,2.5,21.1,18.6,443.3,471.6,28.3,101.8,98.3,-3.5,0.9,0.3,-0.6,22.5,25,2.5,1,0.9,-0.1,0,0,0,1955.8,819.1,-1136.7,,,,12,5.3,-6.7,23.7,16.8,-6.9,0.7,2.1,1.4,12.9,2.1,-10.8,1.3,6.2,4.9,,,,,,,,,,1.1,1,-0.1,59.2,132,72.8,33.1,43.3,10.2,9,7.6,-1.4,278.7,320.7,42,2,17.6,15.6,10.7,14.6,3.9,4.8,44.9,40.1,243,0.6,-242.4,0,0,0,207.1,207.3,0.200000000000017,0,0.2,0.2,0.1,0.2,0.1,1.3,24.4,23.1,104.2,77.8,-26.4,,,,507.7,1078.1,570.4,31.9,12.3,-19.6,47.5,165.7,118.2,0.5,16.1,15.6,20.3,16.6,-3.7,18.8,23.3,4.5,1.9,4.1,2.2,823.5,363.5,-460,133,32.6,-100.4,20.9,0.8,-20.1,128.9,19,-109.9,162.9,13.2,-149.7,18.2,1.5,-16.7,1102,383.1,-718.9,37.7,19.2,-18.5,0.7,0.2,-0.5,57.5,1.2,-56.3,1639.9,676.4,-963.5,1543.5,1321.2,-222.3,738.5,165.9,-572.6,,,,39.2,10.1,-29.1,956,606.9,-349.1,82.9,3.8,-79.1,0,0.1,0.1,4.1,0.3,-3.8,5204,1076,-4128,2.9,0.8,-2.1,0,0,0,2360,1909.8,-450.2,701.4,1218.2,516.8,2835.9,1456.8,-1379.1,11799.4,5294,-6505.4,345.2,921.5,576.3,0,0.3,0.3,0,0,0,0,0.6,0.6,0,0,0,4.6,3.9,-0.7,130.7,138.7,8,0.1,0,-0.1,0.7,1.1,0.4,0,0.1,0.1,0.4,1,0.6,0.1,0.2,0.1,0.3,0.1,-0.2,0,0.2,0.2,0.2,0.1,-0.1,0,0,0,1.3,8.6,7.3,0,0,0,3,8,5,0,1.3,1.3,0.9,1.6,0.7,1.2,1.4,0.2,0,0.1,0.1,7.3,2.8,-4.5,0.5,0.5,0,30.3,31.1,0.800000000000001,144,42.1,-101.9,13,15.3,2.3,0,0,0,56.8,289.6,232.8,0,0,0,,,,0,0,0,0,4.3,4.3,0,1.7,1.7,10.4,4.7,-5.7,0.5,3.8,3.3,0.4,3.9,3.5,12.6,8.7,-3.9,0.3,3.8,3.5,42.7,12.2,-30.5,19.9,19.4,-0.5,0,1.1,1.1,0.2,1.8,1.6,1.4,1.9,0.5,328.7,45,-283.7,0.6,0.8,0.2,61.9,4.7,-57.2,0.5,0.1,-0.4,0,0.1,0.1,0.1,0.1,0,6.7,3.6,-3.1,108.4,19.9,-88.5,24.3,5.2,-19.1,0,0.4,0.4,0,0.5,0.5,0,0,0,0,6,6,16.7,1.1,-15.6,0.6,0.3,-0.3,0.2,0.1,-0.1,0.1,0.1,0,1,11.2,10.2,0.1,0.2,0.1,0,0.9,0.9,1.2,1.9,0.7,9,52.7,43.7,0.9,0.3,-0.6,0,0,0,4,5.3,1.3,25,3.4,-21.6,1.1,7.9,6.8,5.3,0.5,-4.8,,,,0,0.1,0.1,0,0.1,0.1,0,0,0,268.7,233,-35.7,1.7,1,-0.7,1.7,3.8,2.1,3.3,2.2,-1.1,2.9,0.4,-2.5,11.5,4,-7.5,3.2,0.5,-2.7,9.9,0,-9.9,0,0,0,0,0,0
1999-04-01,3074.6,1422.7,-1651.9,16129.8,13091.2,-3038.6,80801,56546,-24255,5603.2,0,-5603.2,9413.2,4797.7,-4615.5,13814,16050,2236,7210.2,5786.7,-1423.5,4544.8,4556.2,11.3999999999996,24551.3,20774.7,-3776.6,18188.217268,14757.75031,-3430.466958,1337.907183,799.931508,-537.975675,27318.6,14059.6,-13259,79979.8,57282.8999999999,-22696.9000000001,30732,15360,-15372,,,,625.9,1019.5,393.6,1108.4,387.6,-720.8,0.1,0.2,0.1,16120.5,14126.7,-1993.8,0.2,0.5,0.3,8430.8,6648,-1782.8,173.4,135.7,-37.7,4,13.3,9.3,113.8,123.5,9.7,185.6,211.4,25.8,37.5,37,-0.5,352.4,204.9,-147.5,37.6,175.7,138.1,1.8,30,28.2,19.5,63.4,43.9,0,2.5,2.5,49.7,111.7,62,1,8.8,7.8,0.8,28.8,28,23.6,62.5,38.9,366.5,353.1,-13.4,0.2,2.8,2.6,3.4,3.9,0.5,2.3,4.8,2.5,0,12.2,12.2,0,0.4,0.4,0.6,4.2,3.6,1.8,9.1,7.3,0.6,15.6,15,1.4,6.4,5,2.7,26.8,24.1,81.6,66.5,-15.1,36.2,52.1,15.9,,,,,,,74.6,29.7,-44.9,0.2,6.6,6.4,0,6.5,6.5,426,326.3,-99.7,861.6,410.5,-451.1,10.5,12.2,1.7,8.2,15.2,7,0,0.5,0.5,155.9,67.9,-88,128.1,135.4,7.30000000000001,10.5,18.9,8.4,265.3,228,-37.3,894.8,1072.3,177.5,2.6,51.8,49.2,15.6,35.2,19.6,192.6,372.1,179.5,0,0,0,26,78.6,52.6,683.1,394.7,-288.4,0,0.1,0.1,281.8,140.5,-141.3,249.2,216.9,-32.3,1.7,0.7,-1,283.9,124,-159.9,3239.6,3216.1,-23.5,749.2,460.4,-288.8,651.6,1544.6,893,791.3,1097.3,306,29.6,27,-2.6,0,0.7,0.7,0.7,0.8,0.1,2068.6,1529.6,-539,4471.2,2336.7,-2134.5,216.3,200.6,-15.7,,,,57.9,40.7,-17.2,11.3,9.5,-1.8,136.6,63.9,-72.7,23,0.3,-22.7,736.5,730.1,-6.39999999999998,16.7,32.5,15.8,8.3,20.3,12,5.7,8.3,2.6,66.1,70.8,4.7,,,,657.5,113.4,-544.1,6.4,3,-3.4,23.2,51.5,28.3,1.7,9.3,7.6,2.8,5,2.2,1,10.8,9.8,23.7,106.8,83.1,0,0.3,0.3,4.4,1.8,-2.6,3.5,0.1,-3.4,0.4,0.7,0.3,0.6,21.4,20.8,398.4,421.7,23.3,127.5,76.4,-51.1,1.3,0.4,-0.9,24.6,13.6,-11,0,1.2,1.2,0,0.1,0.1,1759.7,1063,-696.7,,,,14.1,9.6,-4.5,23.2,9.6,-13.6,0.7,4.2,3.5,5.1,6.6,1.5,0.7,4.4,3.7,,,,,,,,,,0.8,2.3,1.5,57.5,96.5,39,33.1,16.4,-16.7,11.4,8.3,-3.1,196.2,337.3,141.1,2.6,16.4,13.8,8.6,8.3,-0.299999999999999,2.3,34.9,32.6,277.9,0,-277.9,0,0,0,172.7,185.9,13.2,0,0.1,0.1,0,0.3,0.3,0.7,27.7,27,112.7,76,-36.7,,,,524.3,523.1,-1.19999999999993,20.1,11.1,-9,61.6,155,93.4,0.6,8.1,7.5,17.8,17.3,-0.5,16.9,53.6,36.7,0.9,1,0.1,745.2,279.6,-465.6,136,34.6,-101.4,14.3,1.6,-12.7,121.7,13.5,-108.2,135.9,20.1,-115.8,11.1,1.1,-10,1090.3,341.2,-749.1,23.1,26.1,3,0.5,0.1,-0.4,46.5,2,-44.5,1636,685.9,-950.1,1423.1,1218.5,-204.6,711.2,163.6,-547.6,,,,24.8,6.1,-18.7,828.8,594.6,-234.2,67.2,3.2,-64,0,0.1,0.1,3.5,0.2,-3.3,5818.9,1035,-4783.9,1.8,1.2,-0.6,0,0,0,2324.9,2088.6,-236.3,699.1,977.8,278.7,2763,1501.8,-1261.2,10407.6,4784.7,-5622.9,417.2,880.6,463.4,0,0.6,0.6,0.1,0.1,0,0,0.1,0.1,0,0.1,0.1,12.3,4.5,-7.8,184.5,114.6,-69.9,0,0.1,0.1,0.1,1.3,1.2,0,0,0,0.5,0.7,0.2,0.2,0.2,0,0.1,0,-0.1,0.2,0.1,-0.1,0.1,0.1,0,0,0,0,0.6,1.5,0.9,0,0,0,3.4,6.7,3.3,0.1,2.1,2,0.6,2.2,1.6,0.2,1.5,1.3,0,0.1,0.1,5.5,1.7,-3.8,0.4,0.7,0.3,35.4,110.3,74.9,135.8,36.1,-99.7,7.6,17.9,10.3,0,0,0,50.6,247.9,197.3,0,0,0,,,,0,0,0,3.8,3.4,-0.4,0.1,0.9,0.8,1.9,2.2,0.3,0.8,6.5,5.7,0.2,2.1,1.9,11.7,8.5,-3.2,0.7,0.3,-0.4,54,6.3,-47.7,14.4,18,3.6,0,0.6,0.6,0.1,0.7,0.6,0.2,2.5,2.3,369.5,47.4,-322.1,0.1,0.4,0.3,131.5,1.8,-129.7,1.2,0.1,-1.1,0,0,0,0.8,0.5,-0.3,1.2,2,0.8,164.1,22,-142.1,26.1,4,-22.1,0,0,0,0,1.2,1.2,0.1,0,-0.1,3.5,3.7,0.2,20.2,0.5,-19.7,1.8,0.2,-1.6,0.4,3.7,3.3,0,0.5,0.5,2.4,11.4,9,0.1,0.2,0.1,0.1,1.2,1.1,1.1,3.7,2.6,10.4,12.7,2.3,0.1,0.5,0.4,0,0.1,0.1,1.8,6.9,5.1,20.8,1.9,-18.9,1.2,1.5,0.3,5,0.2,-4.8,,,,0,0,0,0,0,0,0,0,0,226.3,194.1,-32.2,1.3,7.2,5.9,1.3,4.4,3.1,4.7,2,-2.7,1.7,0.2,-1.5,7.3,8.1,0.8,5,0.5,-4.5,8.4,0.1,-8.3,0,14.1,14.1,0,0,0
1999-05-01,3277,1533.6,-1743.4,16035.2,12931.7,-3103.5,83200,56502,-26698,5892.5,0,-5892.5,9573.5,4908.4,-4665.1,13965,15740,1775,7584,5661.2,-1922.8,4640.4,4569.6,-70.7999999999993,25284.4,20809.2,-4475.2,18042.328245,14091.663364,-3950.664881,1382.559409,834.327439,-548.23197,27591.6,13576.5,-14015.1,80964.8000000001,56489,-24475.8000000001,30965.7,15028.3,-15937.4,,,,649.1,1126.9,477.8,1146.5,353.6,-792.9,0.8,0.1,-0.7,16344.3,14150.7,-2193.6,0.4,0.5,0.1,8940.1,6658.5,-2281.6,180.7,141.9,-38.8,5.3,10.3,5,119.7,133.1,13.4,211,219.3,8.30000000000001,32,31.7,-0.300000000000001,333.3,191.1,-142.2,32.2,131,98.8,0.7,27.7,27,18.1,62.1,44,0,0.2,0.2,47.8,108,60.2,0.3,8.7,8.4,0.5,27.8,27.3,25.1,58.8,33.7,338.6,360.8,22.2,0.3,1.8,1.5,1,3.9,2.9,2.4,4,1.6,0.1,6.9,6.8,0,0.4,0.4,0.2,3.3,3.1,1.6,7.7,6.1,0.3,24.7,24.4,1.9,4,2.1,3.1,21.6,18.5,76.3,70.8,-5.5,23.2,49.2,26,,,,,,,52.5,25.4,-27.1,0.1,7.1,7,0,2.6,2.6,511.1,285.1,-226,925.1,459.7,-465.4,12.8,11.1,-1.7,9.3,11,1.7,0,5,5,174.3,60.5,-113.8,129.9,136.7,6.79999999999998,14.2,24,9.8,193.2,234.4,41.2,932.7,1083.5,150.8,11,61.1,50.1,16.8,43.1,26.3,201.6,408.4,206.8,0,0,0,31.4,19,-12.4,670.1,401.1,-269,0,0.5,0.5,303.7,134.5,-169.2,229.9,128.5,-101.4,2,0.5,-1.5,237.5,120.2,-117.3,3194.5,3294.7,100.2,637.7,446,-191.7,619.8,1533.7,913.9,742.5,1083.6,341.1,25.9,35.3,9.4,0,0.4,0.4,1,0.4,-0.6,2114,1677.8,-436.2,4547.7,2191.5,-2356.2,227.8,202.4,-25.4,,,,54.1,44.9,-9.2,10.9,13.7,2.8,137.5,39.9,-97.6,26.5,0.8,-25.7,798.1,462.5,-335.6,15.9,8.9,-7,17.9,15.4,-2.5,7.4,5.1,-2.3,65.9,64.8,-1.10000000000001,,,,495.4,125.8,-369.6,5.5,2.2,-3.3,47.6,12.8,-34.8,1,0.9,-0.1,0.3,7.9,7.6,0.4,2.9,2.5,11.6,5.4,-6.2,0,2.3,2.3,6,0.3,-5.7,2.6,0.1,-2.5,0.4,3.7,3.3,0.6,28.4,27.8,423.4,651.6,228.2,106.5,89.2,-17.3,0.7,0.3,-0.4,32.9,13.9,-19,1.2,1.4,0.2,0,0,0,1842.1,761.7,-1080.4,,,,8.5,5,-3.5,19.6,7.5,-12.1,0.8,1.1,0.3,10.3,4.8,-5.5,0.3,2,1.7,,,,,,,,,,1.1,11.6,10.5,50.1,74.5,24.4,38.8,18.5,-20.3,14.3,12.1,-2.2,196.6,292,95.4,3.4,25.9,22.5,3.5,7.3,3.8,3.7,25.9,22.2,318.3,0.2,-318.1,0,0,0,172.1,183.7,11.6,0,0,0,0,0.2,0.2,9.5,23.4,13.9,106.4,70.1,-36.3,,,,646,586.8,-59.2,20.1,14.8,-5.3,48,176.6,128.6,0.1,10.9,10.8,19.5,13.3,-6.2,20.5,29.6,9.1,0.5,0.9,0.4,659.6,249.1,-410.5,110.4,45.7,-64.7,12.1,1.6,-10.5,114.3,11.2,-103.1,101.2,7.1,-94.1,12.3,0.6,-11.7,1023.3,513,-510.3,39,22.3,-16.7,0.6,0.1,-0.5,32.3,1.2,-31.1,1785.7,735.5,-1050.2,1527.3,1222.1,-305.2,715.4,162.9,-552.5,,,,29,5.4,-23.6,932.9,566.2,-366.7,71.6,2.9,-68.7,0,0.1,0.1,5.5,0.2,-5.3,6363.1,1113.8,-5249.3,3.4,0.4,-3,0,0.3,0.3,2456.9,1818.6,-638.3,743.8,1000.1,256.3,2856,1620.4,-1235.6,9476.4,4271.4,-5205,466.9,929.3,462.4,0.1,0.3,0.2,0,0,0,0,0.4,0.4,0,0.2,0.2,3.5,3.7,0.2,163.2,124.4,-38.8,0,0.1,0.1,0.1,0.7,0.6,0,0,0,0.6,1.2,0.6,0.1,0.1,0,0,0,0,0,0.1,0.1,0.1,0.1,0,0,0,0,1.8,1.4,-0.4,0,0,0,3.4,7.5,4.1,0.1,1.3,1.2,0.9,3.5,2.6,1,0.8,-0.2,0,0.3,0.3,6.7,51.3,44.6,0.6,0.4,-0.2,33,74.5,41.5,148.3,22.4,-125.9,5.5,80.6,75.1,0,0,0,49.1,302.8,253.7,0,1.3,1.3,,,,0,0,0,19,1.4,-17.6,0.2,0.7,0.5,14.5,2.5,-12,0.3,4.8,4.5,0.7,1.1,0.4,4,4.8,0.8,0.6,0.5,-0.1,19.8,6.6,-13.2,10.5,13.8,3.3,0,2.1,2.1,0.3,1.9,1.6,0.2,1.6,1.4,349.4,40.1,-309.3,0.9,0.1,-0.8,149.3,2.6,-146.7,0.9,0.3,-0.6,0,0.1,0.1,0,0.4,0.4,2,2.1,0.1,223.8,18.9,-204.9,31.1,4.3,-26.8,0,0,0,0,0.6,0.6,0.1,0,-0.1,3,3.5,0.5,18.1,0.3,-17.8,0.4,0.1,-0.3,0.5,4.4,3.9,0,0,0,5.1,9.5,4.4,0.1,0.6,0.5,0,0.4,0.4,2.5,2.9,0.4,7.8,7.9,0.100000000000001,0.1,0.8,0.7,0,0.3,0.3,1.7,4.5,2.8,16.5,5.6,-10.9,1.2,3.7,2.5,3,0.4,-2.6,,,,0.6,0,-0.6,0,0.1,0.1,0,0,0,232.9,194.6,-38.3,0.7,1.6,0.9,0.8,1.1,0.3,2.6,1.5,-1.1,1.6,0.5,-1.1,10.9,2.3,-8.6,3.1,0.8,-2.3,6.6,0,-6.6,0,28.2,28.2,0,1,1
1999-06-01,3341,1359.4,-1981.6,17217.8,12393.7,-4824.1,85868,56420,-29448,6179.2,0,-6179.2,10225.5,4948.6,-5276.9,15828,16680,852,8274.3,5879.6,-2394.7,4826,4583.7,-242.3,26682,21636.1,-5045.9,19506.402279,13722.539207,-5783.863072,1360.277902,888.9652,-471.312702,30930.2,14664.8,-16265.4,87878.9,57824.5,-30054.4,34804.8,15818.2,-18986.6,,,,698.4,1163.3,464.9,1140.3,505.1,-635.200000000001,1.3,0.4,-0.9,17132,14567,-2565,0.2,0.2,0,9550,7069.1,-2480.9,185.2,148.7,-36.5,3.6,9.6,6,148.1,129.5,-18.6,251.7,235.6,-16.1,48.9,27.7,-21.2,292,185.4,-106.6,31.1,162.7,131.6,0.4,29.6,29.2,11.8,65.5,53.7,0,0.1,0.1,55,106.2,51.2,0.5,6.7,6.2,0.1,26.2,26.1,29.1,50.5,21.4,397.1,338.3,-58.8,0.2,1.7,1.5,6.6,11.9,5.3,2.9,4.3,1.4,0.2,7.5,7.3,0,0.2,0.2,1.3,3.1,1.8,2.2,6.2,4,0.6,3.7,3.1,1.2,5,3.8,3.6,23.7,20.1,102.9,51.1,-51.8,38.9,37.6,-1.3,,,,,,,47.3,36.1,-11.2,0.1,4.5,4.4,0.1,2.3,2.2,487.1,278.9,-208.2,839.4,413.6,-425.8,9.1,8.8,-0.299999999999999,7.7,9.4,1.7,0,80.9,80.9,168.9,59.8,-109.1,138,163.8,25.8,15.2,18.6,3.4,215.5,263.5,48,1052.5,1067.8,15.3,2.7,45.3,42.6,19.5,46.5,27,207.4,405.6,198.2,0.2,0,-0.2,18.9,16.2,-2.7,758.5,357.2,-401.3,0,0,0,402.7,125.3,-277.4,263.9,133.9,-130,2.7,0.1,-2.6,246.8,112.8,-134,3323.2,3110.3,-212.9,928.6,543.6,-385,694.8,1618.2,923.4,795.6,965.9,170.3,32.1,23.6,-8.5,0,0.5,0.5,1,0.7,-0.3,2096.4,1614,-482.4,4755.6,2079.2,-2676.4,262.8,199.6,-63.2,,,,64,39.3,-24.7,13.7,12,-1.7,182.3,42.4,-139.9,23.3,0.6,-22.7,889.5,559.2,-330.3,26,15.5,-10.5,17.8,16.1,-1.7,14.4,4.9,-9.5,68,56.8,-11.2,,,,539.3,113.7,-425.6,11.4,2.8,-8.6,39,10.4,-28.6,1.8,3.3,1.5,16.6,3.7,-12.9,2.8,3.6,0.8,25.3,4,-21.3,0,1,1,4.3,0.9,-3.4,0,0,0,0.7,1.5,0.8,0.9,26.2,25.3,428.9,476.8,47.9,137.1,74.1,-63,1.2,0.3,-0.9,27.8,15.1,-12.7,0,0.4,0.4,0,0.1,0.1,2004.4,765.8,-1238.6,,,,6,3.9,-2.1,24.1,13.1,-11,0.9,1,0.1,11.4,5.3,-6.1,0.1,4.4,4.3,,,,,,,,,,1,3.6,2.6,48.9,88,39.1,50,13.9,-36.1,20.4,6.9,-13.5,217.1,415.3,198.2,2.2,15.2,13,9.5,14.8,5.3,4.3,18.8,14.5,302.9,0,-302.9,0,0,0,203.4,144.2,-59.2,0,0,0,0.3,0.3,0,2.5,19.2,16.7,114.7,58.8,-55.9,,,,631.4,387.7,-243.7,15.8,13.6,-2.2,72.9,180.8,107.9,0.3,10.8,10.5,22.6,11,-11.6,16,17.8,1.8,1,0.5,-0.5,678.6,349.5,-329.1,142.9,25.3,-117.6,14.7,0.4,-14.3,182.8,25.3,-157.5,142.5,11.3,-131.2,17.8,0.4,-17.4,1236.7,380.3,-856.4,45.2,18.5,-26.7,2,0.4,-1.6,47.7,2.7,-45,1816,853.6,-962.4,1562.3,1310.8,-251.5,861.1,215.1,-646,,,,24.4,4.3,-20.1,1153.5,609,-544.5,102.4,2.3,-100.1,0.1,0,-0.1,3.1,0.3,-2.8,7117.4,1442,-5675.4,4.3,3.5,-0.8,0,0,0,2711.4,1963,-748.4,917.9,1039.3,121.4,3082.6,1566.5,-1516.1,10897.4,4535.5,-6361.9,495.7,992.3,496.6,0.2,0.3,0.1,0,0.1,0.1,0,0,0,0,0,0,15.8,2.1,-13.7,172.3,129.2,-43.1,0,0,0,0.2,0.1,-0.1,0,0,0,0.5,0.9,0.4,0.1,0.1,0,0.2,6.2,6,0.1,1.3,1.2,0.1,0.2,0.1,0,0,0,1.1,15.7,14.6,0,0,0,2.4,7.3,4.9,0.2,2,1.8,0.7,2.8,2.1,2.2,1.1,-1.1,0,0,0,6.2,2.1,-4.1,0.5,0.8,0.3,36.8,86.8,50,121.9,32.1,-89.8,14,11.7,-2.3,0,3.4,3.4,47,253.3,206.3,0,1.5,1.5,,,,0,0,0,0.3,1.8,1.5,0,2.9,2.9,2.1,4.5,2.4,1.2,7.6,6.4,0.4,1,0.6,9.7,7.2,-2.5,2.4,0.2,-2.2,4.2,5,0.8,33.3,11.5,-21.8,0,0.7,0.7,0.4,1.4,1,0.2,4.1,3.9,380.8,57.7,-323.1,0,0.4,0.4,77.6,1.5,-76.1,1,0.3,-0.7,0.1,0,-0.1,0.4,1,0.6,5.2,3.5,-1.7,187.4,18.1,-169.3,38.6,2.9,-35.7,0,0,0,0,0.4,0.4,1.6,0.2,-1.4,2.2,3.1,0.9,20.2,2.8,-17.4,0.4,0.3,-0.1,0.3,1.2,0.9,0,0.3,0.3,4.8,25.3,20.5,0,0.1,0.1,0,10.2,10.2,0.7,1.9,1.2,8.4,6.6,-1.8,0.3,0.8,0.5,0,0,0,2.7,10.1,7.4,21.7,6.4,-15.3,0.7,1.4,0.7,8.7,98,89.3,,,,0,0,0,0,0.1,0.1,0,0.1,0.1,287.6,216.7,-70.9,1,0.8,-0.2,1.5,1,-0.5,5.4,0.9,-4.5,2.4,0.4,-2,12.9,4,-8.9,2.5,0.3,-2.2,10.7,0,-10.7,0,11.2,11.2,0,0,0
1999-07-01,3703.7,1767.1,-1936.6,17873.4,11484.5,-6388.9,87186,57269,-29917,5920.7,0,-5920.7,7678.5,4517.6,-3160.9,15978,15429,-549,8375.4,5891.2,-2484.2,5100.7,4482.7,-618,23793.2,18639.8,-5153.4,19997.409822,12544.100647,-7453.309175,1293.435849,847.622426,-445.813423,31502.6,14110.1,-17392.5,86775.4,52997.4,-33778,35945.2,15408.6,-20536.6,,,,644.4,1052.3,407.9,1056.1,426.7,-629.4,1,0.2,-0.8,14632.1,11519.3,-3112.8,0.1,0.1,0,9161.1,7120.5,-2040.6,186.5,150.8,-35.7,7.4,9.5,2.1,164.8,106.8,-58,228.4,182,-46.4,42.7,31.2,-11.5,363,181.1,-181.9,27.5,106.6,79.1,0.5,32,31.5,12.4,61.3,48.9,0,0.3,0.3,57.7,99.5,41.8,0.4,8.3,7.9,0.4,27.7,27.3,30.9,56.5,25.6,382,340.2,-41.8,0.1,1.9,1.8,1.5,4.7,3.2,3,3.5,0.5,0.1,6.9,6.8,0,0.1,0.1,0.9,3.6,2.7,1.5,8.9,7.4,0.7,3.6,2.9,1.9,5.8,3.9,3.2,22.5,19.3,113.2,51.3,-61.9,43.6,39.3,-4.3,,,,,,,40.4,24.7,-15.7,0.8,5.2,4.4,0,1.7,1.7,547.1,257.7,-289.4,1065.9,641.6,-424.3,11.4,11.7,0.299999999999999,8.8,10.9,2.1,0,0.8,0.8,154.9,60.1,-94.8,146.2,132.1,-14.1,33.1,23.1,-10,207.9,227.9,20,962.8,1090.6,127.8,2.5,49,46.5,16.9,40.8,23.9,227.8,358.8,131,0,0,0,16.2,17.8,1.6,703.6,316.1,-387.5,0,0,0,429,99.9,-329.1,266.4,141.4,-125,1.2,0.2,-1,243.6,122.8,-120.8,3436.5,3076.6,-359.9,1147,427.4,-719.6,736.3,1355.7,619.4,786.4,862.1,75.7,18.7,191.1,172.4,0,1.7,1.7,0.8,0.3,-0.5,2228.9,1274.9,-954,4987,1966.2,-3020.8,250.4,120.3,-130.1,,,,70.1,42.4,-27.7,15.7,7.9,-7.8,151.5,33.1,-118.4,25.1,0.3,-24.8,823.4,474,-349.4,19.2,30.2,11,44.8,24,-20.8,6.4,2.7,-3.7,68.9,74.7,5.8,,,,408.9,144.6,-264.3,7.6,3.1,-4.5,78.5,8.6,-69.9,1.7,4.8,3.1,0.6,2.7,2.1,1.3,16.8,15.5,15.7,6.8,-8.9,0,0.3,0.3,14.3,1.5,-12.8,0.1,1.6,1.5,0.5,0.8,0.3,1.6,6,4.4,428.4,335.7,-92.7,115.7,61.9,-53.8,0.1,0.2,0.1,25.8,16.5,-9.3,0.3,0.3,0,0,0.1,0.1,2036.6,882,-1154.6,,,,6,4.2,-1.8,25.6,7.2,-18.4,1.5,5.5,4,13.5,4.1,-9.4,0.1,5.2,5.1,,,,,,,,,,0.5,1.3,0.8,57.5,79.7,22.2,40.5,11.4,-29.1,17.6,17.7,0.0999999999999979,217.3,217.9,0.599999999999994,2.3,31.7,29.4,9.6,16.6,7,6.1,21.2,15.1,379.1,0,-379.1,0,0,0,221,196.5,-24.5,0,0,0,0.1,0.5,0.4,1.7,28.3,26.6,131.4,69.4,-62,,,,753.3,626.8,-126.5,18.1,9.9,-8.2,69.7,148.9,79.2,0.2,23.9,23.7,19.7,12.8,-6.9,18.3,46.3,28,1,0.6,-0.4,795.6,315.5,-480.1,154.8,29,-125.8,16.3,0.4,-15.9,198.7,10.3,-188.4,168.6,16.3,-152.3,21.1,0.8,-20.3,1252.1,362.3,-889.8,48.3,19.4,-28.9,1.2,0.1,-1.1,63.8,1.7,-62.1,1856.8,862.3,-994.5,1719.3,1303,-416.3,803.3,161.1,-642.2,,,,43.4,5.4,-38,1176.8,635,-541.8,105,3.9,-101.1,0.1,0,-0.1,4,0.5,-3.5,7405.7,1074,-6331.7,6.9,1.1,-5.8,0,1.1,1.1,2654.3,1863.2,-791.1,992.3,1058.4,66.1000000000001,3009.6,1666.6,-1343,11108.8,4443.9,-6664.9,442.2,900.1,457.9,0,0.1,0.1,0,0.1,0.1,0,0.2,0.2,0,0.1,0.1,14,2.9,-11.1,171.2,130.5,-40.7,0,0.1,0.1,0.4,0.5,0.1,0,0,0,0.4,0.7,0.3,0.1,0.2,0.1,0.1,0.1,0,0,0.1,0.1,0,0.3,0.3,0,0,0,0,1.6,1.6,0,0,0,4.5,7.6,3.1,0.1,2.4,2.3,0.8,1.7,0.9,1.9,1,-0.9,0,0,0,8.5,1.8,-6.7,0.2,0.4,0.2,28.2,40,11.8,149.2,48,-101.2,4.4,48.4,44,0,14.9,14.9,55.5,284,228.5,0,1.7,1.7,,,,0,0,0,4.1,1.3,-2.8,0,0.9,0.9,14.4,1.7,-12.7,0.4,9.9,9.5,4.6,1.7,-2.9,12.2,3.5,-8.7,0.9,1.3,0.4,6.7,6.1,-0.600000000000001,18.4,22,3.6,0,0.4,0.4,0.7,1.8,1.1,0.1,1.7,1.6,333.8,61.4,-272.4,0.4,0.2,-0.2,105.8,4.1,-101.7,0.6,0.1,-0.5,0,0,0,1.3,0.7,-0.6,0,1.8,1.8,178.1,23.8,-154.3,30.4,2.6,-27.8,0,0,0,0,0.8,0.8,0,0,0,2.4,2.5,0.1,21.6,0.9,-20.7,0.1,0.1,0,0.2,3.6,3.4,0,0.5,0.5,6.1,6.6,0.5,0,0.1,0.1,0,2.8,2.8,2,1.7,-0.3,9.9,19.5,9.6,0.3,0.5,0.2,0.1,0,-0.1,3.1,10,6.9,23.4,1.7,-21.7,1.2,4.4,3.2,9,0.9,-8.1,,,,0,0,0,0,0.2,0.2,0,0,0,238.9,213.7,-25.2,1.1,0.9,-0.2,1.5,1,-0.5,1.8,1.4,-0.4,3,0.8,-2.2,7.2,5,-2.2,1.4,0.6,-0.8,12.1,0,-12.1,0,22.5,22.5,0,0,0
1999-08-01,4212.8,1328,-2884.8,16577,12219.1,-4357.9,87837,58713,-29124,6180.5,0,-6180.5,10210.3,4836.1,-5374.2,15478,16571,1093,8331.6,6594.2,-1737.4,5383.6,4460.1,-923.5,26908.8,21289.8,-5619,18508.148348,13567.891398,-4940.25695,1655.402821,717.777254,-937.625567000001,32029.1,15123.9,-16905.2,89748.3000000001,57438.9,-32309.4000000001,36626.4,16219.2,-20407.2,,,,664.9,1164.7,499.8,1349.5,415.8,-933.7,1.1,0.2,-0.9,17236.9,13815.1,-3421.8,0,0,0,9671.9,7474.7,-2197.2,198.2,163.1,-35.1,7.2,10.3,3.1,131.8,124.4,-7.40000000000001,246.8,182.3,-64.5,44,24.3,-19.7,335.6,175.8,-159.8,31.3,125.3,94,0.9,26.8,25.9,15.2,60.5,45.3,0,0.1,0.1,53.9,103.3,49.4,1,8.7,7.7,0.1,25.8,25.7,28.4,47.7,19.3,386.4,330.9,-55.5,0.1,1.8,1.7,2.7,5.3,2.6,2.3,3.9,1.6,0.2,5.5,5.3,0,0.3,0.3,0.2,2.1,1.9,1.8,9.5,7.7,0.9,2.8,1.9,1.9,5.5,3.6,2.7,21.1,18.4,140.6,55.2,-85.4,38.7,41.8,3.09999999999999,,,,,,,64.6,24.7,-39.9,0.4,3.7,3.3,0.1,1.9,1.8,601.5,255.3,-346.2,1133.8,384.5,-749.3,9.3,12.2,2.9,15.9,12.3,-3.6,0,99,99,178.5,68.7,-109.8,161.1,132.3,-28.8,13.1,15.4,2.3,204.7,258.5,53.8,1066.4,1134.3,67.8999999999999,2.8,35.9,33.1,16.5,43.9,27.4,242.2,413.6,171.4,0,0,0,17,31.2,14.2,494,326.7,-167.3,0,0,0,340,135.2,-204.8,239.1,126.5,-112.6,0.5,0.3,-0.2,204.3,103.2,-101.1,3188.4,3269.9,81.5,954.5,576,-378.5,663.6,1687.1,1023.5,597.4,939.1,341.7,31.2,21.9,-9.3,0,0.4,0.4,1.2,7.7,6.5,2338,1298,-1040,4569.4,2163.2,-2406.2,252,295.4,43.4,,,,65.4,35.4,-30,13.6,6.5,-7.1,162.9,36.7,-126.2,23.3,0.9,-22.4,723.1,634.5,-88.6,25.6,4.2,-21.4,31.3,24.7,-6.6,6.9,3.4,-3.5,59.9,56.5,-3.4,,,,482.2,197.2,-285,9.8,2.8,-7,47,16,-31,1.5,2.2,0.7,0.2,7.4,7.2,1.6,4.2,2.6,6.8,9.3,2.5,0,5.9,5.9,11.8,0.8,-11,0,1,1,0.4,1.7,1.3,1.3,26.9,25.6,465.8,396.2,-69.6,135.6,61,-74.6,0.1,0.5,0.4,31,14,-17,0.1,0.4,0.3,0,0.5,0.5,1982.6,690.7,-1291.9,,,,5.2,3.1,-2.1,26.8,8.1,-18.7,1.6,2.7,1.1,15.3,6.8,-8.5,0.1,2.4,2.3,,,,,,,,,,0.3,1,0.7,34.3,58.9,24.6,44.1,11.9,-32.2,17.5,7.9,-9.6,178.9,225.9,47,3.4,15.9,12.5,16.7,13,-3.7,4.2,27.6,23.4,347,0,-347,0,0,0,178.3,200.3,22,0,0,0,0.5,0.4,-0.1,3.4,37.6,34.2,209.3,57.8,-151.5,,,,802.2,474.7,-327.5,24.7,10.6,-14.1,69.5,135.7,66.2,0.3,15.8,15.5,15.9,14.4,-1.5,20.9,30.2,9.3,1,1.5,0.5,893,300.3,-592.7,164,23.1,-140.9,12.5,0.7,-11.8,225.9,33.5,-192.4,156.5,16.1,-140.4,21.6,1.4,-20.2,1316.4,378.4,-938,48.1,30.9,-17.2,1.6,0.2,-1.4,59.6,1.4,-58.2,2020.3,732.9,-1287.4,1511.7,1638.7,127,878.5,174.9,-703.6,,,,20.4,3,-17.4,1192.9,674.4,-518.5,112.4,4.9,-107.5,0,0,0,3,0.8,-2.2,8022.1,1151.3,-6870.8,8.5,0.4,-8.1,0,0.5,0.5,2686.7,2251.2,-435.5,1042,1050.4,8.40000000000009,3091.1,1653.9,-1437.2,10801,4695.7,-6105.3,508.8,951,442.2,0,0.2,0.2,0,0,0,0,0,0,0,0,0,12.1,2.2,-9.9,129.1,139.4,10.3,0,0.2,0.2,0.3,0.3,0,0,0,0,0.8,0.9,0.1,0,0.1,0.1,0.1,0.1,0,0.1,0.1,0,0.1,1,0.9,0,0,0,0,1.2,1.2,0,0,0,2.1,7.7,5.6,0.3,5.2,4.9,1.2,1.9,0.7,2.3,1.7,-0.6,0,0.1,0.1,7.2,51,43.8,0.5,0.5,0,30,36.6,6.6,219,41.9,-177.1,5.1,41.2,36.1,0,0,0,51.8,181.5,129.7,0,1.8,1.8,,,,0,0,0,0.2,1.9,1.7,0.3,0.8,0.5,7.9,2,-5.9,2.7,5.7,3,0.6,1.6,1,11.1,0.9,-10.2,0.2,0.6,0.4,3.5,9.8,6.3,10.7,30.1,19.4,0,1.2,1.2,0.1,1.4,1.3,0.2,2.4,2.2,528.8,47.8,-481,0,0.4,0.4,133.4,2.8,-130.6,1.1,0.1,-1,0,0,0,0.1,1.4,1.3,0.1,2,1.9,213.9,22.3,-191.6,36.3,5.7,-30.6,0,0,0,0,0.2,0.2,0.1,0.2,0.1,2.6,2.7,0.1,11,1.7,-9.3,0,0.4,0.4,0.9,2.6,1.7,0,0.1,0.1,4.4,9.3,4.9,0,0,0,0,0.9,0.9,0.5,1.4,0.9,13.3,7,-6.3,0.4,0.2,-0.2,0,0.1,0.1,3.2,7.2,4,21,2.2,-18.8,0.5,2.2,1.7,7.5,1.4,-6.1,,,,0.4,0,-0.4,0,0.2,0.2,0,0.3,0.3,296,225.1,-70.9,6.7,1.5,-5.2,1.6,2.6,1,1,1.3,0.3,3,0.2,-2.8,9.4,3,-6.4,4.9,0.6,-4.3,10.1,0.4,-9.7,0,19.2,19.2,0,0,0
1999-09-01,4184.1,1305.8,-2878.3,16117.9,12426.3,-3691.6,88512,60053,-28459,6420.3,0,-6420.3,9988.7,5099.8,-4888.9,16110,17049,939,8375.7,6218.3,-2157.4,5407.4,4469.8,-937.599999999999,27168.3,22228.2,-4940.1,18007.55708,14475.316673,-3532.240407,1665.678794,808.317389,-857.361405,32693.2,15159.9,-17533.3,90244.9,59431.9,-30813,37298,15936.6,-21361.4,,,,696,1471.2,775.2,1405,479.4,-925.6,1.5,0.1,-1.4,17324.8,14423,-2901.8,0.3,0.2,-0.1,9843.5,7805.2,-2038.3,184.2,139.7,-44.5,6.9,11.3,4.4,140.2,114.1,-26.1,244,194.8,-49.2,39.8,30.7,-9.1,349.7,200.7,-149,25.6,128.5,102.9,1.3,32.8,31.5,11.4,57,45.6,0.6,0.1,-0.5,64.3,102.2,37.9,0.3,6.1,5.8,0.4,24.4,24,29,44.6,15.6,393.8,329.9,-63.9,0.2,1,0.8,0.7,3.2,2.5,2.5,2.7,0.2,0.3,6.8,6.5,0,0.4,0.4,0.4,2.7,2.3,7.8,8.5,0.7,1.5,5.3,3.8,1.8,3.5,1.7,22.6,22.7,0.0999999999999979,145.1,62.8,-82.3,18,38.5,20.5,,,,,,,74,23.7,-50.3,0.2,4.6,4.4,0.1,1.7,1.6,577.8,283,-294.8,1187.8,356.4,-831.4,11.1,15.6,4.5,6.4,10.3,3.9,1.8,0.6,-1.2,131.6,82.9,-48.7,192.3,136,-56.3,20.1,28.4,8.3,236.6,226.3,-10.3,1042,1134.1,92.0999999999999,6.4,37.6,31.2,16.7,41.8,25.1,210.2,512.1,301.9,0.2,0,-0.2,34.3,19.9,-14.4,646.7,351.5,-295.2,0,0,0,363.1,93.5,-269.6,211.5,103,-108.5,1.9,0.1,-1.8,213.9,123.4,-90.5,3404.1,2999.4,-404.7,1006.7,550.7,-456,673.3,1651,977.7,739.3,993.8,254.5,18.6,196.8,178.2,0,1,1,0.8,0.6,-0.2,2031.4,1457.3,-574.1,4314.9,2009,-2305.9,256.8,183.9,-72.9,,,,63.2,50.2,-13,19.9,6.5,-13.4,169,43.4,-125.6,20.9,0.9,-20,757.5,1059.8,302.3,29.7,13,-16.7,38.8,20.9,-17.9,6.3,2.9,-3.4,77.2,64.8,-12.4,,,,348,486.9,138.9,10.4,3,-7.4,52.9,8.5,-44.4,1,6.9,5.9,1.1,4.2,3.1,0.9,3.2,2.3,24.6,9.4,-15.2,0.1,5.6,5.5,5.2,0.1,-5.1,0.2,4.8,4.6,0.7,2.2,1.5,2.5,82.7,80.2,346.6,448.9,102.3,98.2,265.9,167.7,0.7,0.3,-0.4,28.1,17.7,-10.4,0.3,0.1,-0.2,0,0.1,0.1,1658.4,771.1,-887.3,,,,9.8,5.6,-4.2,25,8.1,-16.9,1.4,1.5,0.1,5.7,6.5,0.8,0,2.4,2.4,,,,,,,,,,0.2,0.9,0.7,37.9,79.2,41.3,29.7,10.9,-18.8,16.8,10.9,-5.9,198.9,216.5,17.6,2.4,14.1,11.7,6.7,16.3,9.6,6.1,39.3,33.2,390.4,0,-390.4,0,9.1,9.1,220.8,183.8,-37,0,0.2,0.2,0.3,0.9,0.6,0.9,18.7,17.8,160.1,67.9,-92.2,,,,857.1,384.9,-472.2,31.8,7.5,-24.3,58.7,206,147.3,11.9,10.8,-1.1,14.4,13.5,-0.9,19.4,22.9,3.5,0.2,0.7,0.5,875.8,369,-506.8,161.3,33.7,-127.6,13.7,5.7,-8,207.1,29.8,-177.3,158.1,14.6,-143.5,23.2,0.2,-23,1326.5,376.1,-950.4,53.4,16.8,-36.6,1.1,0.1,-1,61.4,1.5,-59.9,1966.5,763.4,-1203.1,1517.4,1494.5,-22.9000000000001,898.3,171.8,-726.5,,,,33.4,4.6,-28.8,1166.7,575,-591.7,116.9,3.5,-113.4,0,0.1,0.1,5.2,0.4,-4.8,8198.2,1325.3,-6872.9,8.3,1,-7.3,0,0.5,0.5,2797.4,2020.9,-776.5,1054.4,1175.9,121.5,3006.5,1527,-1479.5,11271.3,4649.9,-6621.4,495.4,1143,647.6,0,0.2,0.2,0,0.1,0.1,0,0.2,0.2,0,0,0,26.1,3.4,-22.7,144.8,301.7,156.9,0.2,0.1,-0.1,0.6,0.2,-0.4,0,0,0,0.5,1.2,0.7,0.1,0,-0.1,0,0.1,0.1,0,0.1,0.1,0.1,1.1,1,0,0,0,0,1.9,1.9,0,0,0,2.9,8.4,5.5,2.9,3,0.1,0.8,2.6,1.8,1.5,1.6,0.1,0,0.1,0.1,19.6,1.6,-18,0.5,0.7,0.2,33.9,34.7,0.800000000000004,167,44.9,-122.1,3.6,11.9,8.3,0,0,0,56.1,236.4,180.3,0,0.1,0.1,,,,0,0,0,6.3,39.7,33.4,0.1,4.5,4.4,2,2.7,0.7,0.9,3.8,2.9,0.2,5.8,5.6,6.9,2.9,-4,1,0.9,-0.1,9.3,10.3,1,11.5,21.6,10.1,0,0.3,0.3,2.5,0.8,-1.7,0.1,2.4,2.3,433,57.3,-375.7,0,0.1,0.1,167.5,7,-160.5,0.1,0.7,0.6,0,0,0,0,1.8,1.8,0.3,1.5,1.2,326.4,22,-304.4,40.9,5.2,-35.7,0,0,0,0,0.1,0.1,0,0,0,2.8,2.9,0.1,15.8,0.6,-15.2,0.1,0.1,0,0.4,9.3,8.9,0,0,0,2.1,19,16.9,0,0.2,0.2,0,0.2,0.2,1.4,0.8,-0.6,8.1,14.3,6.2,0.6,0.6,0,0,0,0,3.3,2.7,-0.6,25.2,3.2,-22,0.5,1.3,0.8,9.5,0.4,-9.1,,,,0.5,0,-0.5,0,0.6,0.6,0,0.2,0.2,284.9,223.8,-61.1,1.9,1,-0.9,1.6,2.8,1.2,4,2.9,-1.1,3,0.1,-2.9,10.6,3.3,-7.3,9.3,0.6,-8.7,8.2,0,-8.2,0,41.9,41.9,0,0,0
1999-10-01,4191.2,1457.8,-2733.4,18074.2,13680.9,-4393.3,89923,60037,-29886,6490.5,0,-6490.5,10369.3,5146,-5223.3,16704,17824,1120,8517.7,6368.9,-2148.8,5355.1,5054,-301.1,27806.1,23285.2,-4520.9,20524.07811,15245.314099,-5278.764011,1638.044828,984.926243,-653.118584999999,33554,15777,-17777,94460,62972.6,-31487.4,38512.6,16646.4,-21866.2,,,,622.2,1646.3,1024.1,1409.3,629.6,-779.7,1.6,0.6,-1,17787.3,14824.3,-2963,0.4,0.1,-0.3,10018.8,8460.9,-1557.9,175.2,157.7,-17.5,8,11.5,3.5,142.1,123.9,-18.2,237,182.2,-54.8,36.8,34.4,-2.4,367.5,231.3,-136.2,24.9,227.6,202.7,12.6,29.7,17.1,11.2,74,62.8,0,0.2,0.2,54.4,110.8,56.4,1,7.3,6.3,0.2,29,28.8,23.2,43.6,20.4,364.1,353.8,-10.3,0.3,2.3,2,0.7,3.7,3,3,3.8,0.8,0.1,6.7,6.6,0.1,0.3,0.2,2,3.3,1.3,1.7,8.4,6.7,1,4.6,3.6,2.4,9.2,6.8,4.1,28.5,24.4,135.5,55.8,-79.7,51.3,62.1,10.8,,,,,,,55.8,26.6,-29.2,0,4.9,4.9,0,3.8,3.8,608.5,326.6,-281.9,1110.6,439.4,-671.2,8.8,14.2,5.4,12.6,14.2,1.6,2.3,1,-1.3,159.2,87.6,-71.6,182.4,157,-25.4,20.8,26.9,6.1,293.7,260.6,-33.1,999.8,1341.5,341.7,3.8,43,39.2,19.1,42.4,23.3,216.9,458.7,241.8,0,0,0,31.6,30.3,-1.3,799.3,353.5,-445.8,0,0,0,441.6,119.3,-322.3,283,136.8,-146.2,1.8,0.1,-1.7,247.1,157.1,-90,3454.4,3297.4,-157,1284.1,568.4,-715.7,818.6,1661.2,842.6,878.7,1111.2,232.5,30.8,21,-9.8,0,0.7,0.7,4.5,0.1,-4.4,2254.3,1651.3,-603,4852.6,2534.8,-2317.8,248.1,278.5,30.4,,,,73,53.7,-19.3,15.5,7.6,-7.9,171.8,38.4,-133.4,23.2,0.7,-22.5,899.2,748.5,-150.7,20.7,13.1,-7.6,19.8,14.3,-5.5,14,3.3,-10.7,68.2,70.2,2,,,,560.9,296.5,-264.4,6.5,1.6,-4.9,56.8,10.6,-46.2,1.2,1.2,0,0.6,5.9,5.3,4.6,14.7,10.1,29.4,5.2,-24.2,0.1,2.5,2.4,5.8,1.7,-4.1,0.1,2.5,2.4,1.2,1.5,0.3,4.9,10.8,5.9,422.2,467.8,45.6,112.7,75.5,-37.2,0.7,0.3,-0.4,33.9,14.6,-19.3,0.1,0.4,0.3,0,0,0,1905,1063.3,-841.7,,,,11.2,43.5,32.3,25.3,7.4,-17.9,1.1,5.4,4.3,7,6.1,-0.9,0,7.4,7.4,,,,,,,,,,0.2,0.5,0.3,38.6,68.3,29.7,41.2,7.8,-33.4,16.4,6.1,-10.3,298.1,232.6,-65.5,2.6,12.3,9.7,5.4,12.6,7.2,2,21.3,19.3,637.9,0,-637.9,0,13.6,13.6,189.9,188.1,-1.80000000000001,0,0,0,0.5,1.9,1.4,3.3,20.8,17.5,128.7,72,-56.7,,,,851.4,464.8,-386.6,14.9,10.7,-4.2,62.1,188.2,126.1,0.7,18.1,17.4,13,15.9,2.9,19.9,22.3,2.4,0.1,1.9,1.8,874.7,265.8,-608.9,160.6,143.8,-16.8,11.1,1.7,-9.4,149.5,22.5,-127,147.7,15,-132.7,21.1,0.4,-20.7,1382.2,578.8,-803.4,111.6,40.3,-71.3,0.6,0.2,-0.4,46.4,2.5,-43.9,1922,811.6,-1110.4,1597.7,1372.2,-225.5,886.1,202.3,-683.8,,,,75.9,3.2,-72.7,1115.1,616,-499.1,101.8,4.3,-97.5,0,0.1,0.1,9.1,0.4,-8.7,8207.9,1069.1,-7138.8,6.7,0.4,-6.3,0,0.5,0.5,2887.9,1972.7,-915.2,1038,1104.3,66.3,2994.1,1919.7,-1074.4,12126,5086.3,-7039.7,443.2,1378.9,935.7,0,0.3,0.3,0,0,0,0,0,0,0,0,0,17.5,2.9,-14.6,140.8,233.5,92.7,0.1,0.3,0.2,0.9,0.3,-0.6,0,0,0,0.2,1.1,0.9,0.1,0.3,0.2,0,0.3,0.3,0,0.1,0.1,0.1,1.2,1.1,0,0,0,0,3.3,3.3,0,0,0,5.2,7.6,2.4,2.4,10.4,8,1.2,1.9,0.7,2.1,1.2,-0.9,0,0.1,0.1,8.1,2.3,-5.8,0.3,0.3,0,29.4,37,7.6,142.8,29.3,-113.5,2.9,12.2,9.3,0,0,0,53.7,274.7,221,0,0.7,0.7,,,,0,0,0,0,6.9,6.9,0,5.4,5.4,1.4,4.1,2.7,0.5,4,3.5,0.5,2.2,1.7,8.5,3.3,-5.2,1.5,0.8,-0.7,12.1,11.9,-0.199999999999999,18.8,21.6,2.8,0,0.5,0.5,0.1,1.6,1.5,0.3,0.9,0.6,356.7,37.4,-319.3,0,0.1,0.1,168.5,6.4,-162.1,0.6,0.1,-0.5,0,1.1,1.1,0,1.6,1.6,0,5.3,5.3,304.1,19.8,-284.3,61.7,2.6,-59.1,0,0,0,0,0.7,0.7,0.1,0.1,0,2.3,5.2,2.9,25.6,1.2,-24.4,0.4,0.1,-0.3,0.7,3.4,2.7,0,0,0,3.9,6.4,2.5,0,0.4,0.4,0,1.3,1.3,2.2,2.3,0.0999999999999996,7.2,14.1,6.9,0.5,2.2,1.7,0,0.3,0.3,1.8,4.6,2.8,21.3,1.6,-19.7,0.4,4.2,3.8,7.4,0.7,-6.7,,,,0.1,0,-0.1,0,0.1,0.1,0,0.3,0.3,354.8,257.4,-97.4,6.8,176.5,169.7,1.5,4.8,3.3,0.5,1.2,0.7,3.4,0.1,-3.3,8.9,5.1,-3.8,14.2,1,-13.2,11,0,-11,0,109.8,109.8,0,0,0
1999-11-01,4182.6,1479.7,-2702.9,18522.2,13081.9,-5440.3,90984,60206,-30778,6357.3,0,-6357.3,10636.5,4942.1,-5694.4,16923,16000,-923,8743.3,5680.1,-3063.2,5278.2,4737.3,-540.9,28177.7,23301.2,-4876.5,20870.808285,14785.950919,-6084.85736599999,1572.878793,843.541093,-729.3377,32473.4,14774,-17699.4,93580.1,60947.9,-32632.2,37057.2,15908.6,-21148.6,,,,620.8,1288.1,667.3,1310,553.2,-756.8,1.5,0.1,-1.4,18176.3,15099.4,-3076.9,1,0,-1,10001.4,8201.8,-1799.6,185.8,182.2,-3.60000000000002,9.4,12,2.6,126.6,122.9,-3.69999999999999,246.8,178.3,-68.5,42.5,31.1,-11.4,329.9,212.3,-117.6,28.3,136,107.7,2.6,27.5,24.9,17.6,101.9,84.3,0,0.4,0.4,60.5,124.3,63.8,0.6,9.6,9,1.6,37,35.4,22.9,52.2,29.3,378.9,339.5,-39.4,0,1.6,1.6,1.3,4.3,3,3,4.9,1.9,0.2,7.5,7.3,0.1,0.2,0.1,0.8,2.4,1.6,1.9,8.2,6.3,0.6,4.8,4.2,1.6,5.9,4.3,4,26.8,22.8,129.3,70.3,-59,30.8,64,33.2,,,,,,,74.3,22.5,-51.8,0.5,3.2,2.7,0,2,2,577.2,300.9,-276.3,1145.6,384.2,-761.4,9.2,11.4,2.2,21,11.2,-9.8,0.1,0.8,0.7,138,62.6,-75.4,162.6,167.8,5.20000000000002,38.2,26.3,-11.9,246.8,266.2,19.4,979.8,1217.4,237.6,4.7,43.3,38.6,19.4,42.6,23.2,233.4,406.7,173.3,0,0,0,18.9,16.4,-2.5,798.5,388.1,-410.4,0.6,0,-0.6,467.5,105.7,-361.8,249.8,131.6,-118.2,0.9,0.4,-0.5,234,108.7,-125.3,3563.4,3168,-395.4,1295,537.4,-757.6,849.4,1760.7,911.3,765.4,1002.3,236.9,26.7,195.1,168.4,0,0.4,0.4,1.3,0.2,-1.1,2378.9,1372.7,-1006.2,5085.1,2209.2,-2875.9,243,210.7,-32.3,,,,70.9,38.9,-32,16.4,9,-7.4,176.2,50.2,-126,23.1,0.8,-22.3,874.4,993.1,118.7,16.9,13.5,-3.4,22.1,15.6,-6.5,9.4,2.9,-6.5,73.5,92,18.5,,,,553.5,161.7,-391.8,8.5,1.6,-6.9,35.7,10.9,-24.8,1.3,5.7,4.4,1.2,3.5,2.3,3.2,7.6,4.4,33.2,5.8,-27.4,0.1,2.4,2.3,5.9,1,-4.9,0.2,0.5,0.3,0.8,1.4,0.6,2.5,21.4,18.9,458,783.8,325.8,122.1,65.6,-56.5,0.8,0.2,-0.6,29.5,18,-11.5,0.8,0.3,-0.5,0,0.7,0.7,1972.7,816.1,-1156.6,,,,10.8,13.1,2.3,21.7,7,-14.7,3.7,1.6,-2.1,9.9,6.6,-3.3,0,6.9,6.9,,,,,,,,,,0.2,0.5,0.3,41.6,71.9,30.3,29.7,8.5,-21.2,15.3,4.5,-10.8,244.4,320.8,76.4,2.1,13.1,11,5.9,10.2,4.3,3.4,34.5,31.1,485.4,0,-485.4,0,16.5,16.5,245,165,-80,0,0,0,0.5,1,0.5,2.5,17.4,14.9,146.5,58.4,-88.1,,,,853.9,409.5,-444.4,24.1,14.5,-9.6,71.7,334.2,262.5,8.1,12.9,4.8,17.9,14.9,-3,18.8,31.2,12.4,0.1,0.4,0.3,734.5,298.9,-435.6,155.5,47.1,-108.4,14.3,4.4,-9.9,133.1,38.1,-95,123.5,13.4,-110.1,19.7,0.5,-19.2,1307.6,433.7,-873.9,62.4,24.6,-37.8,1.1,0.1,-1,32.5,1.5,-31,1955.6,822.9,-1132.7,1589.5,1279.8,-309.7,831.2,183,-648.2,,,,32.2,4,-28.2,1096.7,604,-492.7,86.8,3.4,-83.4,0,0.1,0.1,5.8,0.4,-5.4,7543.5,1025.5,-6518,6.1,0.3,-5.8,0,0.6,0.6,3058.9,1810,-1248.9,924.2,1056.6,132.4,3170.6,1533.8,-1636.8,11578.5,5185.3,-6393.2,445.2,1094.3,649.1,0,0,0,0,0,0,0,0,0,0,0,0,26.7,2.4,-24.3,133.7,169.1,35.4,0,0.1,0.1,0.9,0.1,-0.8,0,0,0,0.3,1,0.7,0.1,0.2,0.1,0,0,0,0,0,0,0.2,0.9,0.7,0,0,0,0.1,2.2,2.1,0,0,0,5.4,9.2,3.8,1,2.4,1.4,0.9,1.5,0.6,0.4,1.4,1,0,0,0,5.6,2.5,-3.1,0.3,0.8,0.5,32.1,30.2,-1.9,175.2,38.7,-136.5,5,9,4,0,0,0,50.5,212.4,161.9,0,0.1,0.1,,,,0,0,0,6.5,134.5,128,0,1.1,1.1,12,2.7,-9.3,0.7,4.4,3.7,0.1,1.8,1.7,8.5,3.1,-5.4,0.5,1.5,1,28.4,9.6,-18.8,25.8,21,-4.8,0,0.7,0.7,7.3,1.8,-5.5,0.1,0.7,0.6,448.9,40.6,-408.3,0,0.2,0.2,163,3.2,-159.8,0,0,0,0,0,0,0,0.7,0.7,0,2,2,243.5,22.1,-221.4,15.2,3.7,-11.5,0,0,0,0,0.3,0.3,0.2,0,-0.2,2.7,3.3,0.6,29.6,0.2,-29.4,0.9,1,0.1,0.1,15.5,15.4,0,0.1,0.1,1.5,14,12.5,0,0.1,0.1,0,1.4,1.4,2.4,2.7,0.3,7,16.5,9.5,0.2,0.6,0.4,0,0,0,2.8,3.5,0.7,21.6,2.1,-19.5,0.7,3,2.3,8,0.4,-7.6,,,,0,0,0,0,0.1,0.1,0,0.1,0.1,231.9,226.8,-5.09999999999999,3.1,1.8,-1.3,1.2,3,1.8,1.4,1.4,0,1.7,0.8,-0.9,12.4,6,-6.4,10.9,1,-9.9,8.9,0,-8.9,0,82.7,82.7,0,0,0
1999-12-01,4282.3,3079.6,-1202.7,17884.8,13642.6,-4242.2,93115,62509,-30606,6252.5,0,-6252.5,10076.7,4629.5,-5447.2,17044,20283,3239,8861,7027.7,-1833.3,5545,4741.9,-803.1,26437.8,22431.1,-4006.7,20283.270343,15503.044703,-4780.22564,1645.348512,813.419802,-831.928710000001,32121.7,16001.5,-16120.2,91296.5,63807.1999999999,-27489.3000000001,36744.1,19088.4,-17655.7,,,,637.7,1188.1,550.4,1321.9,428.1,-893.8,2.2,0.1,-2.1,17012.1,13908.3,-3103.8,1.1,0,-1.1,9425.7,8522.8,-902.900000000001,235.9,148,-87.9,7.6,17.2,9.6,148.2,129.7,-18.5,239.9,170.6,-69.3,50.6,30.3,-20.3,329.4,199.2,-130.2,27.3,140.9,113.6,0.8,31.6,30.8,19.5,85.3,65.8,0,0.1,0.1,65.4,112.5,47.1,0.4,10.1,9.7,0.6,60.9,60.3,25.9,55.8,29.9,359.5,337.1,-22.4,0.1,1.8,1.7,1.5,6.6,5.1,3.1,3.9,0.8,0.1,11,10.9,0.1,0.3,0.2,6.1,2.8,-3.3,2.1,8.6,6.5,0.1,3,2.9,1.9,4.5,2.6,3,33.4,30.4,134.3,63.7,-70.6,29.7,65.1,35.4,,,,,,,65.6,23.9,-41.7,0.2,5.2,5,0,2.9,2.9,670.7,366.6,-304.1,1220.7,413.6,-807.1,13.5,10.4,-3.1,10.6,8.6,-2,0,3,3,153,77.8,-75.2,171.2,117.9,-53.3,18.8,20.8,2,243.9,365.8,121.9,999.6,1058.8,59.1999999999999,3.8,27.8,24,15.6,41.2,25.6,264.7,463.3,198.6,0,0,0,29.3,28.2,-1.1,768.1,344.6,-423.5,0,0,0,363.2,124.9,-238.3,246.2,113.6,-132.6,2.9,0,-2.9,231.9,117.2,-114.7,3549.5,3043.2,-506.3,704.3,574,-130.3,903.4,1800.1,896.7,724.5,1058.9,334.4,24.3,25.3,1,0,0.5,0.5,1.3,0.4,-0.9,2215.9,1919.7,-296.2,5189.3,2357,-2832.3,242.8,183.6,-59.2,,,,74.8,36.6,-38.2,16.2,9.5,-6.7,213.1,41.2,-171.9,24.7,0.5,-24.2,857.8,1119.1,261.3,24.8,11.8,-13,5.5,14.2,8.7,8.6,9.2,0.6,76.6,74.2,-2.39999999999999,,,,676.5,141.9,-534.6,6.8,1.7,-5.1,63.7,24.4,-39.3,1,4.7,3.7,0.8,1.9,1.1,1.3,9.1,7.8,16.8,4.8,-12,0.1,0.3,0.2,8.6,0.4,-8.2,0.8,1,0.2,1.1,2.9,1.8,2.7,76.8,74.1,438.3,725.4,287.1,123.5,86.1,-37.4,0.6,0.6,0,31.3,15.9,-15.4,1.4,0,-1.4,0,0.2,0.2,1983,984.6,-998.4,,,,15.7,4.1,-11.6,22.1,10.8,-11.3,1.3,3.6,2.3,8.2,5,-3.2,0.3,2.8,2.5,,,,,,,,,,0.5,1.2,0.7,60.6,76.2,15.6,44.7,11.3,-33.4,22.7,8.7,-14,243.7,279.4,35.7,6.4,9.7,3.3,10.8,17.8,7,4.9,22.2,17.3,524.6,0,-524.6,2.4,8.3,5.9,182.5,183.1,0.599999999999994,0.1,0,-0.1,0.8,1.1,0.3,2,23.2,21.2,142,107.2,-34.8,,,,951.5,1557.1,605.6,30.2,11,-19.2,67.1,691.6,624.5,0.4,6.8,6.4,18.2,27.9,9.7,21.6,23.7,2.1,0.1,1.9,1.8,658.7,332.2,-326.5,160.3,21.2,-139.1,16.7,0.9,-15.8,133.7,21.6,-112.1,135.4,15.8,-119.6,32.8,0.2,-32.6,1269,581.7,-687.3,49.5,31.2,-18.3,0.2,0,-0.2,34.5,1.3,-33.2,1885.9,828.3,-1057.6,1572.2,1508.9,-63.3,761,197.7,-563.3,,,,28.8,4.8,-24,1008.9,621.7,-387.2,75.1,3.2,-71.9,0.1,0,-0.1,6.9,1.5,-5.4,6690.3,1093.9,-5596.4,5.6,0.4,-5.2,0,7.7,7.7,3151.3,2300.7,-850.6,883,1193,310,3254.5,2025.1,-1229.4,12185,5059,-7126,479.2,991.1,511.9,0,0.1,0.1,0,0,0,0,0,0,0,0,0,4.4,3.4,-1,141.9,170.9,29,0.1,0,-0.1,1.4,0.3,-1.1,0,0,0,0.3,2,1.7,0,0,0,0,0.1,0.1,0,0.2,0.2,0.4,0.8,0.4,0,0,0,0,1.1,1.1,0,0,0,2.3,9.7,7.4,0,2.7,2.7,0.9,2.3,1.4,0.4,1.3,0.9,0,0,0,6,1.4,-4.6,0.4,0.9,0.5,34.8,20.8,-14,226,43.4,-182.6,5,15.2,10.2,0,0,0,57.3,305.3,248,0,0,0,,,,0,0,0,0.2,17.5,17.3,0,5.1,5.1,4.2,3,-1.2,0.5,5.2,4.7,1.1,3.2,2.1,10.3,2,-8.3,0.6,2.5,1.9,50,11.3,-38.7,15.4,12.6,-2.8,0,0.3,0.3,0.3,1.7,1.4,0.2,1.6,1.4,356.9,49.7,-307.2,0,0.2,0.2,205.8,3.5,-202.3,0.3,0.1,-0.2,0,0.1,0.1,0,1.2,1.2,0,1.9,1.9,199,20.6,-178.4,54.1,4,-50.1,0,0,0,0,1.4,1.4,0.2,0,-0.2,3.4,5,1.6,22,0.6,-21.4,1.2,0.1,-1.1,0.2,2.2,2,0,0.8,0.8,0.7,14.7,14,0.1,0.1,0,0,5.7,5.7,3.8,1.7,-2.1,7.7,7.3,-0.4,1.8,0.5,-1.3,0.1,0.1,0,4.9,2.9,-2,23.4,3.7,-19.7,0.4,2.1,1.7,6.6,0.4,-6.2,,,,0.2,0,-0.2,0,0.2,0.2,0,0.1,0.1,314.9,218.4,-96.5,0.9,0.8,-0.1,1.8,4.8,3,1.6,1.3,-0.3,3.3,5.6,2.3,10,10.4,0.4,4.8,0.5,-4.3,8.8,0.1,-8.7,0,41.6,41.6,0,0,0
2000-01-01,4381.8,1484.4,-2897.4,15771.3,12235.6,-3535.7,93900,62543,-31357,5887.2,0,-5887.2,9788.2,4452.3,-5335.9,14673,16659,1986,8374.7,5981.3,-2393.4,5425.6,4275.4,-1150.2,27161.6,21569,-5592.6,17895.280117,14365.699084,-3529.581033,1593.489217,814.731535,-778.757682,29768.9,14260.9,-15508,87187.8,57679.0999999999,-29508.7000000001,34432,15517.7,-18914.3,,,,678.8,1136.1,457.3,1309,461.6,-847.4,1,0,-1,17578.5,13604.5,-3974,0.1,0.1,0,9583.1,7964.5,-1618.6,197.4,137.8,-59.6,4.5,14.2,9.7,124.1,117.1,-7,178.3,190.2,11.9,39,29.4,-9.6,259.1,183.3,-75.8,31.6,148.9,117.3,4.8,36.5,31.7,18,112.9,94.9,0,0.8,0.8,52.3,94.1,41.8,0.5,7.5,7,0.1,25.4,25.3,16.2,44.1,27.9,178.9,297,118.1,0.1,1.2,1.1,1.3,5,3.7,2.3,4.2,1.9,0.1,11.6,11.5,0,0.3,0.3,1.6,2.6,1,1.1,9.6,8.5,0.4,2.1,1.7,1.8,4.8,3,2.4,23.1,20.7,164.3,97.8,-66.5,75,55.1,-19.9,,,,,,,102.2,26.4,-75.8,0.2,6,5.8,0.1,1.9,1.8,616.2,270.4,-345.8,1283.3,362.7,-920.6,8.6,10.2,1.6,10.3,8.9,-1.4,0,1.4,1.4,150.7,81.2,-69.5,162.7,147.9,-14.8,14.1,18.7,4.6,319.2,249.5,-69.7,1099,1008,-91,4.5,29.2,24.7,20.2,44.5,24.3,279,351.9,72.9,0,0,0,23.9,12.7,-11.2,623.6,350.9,-272.7,0,0,0,352.9,161.6,-191.3,252.4,102.3,-150.1,2.2,0,-2.2,210.6,137.3,-73.3,2948.5,3044.6,96.0999999999999,689.7,492.1,-197.6,717.9,1557.5,839.6,696.5,976.4,279.9,24.5,23.1,-1.4,0,1,1,0.8,0.4,-0.4,2329.1,1571.2,-757.9,4206.7,2102.6,-2104.1,250.3,178,-72.3,,,,71.1,40.7,-30.4,23.8,9.3,-14.5,147.3,36.7,-110.6,17.9,1.2,-16.7,780.1,1173.3,393.2,32.7,11.4,-21.3,10.1,12.1,2,10.2,6.1,-4.1,74.7,49.7,-25,,,,584.5,343.2,-241.3,6.5,5.5,-1,37,7,-30,1.6,9.7,8.1,1.6,1.9,0.3,0.3,7.7,7.4,26.6,7.6,-19,0.2,0.7,0.5,4.8,0.2,-4.6,0.5,1.6,1.1,1.7,0.9,-0.8,9.2,17.1,7.9,468.3,452.9,-15.4,102.2,68.5,-33.7,0.1,0.3,0.2,35.9,15.7,-20.2,0.3,0.5,0.2,0,0.2,0.2,1792.2,827.3,-964.9,,,,17.9,8.3,-9.6,19.6,12.1,-7.5,0.6,2.6,2,11.1,3.9,-7.2,0,3.9,3.9,,,,,,,,,,2.9,1,-1.9,32.1,146.3,114.2,23.2,10.1,-13.1,18.1,10,-8.1,197.4,336.2,138.8,1.3,11.1,9.8,4.8,19.5,14.7,10.2,25.7,15.5,196.3,0,-196.3,0,0.7,0.7,194.3,135,-59.3,0,0,0,0.2,3,2.8,3.1,30.9,27.8,201.6,58,-143.6,,,,1193,590.9,-602.1,22,9.4,-12.6,69.9,122.1,52.2,1,17.2,16.2,15.7,18.9,3.2,23.5,13.7,-9.8,0.1,0.1,0,790.2,288.4,-501.8,163,31.9,-131.1,17.1,0.5,-16.6,189.3,13,-176.3,160.7,8.1,-152.6,27.6,0.6,-27,1179.7,444.5,-735.2,66.9,42,-24.9,0.5,2.2,1.7,54,3,-51,1701.5,697.4,-1004.1,1400.6,1239,-161.6,789.5,168.5,-621,0,0,0,16.2,10.9,-5.3,1023.4,653.4,-370,94.7,2.6,-92.1,0.1,0.1,0,7.8,0.5,-7.3,6902.1,863.1,-6039,6.3,0.1,-6.2,0,2.5,2.5,2953.8,1986.2,-967.6,960.5,915.2,-45.3,3059.8,1841,-1218.8,10203.6,4772.2,-5431.4,513.4,1013.2,499.8,0,0.1,0.1,0,0.1,0.1,0,0,0,0,0,0,3,1.9,-1.1,146.7,96.3,-50.4,0,0.1,0.1,0.8,0.3,-0.5,0,0,0,0.3,0.8,0.5,0,0.1,0.1,0.1,0.1,0,0,0.2,0.2,0.1,0.6,0.5,0,0,0,0,1.6,1.6,0,0,0,4.8,9,4.2,0.1,5.9,5.8,1.2,2.4,1.2,0.9,0.8,-0.1,0,0.1,0.1,7.2,1.3,-5.9,0.2,1.2,1,40.4,21,-19.4,189.8,35.7,-154.1,4.9,10.8,5.9,0,0,0,48.9,284.1,235.2,0,0,0,,,,0,0,0,6.7,10.3,3.6,0.1,0.8,0.7,12.3,2.2,-10.1,0.3,4.3,4,0.2,0.7,0.5,8.5,2.9,-5.6,0.7,0.8,0.1,49.6,6.2,-43.4,20.8,13.5,-7.3,0,0.2,0.2,0,4.9,4.9,3.4,0.9,-2.5,436.3,136.5,-299.8,0,0.1,0.1,149.4,1.9,-147.5,0.1,0.8,0.7,0,0,0,0,0.6,0.6,0.1,2.4,2.3,235.8,17.2,-218.6,36.9,5.5,-31.4,0,0,0,0,0.3,0.3,0,0.1,0.1,5.6,5,-0.6,7.9,0.5,-7.4,0.8,0.1,-0.7,0,0.3,0.3,0,0,0,0.8,9.1,8.3,0,0.2,0.2,0.2,5.8,5.6,1.9,1.6,-0.3,8.1,10.7,2.6,0.6,0.2,-0.4,0.6,0,-0.6,3.5,2.1,-1.4,21,1.8,-19.2,0.8,4.6,3.8,11.7,2,-9.7,,,,0.1,0,-0.1,0,0.3,0.3,0,1.1,1.1,247.2,200.7,-46.5,6.2,0.7,-5.5,1.1,1.6,0.5,0.4,1,0.6,2.7,0.5,-2.2,8.6,4.1,-4.5,7.5,0.5,-7,9.7,0,-9.7,0,0,0,0,0,0
2000-02-01,4826,1704.6,-3121.4,17227.4,13586.1,-3641.3,95901,62409,-33492,6679,0,-6679,10348.4,4780,-5568.4,15442,16435,993,7971,5852.5,-2118.5,5874.5,4284.7,-1589.8,28457.4,23432.9,-5024.5,19632.986845,15365.89594,-4267.090905,1896.751487,921.024606,-975.726881000001,30444.5,14520.7,-15923.8,91687.7,61179.1,-30508.6,35269.7,16039.6,-19230.1,,,,554.2,1134.8,580.6,1551.3,416.3,-1135,0.8,0.1,-0.7,18092,14968.6,-3123.4,1.2,0.1,-1.1,10365.4,8464.3,-1901.1,217.8,138.5,-79.3,6.8,13.6,6.8,161.9,124.2,-37.7,256.1,209.8,-46.3,50.4,32,-18.4,315.3,181.7,-133.6,17.2,99.7,82.5,1.3,28,26.7,17.9,73.1,55.2,0,0.1,0.1,56.4,103.2,46.8,0.3,6.1,5.8,0.6,22.1,21.5,23.1,49.6,26.5,351,351.1,0.100000000000023,0.1,1.8,1.7,1.4,5.7,4.3,2.9,3.2,0.3,0.2,11.3,11.1,0,0.2,0.2,0.5,2.8,2.3,2.1,8.6,6.5,5.5,2.7,-2.8,1.8,4.3,2.5,3.2,26.9,23.7,127.5,58.6,-68.9,44.2,50.4,6.2,,,,,,,87.8,18.2,-69.6,0.1,5.9,5.8,0.1,1.8,1.7,577.3,259.2,-318.1,1496.7,419.7,-1077,12.7,12.9,0.200000000000001,9.4,9.6,0.199999999999999,0.1,1.3,1.2,167.2,84.2,-83,174,119,-55,11.7,25.9,14.2,300.5,231,-69.5,1090.8,1057.7,-33.0999999999999,4.2,29.4,25.2,37.9,46.3,8.4,238.6,352.9,114.3,0,0,0,22,14,-8,821.6,409.8,-411.8,0,0,0,426.5,137.3,-289.2,266.5,109.3,-157.2,2.5,0,-2.5,211.3,114.1,-97.2,3464.5,3688.7,224.2,1032.3,654.9,-377.4,728,1795.4,1067.4,778.2,1060.2,282,23.9,22.3,-1.6,0.3,1,0.7,6.8,0.3,-6.5,2092.3,1552.9,-539.4,4473.6,2235.4,-2238.2,242.5,224,-18.5,,,,75.2,119.3,44.1,25.5,7.5,-18,141.4,37.5,-103.9,26.4,1.2,-25.2,822.2,1111.3,289.1,55.2,8.8,-46.4,16.9,25.7,8.8,7.8,7.5,-0.3,72.8,54,-18.8,,,,636.5,128.5,-508,5.8,4.2,-1.6,92.2,7.6,-84.6,2.3,1.9,-0.4,6.9,9.6,2.7,0.7,5.1,4.4,34.3,6.4,-27.9,0.1,0.8,0.7,7.4,7.7,0.3,0.8,0.2,-0.6,1.2,1.3,0.1,1.7,8.8,7.1,497.4,414,-83.4,101.3,75.8,-25.5,0.1,1,0.9,33.9,39.6,5.7,0.6,0.1,-0.5,1.9,0,-1.9,1956.2,820.4,-1135.8,,,,10.1,15.3,5.2,24.8,21.2,-3.6,0.9,1.9,1,17.1,7.7,-9.4,0,2.1,2.1,,,,,,,,,,0.5,0.8,0.3,82.5,77.2,-5.3,32.4,16.4,-16,15.1,14,-1.1,230.4,273.5,43.1,1.4,10.7,9.3,9.1,13.9,4.8,3.4,19.8,16.4,477.9,0.2,-477.7,0,0,0,215.5,158.2,-57.3,0,0,0,0.4,0.2,-0.2,3.1,17.4,14.3,239.6,68.2,-171.4,,,,928.8,746,-182.8,28.4,9.5,-18.9,62.1,152.3,90.2,0.3,10.5,10.2,15.1,14.4,-0.699999999999999,25,17,-8,0,0.1,0.1,823.4,353.2,-470.2,159.8,25.4,-134.4,23.6,0.9,-22.7,187.3,15.4,-171.9,149.3,13.8,-135.5,27.1,0.3,-26.8,1109.4,482,-627.4,63,29.2,-33.8,0.4,0.1,-0.3,71.2,1.8,-69.4,1775.9,742.2,-1033.7,1422.6,1194.6,-228,702.5,200.5,-502,0,0,0,43.2,9.9,-33.3,1011.4,631.3,-380.1,96.4,2,-94.4,0,0.1,0.1,6.3,1.2,-5.1,6584.4,972.7,-5611.7,6.8,0.2,-6.6,0,0.1,0.1,2833.2,2052.8,-780.4,841.8,1010.6,168.8,2873.4,1594.6,-1278.8,11720.7,4991.8,-6728.9,381.2,998.2,617,0,0.1,0.1,0,0.1,0.1,0.1,0,-0.1,0,0,0,3.2,1.9,-1.3,154.5,117.6,-36.9,0,0.1,0.1,0.5,0.1,-0.4,0,0,0,0.3,0.7,0.4,0,1.5,1.5,0,0,0,0,0.1,0.1,0.1,0.2,0.1,0,0,0,0,1.3,1.3,0,0,0,2,5.2,3.2,0.8,2.3,1.5,1.3,1.4,0.0999999999999999,0.5,0.9,0.4,0,0.4,0.4,9.4,2.2,-7.2,0.2,0.5,0.3,33.4,43.3,9.9,241.6,32.5,-209.1,5.9,12.5,6.6,0,0,0,63.7,416.2,352.5,0.1,0,-0.1,,,,0,0,0,20,7.8,-12.2,0,0.5,0.5,11,5.3,-5.7,0.2,4.1,3.9,0.1,1.1,1,9.6,9.7,0.0999999999999996,0.8,0.6,-0.2,94.9,10.2,-84.7,16.3,9.7,-6.6,0,0.5,0.5,0.2,2.2,2,0.5,0.7,0.2,648.4,75.6,-572.8,0.8,0.1,-0.7,149.3,9.4,-139.9,0.2,0,-0.2,0,0,0,0.1,0.3,0.2,0.1,1.8,1.7,175.8,16.6,-159.2,46.2,6.2,-40,0,0.1,0.1,0.4,0.1,-0.3,0.2,0.1,-0.1,3.2,3.8,0.6,16.6,0.3,-16.3,1,0.2,-0.8,0.3,1.6,1.3,0,0.4,0.4,1,3.6,2.6,0,0.3,0.3,0,1.9,1.9,2.5,2.9,0.4,5.9,7.6,1.7,0.4,0.3,-0.1,1.2,0.1,-1.1,4,2.3,-1.7,24.3,1.4,-22.9,5.9,3.2,-2.7,7.5,0.6,-6.9,,,,0,0.1,0.1,0,0.1,0.1,0,0.1,0.1,268.9,209.4,-59.5,1.2,1.2,0,1.1,4.4,3.3,0.9,1.8,0.9,3.3,1,-2.3,14.1,3.7,-10.4,1.4,1.8,0.4,10.9,0,-10.9,0,0,0,0,0,0
2000-03-01,5414.2,1417.8,-3996.4,20757.7,14729.9,-6027.8,99176,63135,-36041,7517.5,0,-7517.5,11799.9,5455.5,-6344.4,17631,18550,919,8555,7300.5,-1254.5,6185.8,5045,-1140.8,32414,26726.7,-5687.3,23447.482466,16435.076367,-7012.406099,2378.942179,810.653195,-1568.288984,32606.5,17515,-15091.5,103244.5,68947.3999999999,-34297.1000000001,38137.4,18720.1,-19417.3,,,,678.7,1209.6,530.9,2014.7,507.4,-1507.3,0.2,0.1,-0.1,20761.5,17085.7,-3675.8,1.3,0.2,-1.1,11652.5,9641.1,-2011.4,231.9,167.8,-64.1,14.3,20.7,6.4,181.6,163.2,-18.4,286.8,233.3,-53.5,59.1,36,-23.1,350.8,232.1,-118.7,23.7,136.3,112.6,0.6,38,37.4,35.7,85.2,49.5,0,4.1,4.1,69.7,121,51.3,0.4,7.1,6.7,0.5,30.8,30.3,24.9,53.8,28.9,414.2,412.8,-1.39999999999998,0.2,2.2,2,1.5,6.2,4.7,3.3,8.7,5.4,0.3,13.4,13.1,0,0.3,0.3,0.8,3.5,2.7,2,10.4,8.4,0.4,2.8,2.4,2.7,6.3,3.6,3.2,26.1,22.9,121.4,73.4,-48,77.7,52.5,-25.2,,,,,,,103.2,25.9,-77.3,0.1,8.1,8,0.1,2,1.9,592.6,359.2,-233.4,1515.5,491.9,-1023.6,12.2,12.5,0.300000000000001,14.2,11.7,-2.5,0.4,1,0.6,165.3,95.5,-69.8,160,139.1,-20.9,17.3,17.1,-0.199999999999999,349.5,304.8,-44.7,1053.1,1140.5,87.4000000000001,3.9,31.3,27.4,47.5,53.2,5.7,242.1,403.1,161,1.3,0,-1.3,22.7,14.9,-7.8,906,382.2,-523.8,0,0,0,485,117.6,-367.4,318.8,137.8,-181,2.1,0,-2.1,264,164,-100,4119.4,3516,-603.4,1314.2,633.5,-680.7,897.5,1897.4,999.9,982.7,1288.7,306,28.4,26.8,-1.6,0.1,0.6,0.5,2.8,0.4,-2.4,2636.2,1829.7,-806.5,5409.5,2831.7,-2577.8,269.8,229.9,-39.9,,,,84.1,38.7,-45.4,20.2,10,-10.2,397.6,40.5,-357.1,26.4,0.9,-25.5,857,1068.9,211.9,42.5,8.3,-34.2,59.9,11.8,-48.1,8.4,4,-4.4,95.1,63.5,-31.6,,,,830.5,127.3,-703.2,3,1.2,-1.8,54,20.7,-33.3,1.5,2.2,0.7,2.1,7.9,5.8,0.4,5.5,5.1,37.7,10.5,-27.2,0.1,2,1.9,5.7,0.6,-5.1,0.9,0,-0.9,1.9,0.7,-1.2,2.5,6.6,4.1,538.3,446.5,-91.8,101.4,82.5,-18.9,0.2,0.3,0.1,39,24.6,-14.4,0.9,0,-0.9,0,0,0,2154.4,930.2,-1224.2,,,,14.4,3.9,-10.5,21.3,12.1,-9.2,0.9,3.5,2.6,16.4,5,-11.4,0,2.2,2.2,,,,,,,,,,0.6,2.5,1.9,47.1,98.7,51.6,38.7,15.2,-23.5,14.8,12.5,-2.3,266.6,271.6,5,2.2,20.9,18.7,19.4,29.3,9.9,10.9,30.2,19.3,376.6,0,-376.6,0,0,0,240.7,263.5,22.8,0,0.1,0.1,0.5,3.6,3.1,4.6,32.1,27.5,155.4,58.5,-96.9,,,,1217.2,360,-857.2,29.9,11.2,-18.7,83.9,176.7,92.8,0.5,15.2,14.7,18.8,16.5,-2.3,34,61.1,27.1,0,1.1,1.1,1085.9,372,-713.9,169.6,28.4,-141.2,30.9,8.4,-22.5,194.7,18.5,-176.2,180.8,8.8,-172,37.4,1.4,-36,1290.8,480.4,-810.4,60,39.9,-20.1,1.1,0.1,-1,75.6,3.2,-72.4,2029.3,826.4,-1202.9,1473,1620.7,147.7,832.3,236.6,-595.7,0,0,0,40.7,21.4,-19.3,1183.8,708.6,-475.2,74,4.7,-69.3,0.3,0.1,-0.2,8.3,0.4,-7.9,6424.1,1330.5,-5093.6,7.5,1.4,-6.1,0,0,0,3133.6,2433,-700.6,796.3,1246.1,449.8,3152.1,2000.7,-1151.4,12810.4,5898.9,-6911.5,453.3,1053.9,600.6,0,0,0,0,0,0,0,0.1,0.1,0,0,0,3.6,2.4,-1.2,199.8,132,-67.8,0.6,0.2,-0.4,0.3,0.3,0,0,0,0,0.3,0.8,0.5,0.1,0.5,0.4,0.1,0.1,0,0,0.5,0.5,0.3,0.2,-0.1,0,0,0,3.4,1.5,-1.9,0,0,0,4.4,9.2,4.8,0.4,1.5,1.1,1.5,2.7,1.2,0.8,1.2,0.4,0,0,0,9.2,2.5,-6.7,0.6,0.3,-0.3,38.7,26.2,-12.5,217.7,39,-178.7,6,16.7,10.7,0,0,0,100.8,220.7,119.9,0,0.3,0.3,,,,0,0,0,6.1,6.7,0.600000000000001,0,2.7,2.7,13.7,3.2,-10.5,0.3,5.9,5.6,0.5,1.4,0.9,2.4,7.5,5.1,0.3,3.9,3.6,32.9,9.7,-23.2,13.7,23.8,10.1,0,2.6,2.6,0.2,2.2,2,0.1,0.8,0.7,985.7,44,-941.7,0.5,0.3,-0.2,205.2,3.2,-202,0.2,1.4,1.2,1.1,0,-1.1,0.1,0.3,0.2,0.2,3.2,3,272.9,26,-246.9,74,9.9,-64.1,0,0,0,0,0.8,0.8,0,0.1,0.1,1.6,2.6,1,3.4,0.9,-2.5,1.8,0.2,-1.6,0,1.2,1.2,0,0.2,0.2,0.7,20.3,19.6,0,0.1,0.1,0,0.8,0.8,2.1,2.2,0.1,11.8,8.7,-3.1,0.5,0.4,-0.1,0,0,0,3.5,6,2.5,21.6,2,-19.6,1,3.6,2.6,8.8,0.6,-8.2,,,,0.1,0,-0.1,0,0.3,0.3,0,0.2,0.2,318,216.8,-101.2,1.4,1.2,-0.2,1.4,2.5,1.1,0.2,0.9,0.7,3.3,59.5,56.2,7.2,4,-3.2,2.6,1,-1.6,12.4,0.2,-12.2,0,0,0,0,0,0
2000-04-01,4999.9,1438.2,-3561.7,18285.4,13860.9,-4424.5,99242,63814,-35428,6826.6,0,-6826.6,10279.6,4873,-5406.6,16506,18116,1610,8222.6,6844.9,-1377.7,5441.8,4775.1,-666.7,29192.8,23837.8,-5355,20577.653291,15557.898711,-5019.75458,2293.395445,799.316623,-1494.078822,32161.9,16171.4,-15990.5,95141.1,63302.6,-31838.5,36902.3,16940.1,-19962.2,,,,731.1,1378.4,647.3,1984.8,365.4,-1619.4,0.8,0.1,-0.7,18637.9,14794.3,-3843.6,0.9,0.1,-0.8,10554.9,9043.5,-1511.4,193.3,148.9,-44.4,6.9,20.1,13.2,133.8,133.4,-0.400000000000006,233.5,210.8,-22.7,42.1,29.9,-12.2,283.4,197.9,-85.5,20.6,160.6,140,11.6,35.5,23.9,15.4,83.1,67.7,0,0.2,0.2,58.8,107.6,48.8,0.3,8.1,7.8,0.3,32.4,32.1,22.7,50.2,27.5,327.1,388.6,61.5,0.1,1.9,1.8,2.5,4.1,1.6,2.6,4.4,1.8,0.1,13.7,13.6,0,0.5,0.5,0.4,2.1,1.7,1.9,9.6,7.7,0.4,3.5,3.1,2.4,5.9,3.5,2.4,24.8,22.4,139.6,107,-32.6,38.7,52.3,13.6,,,,,,,70.1,26.5,-43.6,0.1,9.2,9.1,0.1,1.5,1.4,543.6,304.6,-239,1390.2,530.9,-859.3,11.6,15.9,4.3,3.6,10.1,6.5,0,1.3,1.3,143,78.9,-64.1,159.2,143.2,-16,18.7,21.8,3.1,292,274.1,-17.9,1024,1054.7,30.7,2.2,30.3,28.1,24.9,49.5,24.6,217.6,385.6,168,0.2,0,-0.2,25.8,103.4,77.6,800.6,345.5,-455.1,0,0,0,516.3,157.8,-358.5,222.8,126.2,-96.6,3.5,0,-3.5,212.8,125.2,-87.6,3421.7,3193.2,-228.5,1225.8,521.6,-704.2,794.9,1674.7,879.8,794.7,1147.5,352.8,26.7,31.7,5,0,0.6,0.6,0.9,2.6,1.7,2442,1702.2,-739.8,5018,2784,-2234,266.8,218.9,-47.9,,,,87.4,84.7,-2.7,24.7,7.8,-16.9,167.9,49,-118.9,26.6,0.5,-26.1,812.5,711.1,-101.4,41.2,10,-31.2,25.6,12.3,-13.3,8.4,3.9,-4.5,71.3,50.8,-20.5,,,,434.9,107.5,-327.4,8.2,1.9,-6.3,73.4,12.7,-60.7,1.2,2.2,1,1.6,2.5,0.9,1.2,3,1.8,33.2,12.9,-20.3,0.1,1.3,1.2,13.1,0.6,-12.5,1.6,0.8,-0.8,2.3,20.3,18,1.8,59.4,57.6,454.3,594.9,140.6,92.4,92.4,0,0,2.3,2.3,33.2,16.9,-16.3,0.3,0,-0.3,0,0.2,0.2,1985.5,882.7,-1102.8,,,,11,16.5,5.5,23,11.8,-11.2,0.7,3.2,2.5,12.7,3.3,-9.4,0,1.3,1.3,,,,,,,,,,0.3,2.6,2.3,41.6,149.8,108.2,29.6,13.4,-16.2,14,7.2,-6.8,265.4,445.9,180.5,2.1,23.3,21.2,7.4,14.3,6.9,4,25.7,21.7,455.7,0.1,-455.6,0,0.9,0.9,177.9,377.4,199.5,0,0,0,0.4,1.7,1.3,3.1,25.1,22,157.4,65.3,-92.1,,,,1066.8,403.1,-663.7,39.1,15.6,-23.5,85.4,146.4,61,2.7,4.2,1.5,16.6,21,4.4,15,20.9,5.9,0,0.3,0.3,926.6,257.7,-668.9,156.2,33.4,-122.8,22.7,1.1,-21.6,152.1,15.1,-137,154.5,9.5,-145,30,0.6,-29.4,1142.9,430.1,-712.8,50.9,31.7,-19.2,0.6,0.2,-0.4,57.8,8.9,-48.9,1881,853.8,-1027.2,1386.2,1324.9,-61.3,737.5,201.2,-536.3,0,0,0,29.2,11.5,-17.7,976.6,705.1,-271.5,80.1,6,-74.1,0.1,0.1,0,3.6,1.4,-2.2,7070.5,1227.5,-5843,6.4,0.9,-5.5,0,0,0,2955.6,2425.1,-530.5,730.6,1169.5,438.9,3150.3,1925.4,-1224.9,12452.2,4968,-7484.2,526.5,1116.5,590,0,0,0,0,0.1,0.1,0,0,0,0,0,0,2.4,2,-0.4,183.2,234.8,51.6,0.1,0.1,0,0.6,0.5,-0.1,0,0.1,0.1,0.4,1.2,0.8,0,0.3,0.3,0,0.1,0.1,0,0.5,0.5,0.1,0.2,0.1,0,0,0,1.9,1.5,-0.4,0,0,0,2.8,10.2,7.4,0.1,3.7,3.6,0.9,2.5,1.6,0.6,1.2,0.6,1.4,0.2,-1.2,9.5,2.3,-7.2,0.4,0.7,0.3,28.4,159.8,131.4,196,37.3,-158.7,10.7,50.7,40,0,0,0,73.7,185.7,112,0.1,3.2,3.1,,,,0,0,0,24.7,5.7,-19,0,1.6,1.6,2.8,5.2,2.4,0.3,4.2,3.9,0.3,1.2,0.9,6.3,2.8,-3.5,0.1,2.2,2.1,41.3,10.3,-31,13.2,12.3,-0.899999999999999,0,1.2,1.2,0.1,4.2,4.1,0.3,0.2,-0.1,871.8,37.5,-834.3,0.6,0.3,-0.3,178.2,3.3,-174.9,0.3,0.2,-0.1,0,0,0,0.6,0.3,-0.3,0.1,1.9,1.8,370.1,18,-352.1,43.2,5.4,-37.8,0,0,0,0,0.3,0.3,0.1,0,-0.1,6.7,5.3,-1.4,18.2,1,-17.2,1.4,0.2,-1.2,0.4,0.8,0.4,0,0.1,0.1,0.9,14.1,13.2,0,0.1,0.1,0,0.7,0.7,3.7,3.1,-0.6,7.7,6.6,-1.1,0.6,0.4,-0.2,0,0.2,0.2,1.9,5.1,3.2,19.8,2.2,-17.6,1.4,2,0.6,6.8,0.4,-6.4,,,,0.3,0.1,-0.2,0,0.1,0.1,0,0,0,335,189.9,-145.1,2.5,0.6,-1.9,1.4,1.7,0.3,2.5,1.1,-1.4,2.8,0.2,-2.6,6.7,8.4,1.7,1.6,0.8,-0.8,6.9,0,-6.9,0,13.7,13.7,0,0,0
2000-05-01,5452.4,1366.3,-4086.1,19341.8,14224.1,-5117.7,99651,63632,-36019,7013.5,0,-7013.5,10752.4,5097.8,-5654.6,17822,18620,798,8992.1,6773.3,-2218.8,6041.7,4746.5,-1295.2,31202.8,24977.6,-6225.2,21914.066229,15554.634598,-6359.431631,2080.84371,786.807004,-1294.036706,33587,16363.7,-17223.3,101067.5,64673.5,-36394,39037.6,17358.2,-21679.4,,,,789.5,1227.8,438.3,1772.4,398,-1374.4,0.5,0.3,-0.2,19836.1,15833.8,-4002.3,0.2,0.1,-0.1,11366.7,9143.8,-2222.9,211.5,147,-64.5,6.3,17.3,11,166.7,143.8,-22.9,256.3,211.2,-45.1,44.5,31.9,-12.6,320.6,205.6,-115,24.9,157.9,133,13,33.9,20.9,17.7,91.7,74,0,0.3,0.3,58.5,113.8,55.3,0.8,8.1,7.3,0.2,27.5,27.3,28.5,50,21.5,370.2,355.1,-15.1,0.1,1.4,1.3,1.9,6.5,4.6,3.4,3.8,0.4,0,11.4,11.4,0,3.8,3.8,0.3,2.8,2.5,1.9,8.3,6.4,0.1,2.4,2.3,3.1,7.1,4,3.4,23.4,20,193.8,106.3,-87.5,87.7,34.3,-53.4,,,,,,,130.1,23.1,-107,0.6,6.9,6.3,0.1,1.8,1.7,611.1,293.8,-317.3,1541.4,437.2,-1104.2,12,10.1,-1.9,14.7,11.6,-3.1,0,1.1,1.1,195.6,76.3,-119.3,134.9,128.3,-6.59999999999999,11.4,24.9,13.5,217.6,280.9,63.3,1101.3,1183.5,82.2,2,41.6,39.6,25.1,44.9,19.8,228.4,374,145.6,0,0.1,0.1,22.8,16.2,-6.6,843.3,434.6,-408.7,0,0.1,0.1,452.3,106.6,-345.7,310.4,120.2,-190.2,3.8,0.2,-3.6,241.2,115.9,-125.3,3795.8,3532.7,-263.1,1369.5,703.4,-666.1,859,1786.3,927.3,882.6,1100.1,217.5,31.1,25.1,-6,0,0.9,0.9,1.3,2.9,1.6,2624.9,1639.3,-985.6,4829,2498.1,-2330.9,288.3,275.2,-13.1,,,,96.2,43.9,-52.3,17.8,5.9,-11.9,184.9,44.5,-140.4,25.5,1.3,-24.2,910.2,569.4,-340.8,78.9,7.5,-71.4,22.1,7,-15.1,10,6.1,-3.9,90.5,49.7,-40.8,,,,653.8,134.7,-519.1,10.1,2,-8.1,69.8,13.3,-56.5,2.5,6.3,3.8,0.2,3.3,3.1,1.3,5.4,4.1,43.1,6.6,-36.5,0.2,1,0.8,9.7,1,-8.7,0.9,0.2,-0.7,2.8,10.7,7.9,2.1,11.2,9.1,464,766,302,118.1,85.4,-32.7,0.1,0.5,0.4,50.2,29.3,-20.9,0.4,0,-0.4,0.1,0.4,0.3,2062.6,822.2,-1240.4,,,,14,5.7,-8.3,26.9,9.4,-17.5,1.3,3,1.7,14.3,2.4,-11.9,0,5.6,5.6,,,,,,,,,,0.3,0.9,0.6,42,104.9,62.9,42.5,48.7,6.2,19.7,5.4,-14.3,267.2,364.6,97.4,2.8,11.5,8.7,7.3,14.3,7,6.9,24.5,17.6,430.7,0,-430.7,13.2,0,-13.2,194.2,227.3,33.1,0,0,0,0.9,0,-0.9,4.3,22.4,18.1,211.3,81.3,-130,,,,1333.9,376.2,-957.7,33.1,19.1,-14,91.7,214.7,123,24.6,11.5,-13.1,35.4,15.1,-20.3,29.6,21.7,-7.9,0.4,4.5,4.1,913.7,277.4,-636.3,180.8,37.7,-143.1,20.7,3.3,-17.4,157.8,14.5,-143.3,139.1,16.2,-122.9,33.3,0.3,-33,1250.3,430.7,-819.6,59.3,26,-33.3,0.9,0.2,-0.7,58.1,1.9,-56.2,2023.3,830,-1193.3,1516.6,1273.9,-242.7,829.9,176.7,-653.2,0,0,0,16.6,15.3,-1.3,1070,722,-348,92.5,5.4,-87.1,0.1,0,-0.1,5.2,0.2,-5,7850.2,1526.3,-6323.9,5.9,1.2,-4.7,0,0,0,3121.4,2383.5,-737.9,916.4,1135,218.6,3437.7,1980.9,-1456.8,11946.4,5108.6,-6837.8,562.9,1072.8,509.9,0.1,0.1,0,0.1,0.1,0,0,0.2,0.2,0,0,0,2,1.9,-0.1,201.1,131.4,-69.7,0.2,0.2,0,0.3,1.4,1.1,0,0,0,0.4,1.2,0.8,0,0.4,0.4,0,0.1,0.1,0,0.6,0.6,0.1,0.5,0.4,0,0,0,7,1.7,-5.3,0,0,0,6.1,6.5,0.4,0.1,2.1,2,1.3,2.3,1,0,1.5,1.5,0,0,0,7.6,2.5,-5.1,0.2,0.6,0.4,32.8,25.5,-7.3,221.4,28.2,-193.2,4.9,85.6,80.7,0,0.0262,0.0262,49,249.2,200.2,0,1.7,1.7,,,,0,0,0,0.3,7.9,7.6,0,3.4,3.4,2.3,4.9,2.6,0.3,4.7,4.4,0.3,1.4,1.1,9.1,4.2,-4.9,0.2,0.8,0.6,23.8,8.9,-14.9,15.5,15.6,0.0999999999999996,0,0.4,0.4,4.8,2.4,-2.4,0.2,1.1,0.9,745.7,32.8,-712.9,0.6,0.1,-0.5,196.9,4.2,-192.7,0.7,0.1,-0.6,0,0.1,0.1,0.1,5.6,5.5,0.1,3.5,3.4,322.5,13.8,-308.7,4.1,7.2,3.1,0,0.1,0.1,0.1,0.3,0.2,0,0,0,0.9,2.9,2,12.6,0.6,-12,0.4,0.1,-0.3,0.1,1.1,1,0.3,0.2,-0.1,2.7,11.1,8.4,0,0.2,0.2,0,1.4,1.4,3.1,3.2,0.1,9,7,-2,0.2,0.2,0,0.1,0,-0.1,2.3,2.7,0.4,21.5,2.4,-19.1,0.6,3.8,3.2,11.9,0.7,-11.2,,,,0.1,0,-0.1,0.2,0.5,0.3,0,0,0,345.3,218.8,-126.5,2.7,0.9,-1.8,0.9,2.3,1.4,2.8,1.1,-1.7,8.5,0.7,-7.8,7.7,12,4.3,2.4,2.4,0,9.9,0.5,-9.4,0,20,20,0,0,0
2000-06-01,6084.8,1373.2,-4711.6,18583.1,14220.4,-4362.7,103019,65997,-37022,7307.7,0,-7307.7,10962.6,4517.6,-6445,19107,20177,1070,9665.1,7686.9,-1978.2,6628.2,5108.7,-1519.5,32335.4,25461,-6874.4,20997.619895,15833.443438,-5164.176457,2659.699948,1164.203974,-1495.495974,35611.9,18113.9,-17498,104526.5,68002.3,-36524.2,41101.8,19082.9,-22018.9,,,,803.4,1334.6,531.2,2257.7,696.8,-1560.9,0.5,0.1,-0.4,20391.2,16053.6,-4337.6,0.1,0.1,0,11944.2,9407.5,-2536.7,247.5,150.1,-97.4,5.5,24.6,19.1,171.3,161.8,-9.5,273.3,219.2,-54.1,56.4,28,-28.4,377.2,216.5,-160.7,31.1,173.3,142.2,2.4,32.5,30.1,13.5,86.8,73.3,0,0.2,0.2,60,107.2,47.2,0.5,8.9,8.4,0.5,31,30.5,27.7,48,20.3,409.2,405.2,-4,0.1,2.2,2.1,2.7,5.8,3.1,3.2,4.4,1.2,0.1,14.1,14,0,1.7,1.7,0.4,4.8,4.4,1.9,6.2,4.3,0.2,2.5,2.3,2.5,10.2,7.7,4,23.5,19.5,174.7,59.7,-115,47.3,44.8,-2.5,,,,,,,153.7,26,-127.7,1.7,16.5,14.8,0,1.8,1.8,571.7,290.5,-281.2,1622.6,452.7,-1169.9,11.7,9.7,-2,10.7,9.5,-1.2,0.6,1.9,1.3,198.8,85.2,-113.6,181.4,153.9,-27.5,26.1,15.8,-10.3,216.5,243.5,27,1421.1,1435.2,14.1000000000001,2.1,36.6,34.5,20.8,44.1,23.3,274.7,413,138.3,0.9,0,-0.9,15.4,17,1.6,771.8,405.6,-366.2,0,0.1,0.1,496.9,109.6,-387.3,255.8,125.1,-130.7,1.7,0,-1.7,280.8,105,-175.8,3585.7,3560.8,-24.8999999999996,1571.5,941.9,-629.6,771.2,1833,1061.8,698.1,1143.2,445.1,27.8,30.3,2.5,0,1,1,1.8,9.6,7.8,2362.2,1677.1,-685.1,4643.7,2314.2,-2329.5,255.7,189.6,-66.1,,,,91.7,56.8,-34.9,18.2,4.4,-13.8,208.8,44.6,-164.2,23.4,1,-22.4,790.7,739.3,-51.4000000000001,78.3,4.1,-74.2,14.3,12.8,-1.5,13.7,2.4,-11.3,91.2,58.3,-32.9,,,,556.5,160.6,-395.9,9.9,3.8,-6.1,82.8,31.9,-50.9,2.4,1.7,-0.7,3.1,3.6,0.5,0.6,7.1,6.5,24.5,14.3,-10.2,0,0.3,0.3,16.1,2.9,-13.2,1.1,0,-1.1,2.6,6.9,4.3,2.7,5.2,2.5,482.3,572.7,90.4,146.6,63.2,-83.4,0,0.4,0.4,39.4,36.7,-2.7,0.4,0,-0.4,0,0.1,0.1,2091.7,907.2,-1184.5,,,,13.1,6.4,-6.7,33.4,8.6,-24.8,1.6,8.4,6.8,11.6,4.3,-7.3,0,3.1,3.1,,,,,,,,,,0.3,2.9,2.6,46.7,112.7,66,49,18.2,-30.8,17.2,8.1,-9.1,289.3,445.3,156,2.3,10.2,7.9,6.9,10.1,3.2,8.2,33.2,25,630.8,0.2,-630.6,19.1,0,-19.1,223.1,249.4,26.3,0,0,0,0.2,0,-0.2,5.9,22.6,16.7,207.2,73.4,-133.8,,,,1094.4,386.9,-707.5,53.1,15,-38.1,109.4,158.9,49.5,74.4,14.8,-59.6,18.5,15.7,-2.8,20.9,18.4,-2.5,0.1,0.4,0.3,845.5,245.8,-599.7,188.9,41.8,-147.1,19.6,0.7,-18.9,207,15.2,-191.8,160.5,16.4,-144.1,40.3,0.3,-40,1329.8,469.9,-859.9,70,34.8,-35.2,1.1,0.1,-1,85.9,1.6,-84.3,2208.5,1112.7,-1095.8,1625.4,1499.4,-126,919,177.4,-741.6,0,0,0,46.3,12.2,-34.1,1154.5,719.4,-435.1,123.6,5.7,-117.9,0,0,0,9.4,0.2,-9.2,8541.7,1335.6,-7206.1,8.2,2.7,-5.5,0,0,0,3497.4,2576.4,-921,1016.4,1261.8,245.4,3525.8,2349.3,-1176.5,12173.8,5757.6,-6416.2,588.3,1136.5,548.2,0.3,0.4,0.1,0,0.1,0.1,0,0.3,0.3,0,0,0,2,1.7,-0.3,189.1,168.1,-21,0.1,0.1,0,0.6,1.3,0.7,0,0,0,0.3,1,0.7,0,0.4,0.4,0,0.2,0.2,0,0.9,0.9,0,0.3,0.3,0,0,0,5,2.7,-2.3,0,0,0,2.2,10.4,8.2,0,2.2,2.2,1.2,2.7,1.5,1.6,1.9,0.3,0,0.2,0.2,12.2,2.4,-9.8,0.4,0.4,0,36.2,28.2,-8,260.8,61.8,-199,15.5,7.5,-8,0,0,0,89.1,369.6,280.5,0,0,0,,,,0,0,0,8,5,-3,0,0.8,0.8,13.8,4.2,-9.6,0.2,7.7,7.5,4,2.2,-1.8,11.4,5.2,-6.2,0,0.9,0.9,10.3,5.6,-4.7,21.2,14.8,-6.4,0,0.4,0.4,0.1,1.4,1.3,0.2,1.7,1.5,1168.4,46.7,-1121.7,0.2,0.1,-0.1,179.4,5.5,-173.9,0.9,0,-0.9,0,0,0,0,0.4,0.4,0.1,2,1.9,245.9,12.8,-233.1,13.1,5.5,-7.6,0,0,0,0.1,4,3.9,0,0,0,4.6,4.2,-0.399999999999999,30,0.3,-29.7,0.7,0.1,-0.6,0.6,2.9,2.3,0,0.1,0.1,6.2,4.3,-1.9,0,1,1,0.1,0.6,0.5,7.8,3.2,-4.6,13.6,119.6,106,0.9,0.4,-0.5,0.1,0,-0.1,2.6,6.3,3.7,25.7,1.4,-24.3,2,3.6,1.6,11.9,2.3,-9.6,,,,0,0.2,0.2,0,0.1,0.1,0,0.1,0.1,439.6,382.7,-56.9,0.9,0.6,-0.3,1.1,2.2,1.1,3.4,1.1,-2.3,3.5,0.4,-3.1,13.5,3.5,-10,2.2,1.7,-0.5,12.4,0,-12.4,0,16.7,16.7,0,0,0
2000-07-01,5883.9,1375.1,-4508.8,18982.7,12235.6,-6747.1,103349,65711,-37638,6581.7,0,-6581.7,8126.7,4469.2,-3657.5,18514,18255,-259,9771.8,7557.4,-2214.4,6143.7,4827.3,-1316.4,27835,21237.2,-6597.8,21751.578865,13504.7456,-8246.833265,2617.741479,828.06375,-1789.677729,36731.7,17462.8,-19268.9,101986.6,60028.6,-41958,42860.8,18407.3,-24453.5,,,,776.2,1205.9,429.7,2281.3,454.3,-1827,1.4,0,-1.4,16888.5,12152.8,-4735.7,0,0.1,0.1,10946.5,9084.4,-1862.1,235.7,158.2,-77.5,11,19.9,8.9,172.4,141.7,-30.7,270.2,200.3,-69.9,58.5,34.3,-24.2,283.5,197.5,-86,21.3,123.6,102.3,0.8,24.9,24.1,14.2,80.3,66.1,0,0.1,0.1,50.3,117.6,67.3,0.1,7.5,7.4,0.8,32.3,31.5,26.7,41.4,14.7,384.5,363,-21.5,0.2,1.4,1.2,1.8,4.1,2.3,3.1,7.2,4.1,0,14.5,14.5,0,0.4,0.4,0.4,4.3,3.9,1.7,8.2,6.5,0.2,3,2.8,1.8,6.1,4.3,3.3,24.6,21.3,221.4,114.5,-106.9,35.8,45.8,10,,,,,,,119.9,16,-103.9,1.7,7,5.3,0,1.2,1.2,568,278.2,-289.8,1560.1,407,-1153.1,9.6,16,6.4,18.9,9.5,-9.4,0,0.7,0.7,144.8,99.7,-45.1,186,130.3,-55.7,13.5,24.5,11,228.9,250.6,21.7,1224,1361.3,137.3,2.4,37.5,35.1,20.5,44.9,24.4,245.7,366.3,120.6,0,0,0,19.2,14.4,-4.8,760.2,310.5,-449.7,0,0,0,695.4,101.9,-593.5,277.2,117.1,-160.1,2.1,0.3,-1.8,288.2,92.1,-196.1,3593.9,2903,-690.9,1206.2,515.1,-691.1,823.6,1626.7,803.1,896.8,1145.6,248.8,28.7,21.8,-6.9,0,0.7,0.7,1,0.6,-0.4,2368.1,1484.7,-883.4,4939.5,2181.5,-2758,273.4,139,-134.4,,,,95.4,44.6,-50.8,19.5,4.7,-14.8,188.7,56,-132.7,25.8,2.5,-23.3,906.8,631.5,-275.3,50.2,2.1,-48.1,42.1,11,-31.1,14.6,3.4,-11.2,85.4,59.8,-25.6,,,,624.4,170.3,-454.1,10.2,1.1,-9.1,72.9,20.4,-52.5,1.8,1.2,-0.6,0.6,3.7,3.1,2.5,8.7,6.2,37.3,9.1,-28.2,0.4,0.3,-0.1,7,9.7,2.7,0.5,0.2,-0.3,2,5.2,3.2,2.1,12.4,10.3,512.6,468.9,-43.7,158,70.7,-87.3,0.2,0.3,0.1,37,29.3,-7.7,1.2,0.1,-1.1,0,0.6,0.6,2244.4,861.3,-1383.1,,,,10.4,6.4,-4,32.6,9.2,-23.4,1.6,6.5,4.9,21.2,3.2,-18,0.2,1.1,0.9,,,,,,,,,,0.1,0.3,0.2,44.4,66.6,22.2,43.7,19.7,-24,24.8,16.2,-8.6,253.5,220.3,-33.2,2.2,10.7,8.5,19.4,12.6,-6.8,5.2,31.2,26,600,0,-600,17.4,0,-17.4,270.1,291.8,21.7,0,0,0,0.4,0,-0.4,5.8,27.3,21.5,216.8,44.2,-172.6,,,,1261.6,397.8,-863.8,39.5,13.4,-26.1,86.5,147.4,60.9,53.6,20.8,-32.8,22,11,-11,31.6,16.4,-15.2,0.1,0.2,0.1,930.1,240.7,-689.4,198.4,35.5,-162.9,16.2,0.8,-15.4,229.7,27.6,-202.1,180.9,16.7,-164.2,48.8,1.1,-47.7,1472.2,492.2,-980,77.8,29.7,-48.1,0.8,0.3,-0.5,88.8,1.9,-86.9,2227.8,1010.9,-1216.9,1647.4,1504,-143.4,877.2,229.3,-647.9,0,0,0,21.3,12.1,-9.2,1142.3,728,-414.3,138.8,6,-132.8,0.1,0.1,0,9.7,0.1,-9.6,9246.4,1642.8,-7603.6,13.4,1.6,-11.8,0,0,0,3493.7,2288.1,-1205.6,1062.5,1181.2,118.7,3568.2,2584,-984.2,12557.2,5094,-7463.2,574.3,1009.9,435.6,0,0.3,0.3,0,0.1,0.1,0,0,0,0,0,0,2.4,2.2,-0.2,172.3,170.2,-2.10000000000002,0.1,0.1,0,0.8,0.5,-0.3,0,0,0,0.5,0.8,0.3,0,0.3,0.3,0.1,0.1,0,0.1,0.8,0.7,0.1,0.2,0.1,0,0,0,3.5,1.3,-2.2,0,0,0,3.7,8.5,4.8,0.2,5,4.8,0.6,2.4,1.8,1.9,1.8,-0.0999999999999999,0,0.1,0.1,15.3,1.4,-13.9,0.4,0.5,0.1,37.7,24.2,-13.5,205.9,86.3,-119.6,14,11.8,-2.2,0,0.00504,0.00504,78.7,250.9,172.2,0.7,1.8,1.1,,,,0,0,0,0.1,11.2,11.1,0.1,1.5,1.4,15,4.5,-10.5,0.4,3.2,2.8,1.1,5.3,4.2,8.8,4,-4.8,0.1,2,1.9,7.7,7.2,-0.5,25.8,12.2,-13.6,0.1,0.4,0.3,0.4,1.8,1.4,0.1,0.9,0.8,1018.9,49.6,-969.3,0,0.1,0.1,203.5,4.6,-198.9,0.6,0.1,-0.5,0,0,0,1.3,4,2.7,0,2.8,2.8,383.4,16,-367.4,43.5,5.4,-38.1,0,0,0,0.2,0.2,0,0.1,0.1,0,4.2,3.2,-1,27.8,1.1,-26.7,0.3,0.1,-0.2,0.4,1.2,0.8,0,2,2,10.5,8.7,-1.8,0,2.1,2.1,0,1.1,1.1,1.5,2.4,0.9,7.7,12.4,4.7,0.2,0.4,0.2,0.1,0.1,0,2.9,5.5,2.6,19.7,3,-16.7,1.6,7.2,5.6,14.3,2.5,-11.8,,,,0.3,0,-0.3,0,0.5,0.5,0,0.1,0.1,456.3,248.9,-207.4,3.4,2.3,-1.1,1.1,1.1,0,2,2.5,0.5,3.3,0.9,-2.4,4.7,2.9,-1.8,1.4,0.4,-1,13.9,0,-13.9,0,18.2,18.2,0,0,0
2000-08-01,6192.8,1732.3,-4460.5,18894.4,13858.3,-5036.1,103665,67763,-35902,7468.5,0,-7468.5,10600.8,5165.7,-5435.1,20038,19760,-278,10303.3,7699.3,-2604,6522.3,5314.9,-1207.4,32120.7,25774.3,-6346.4,21406.560152,15258.128956,-6148.431196,2480.15866,952.117794,-1528.040866,38619.8,18282,-20337.8,108166.7,68254.4,-39912.3,44832,19527.1,-25304.9,,,,802.9,1398.2,595.3,2132.7,451.4,-1681.3,1.7,0.1,-1.6,19814.8,15325.4,-4489.4,0.2,0.2,0,12305.9,10448.8,-1857.1,241.3,151,-90.3,8.4,19.8,11.4,178.5,174.2,-4.30000000000001,277.1,249.2,-27.9,47.7,27.8,-19.9,273.2,206.3,-66.9,31.5,126.9,95.4,1.1,36.1,35,17.9,86.6,68.7,0,0.2,0.2,48.4,111.1,62.7,0.7,6.8,6.1,1.3,35.1,33.8,27.3,47,19.7,422.5,389.7,-32.8,0.2,1.1,0.9,11.7,4.3,-7.4,2.9,5.1,2.2,0.2,8.5,8.3,0,0.5,0.5,0.3,4.8,4.5,2.1,8.4,6.3,0.5,4.1,3.6,2.3,6.8,4.5,3,27.4,24.4,209.6,71,-138.6,44.2,37.3,-6.90000000000001,,,,,,,94.2,26,-68.2,2.2,5.4,3.2,0.2,2.5,2.3,605,305.7,-299.3,1561.6,499.4,-1062.2,12.9,12.6,-0.300000000000001,12.7,11.4,-1.3,0.5,2,1.5,241.8,78.1,-163.7,151.4,140.4,-11,14.7,37.3,22.6,230.8,405,174.2,1414,1441.9,27.9000000000001,4.1,40.1,36,24.7,44.5,19.8,297.5,415.6,118.1,0,0,0,17.1,12.5,-4.6,554.1,409.4,-144.7,0,0,0,498.1,110.8,-387.3,245.2,136.6,-108.6,2.7,0,-2.7,224.7,126,-98.7,3692.8,3325.1,-367.7,1458,577.6,-880.4,784.1,1858,1073.9,679,1194.6,515.6,37.9,35.1,-2.8,0,0.8,0.8,2.8,0.5,-2.3,2247.5,1668.7,-578.8,5295.1,2470.2,-2824.9,274.3,209.5,-64.8,,,,91.4,56.6,-34.8,15.9,9.1,-6.8,180.2,53,-127.2,23.7,1,-22.7,800.8,689.4,-111.4,57.9,6.3,-51.6,18.6,6.1,-12.5,12.7,4.7,-8,87.5,81.6,-5.90000000000001,,,,651.3,173.9,-477.4,12.5,0.8,-11.7,87,20.3,-66.7,1.9,2.4,0.5,0.7,7.3,6.6,0.7,7.2,6.5,37.5,20,-17.5,0.2,0.8,0.6,11.3,0.4,-10.9,0.6,0.8,0.2,1.8,5.1,3.3,5.8,5.8,0,513.3,532.6,19.3000000000001,152.2,92.7,-59.5,0.1,1.1,1,36.3,23.9,-12.4,1.6,0,-1.6,0,0.1,0.1,2158.2,876,-1282.2,,,,12.7,6.3,-6.4,30.5,13.5,-17,1.2,4.1,2.9,14.4,10.5,-3.9,0.1,2,1.9,,,,,,,,,,0.3,1.5,1.2,45.7,75.4,29.7,47.9,14.2,-33.7,24.7,8.1,-16.6,252.7,291.8,39.1,1.5,16,14.5,4.5,25.5,21,4.6,31.2,26.6,578.2,8.3,-569.9,16.1,4.9,-11.2,195.6,281.4,85.8,0,0,0,0.6,0,-0.6,7,34.7,27.7,288.2,70.3,-217.9,,,,1275.1,519.9,-755.2,47.4,21,-26.4,86,186.5,100.5,35,18.7,-16.3,20.3,14.8,-5.5,30.9,24.8,-6.1,0,0.2,0.2,1076.6,282.9,-793.7,216.2,38.2,-178,14.8,0.6,-14.2,297,18.5,-278.5,211.3,17.8,-193.5,54.9,5.4,-49.5,1556.9,604,-952.9,76,26.8,-49.2,1.1,0,-1.1,95.2,1.5,-93.7,2401,1039.5,-1361.5,1837.1,1669.5,-167.6,1009.6,205.9,-803.7,0,0,0,40.6,12.9,-27.7,1359.1,837.8,-521.3,144.3,8,-136.3,0,0.2,0.2,8,0.5,-7.5,10054,1429,-8625,14.9,1.7,-13.2,0,0.1,0.1,3622.2,2441.7,-1180.5,1150.7,1332.7,182,3693.3,2255.4,-1437.9,12535.1,5677.4,-6857.7,587.2,1086.2,499,0.1,0.1,0,0,0,0,0.1,0,-0.1,0,0,0,3.5,2.5,-1,182,283.5,101.5,0,0.1,0.1,0.2,1.2,1,0,0,0,0.6,3.4,2.8,0,0.3,0.3,0,0.1,0.1,0,0.5,0.5,0.1,0.9,0.8,0,0,0,0.8,1.3,0.5,0,0,0,2.7,5.2,2.5,2.1,8.3,6.2,1.1,1.8,0.7,2.5,1.5,-1,0,0,0,19.5,1.4,-18.1,0.3,0.3,0,41.1,32.5,-8.6,228.2,165.7,-62.5,6,16.4,10.4,0,0,0,71.4,285.5,214.1,0.6,1,0.4,,,,0,0,0,8,11.3,3.3,0,1.4,1.4,11,7.1,-3.9,0.6,6,5.4,1.5,6.4,4.9,9.1,5.2,-3.9,0.2,2.7,2.5,35.2,6.1,-29.1,18.6,20.5,1.9,0,0.3,0.3,0.1,2.2,2.1,0.1,0.5,0.4,1102.3,50.3,-1052,0,0.2,0.2,138.1,13.2,-124.9,0.7,0,-0.7,0,0.1,0.1,0.1,0.9,0.8,0.1,2.1,2,275,25.7,-249.3,94.7,6.9,-87.8,0.5,0,-0.5,0,0.1,0.1,0,0,0,4.7,2.9,-1.8,10.8,0.6,-10.2,0.6,0.2,-0.4,0,0.8,0.8,0,0.6,0.6,3.6,7.2,3.6,0,4,4,0,0.8,0.8,1.4,2.2,0.8,7.9,16.3,8.4,1.4,0.8,-0.6,0.5,0.1,-0.4,1.3,3.5,2.2,25.7,1.7,-24,0.7,4.9,4.2,12.8,0.7,-12.1,,,,0,0.2,0.2,0.3,0.1,-0.2,0,0.1,0.1,330,220.9,-109.1,2.3,1.2,-1.1,1.5,1.2,-0.3,1.1,1.3,0.2,4.8,1.4,-3.4,8.1,3.5,-4.6,5.8,2,-3.8,13,0,-13,0,29.9,29.9,0,0,0
2000-09-01,6157.6,1900.7,-4256.9,18550.5,14482,-4068.5,106396,67562,-38834,7558.1,0,-7558.1,10076.8,4934.8,-5142,21117,20115,-1002,10339.5,7501.4,-2838.1,6201.2,5167.6,-1033.6,31722.5,24603.3,-7119.2,21307.698419,15978.640837,-5329.057582,2363.136854,1034.263699,-1328.873155,37585.2,17509.4,-20075.8,106355.1,67391,-38964.1,43992.2,19395.4,-24596.8,,,,765.5,1187,421.5,2013.4,584.4,-1429,3.1,0,-3.1,19378.5,14847.4,-4531.1,0.2,0.1,-0.1,12344,9755.9,-2588.1,214.6,160.9,-53.7,7.4,13.9,6.5,156.3,158.6,2.29999999999998,240.1,212.7,-27.4,44.9,32.4,-12.5,279.5,210.7,-68.8,18.1,122.7,104.6,0.8,25.1,24.3,33.6,99.6,66,0.2,0.2,0,46.2,122.7,76.5,0.4,7.6,7.2,0.6,27.3,26.7,25.7,49.5,23.8,410.2,395.9,-14.3,0.1,12,11.9,2.1,5.6,3.5,2.9,3.6,0.7,0.1,10.4,10.3,0,0.3,0.3,0.5,3.1,2.6,2.4,8.4,6,0.4,3.8,3.4,2.6,6.2,3.6,2.8,26.4,23.6,203.3,83.3,-120,42.7,52.5,9.8,,,,,,,134.9,23.3,-111.6,1.5,4.2,2.7,0.1,2.1,2,606.9,290.9,-316,1542.3,478.8,-1063.5,10.9,12.3,1.4,15.9,11.5,-4.4,0.6,1.1,0.5,232.4,81.3,-151.1,189.5,135.7,-53.8,14.5,17.5,3,229.6,308.6,79,1178.1,1442.8,264.7,3.1,52.1,49,24.3,43.4,19.1,278.2,406.8,128.6,0,0,0,17.4,10.5,-6.9,747.2,443.8,-303.4,0.1,0,-0.1,506.1,123.5,-382.6,255.6,142,-113.6,3.7,0.7,-3,238,121.1,-116.9,3282.5,3493.6,211.1,1573.9,639.3,-934.6,777.2,1830.6,1053.4,802.2,1172.8,370.6,26,35.5,9.5,0,1.1,1.1,0.6,0.4,-0.2,2316.8,1632.9,-683.9,4709.8,2471,-2238.8,239.8,242.6,2.79999999999998,,,,88.8,55.9,-32.9,17.1,8,-9.1,383.6,60.3,-323.3,20.6,1.3,-19.3,787.5,760.3,-27.2,57,6.8,-50.2,15.2,10,-5.2,9.4,4.7,-4.7,80,71.7,-8.3,,,,819.3,189.2,-630.1,9.3,2.6,-6.7,113.1,11.2,-101.9,2,10.6,8.6,0.5,68.3,67.8,8.9,15.4,6.5,72.4,8.5,-63.9,0.3,9.3,9,17.2,0.8,-16.4,0.5,0.1,-0.4,2.4,3.5,1.1,2.2,5.1,2.9,366.9,476.6,109.7,139.2,72.3,-66.9,0.1,2.1,2,39.2,22.5,-16.7,0.5,0.2,-0.3,0,0.2,0.2,2306.2,1369.2,-937,,,,12.1,5.4,-6.7,23.9,8,-15.9,5.8,3.9,-1.9,11,4.2,-6.8,0.8,0.9,0.1,,,,,,,,,,0.3,3.4,3.1,52.9,70.4,17.5,46.3,18.6,-27.7,25.9,4.2,-21.7,270,231.3,-38.7,2,20.4,18.4,6.2,12.8,6.6,4.6,41.9,37.3,661.3,0,-661.3,47.3,10,-37.3,233.7,296.3,62.6,0,0.1,0.1,0.4,0,-0.4,7.7,35.8,28.1,283,87.3,-195.7,,,,1308.5,562.1,-746.4,67.7,22.5,-45.2,114.9,370.6,255.7,1.4,23.2,21.8,30.2,20.2,-10,29.9,28.2,-1.7,0.1,0.6,0.5,925.3,404.2,-521.1,197.3,42.2,-155.1,13.8,0.4,-13.4,254.8,21.6,-233.2,187.7,16,-171.7,52.9,2.6,-50.3,1555.8,609.8,-946,69.3,22.4,-46.9,0.8,0.3,-0.5,78.9,2.5,-76.4,2411.6,1042.9,-1368.7,1785.4,1754.3,-31.1000000000001,961.8,211,-750.8,0,0,0,56.2,12,-44.2,1397.3,725.5,-671.8,139.2,7,-132.2,0,0,0,9.4,0.4,-9,10061.7,1333.3,-8728.4,15.2,0.9,-14.3,0,0,0,3626.9,2378,-1248.9,1231.4,1311.4,80,3695.8,2057.7,-1638.1,11484.1,5525.9,-5958.2,575.8,992.4,416.6,0,0.2,0.2,0.2,0.1,-0.1,0,0,0,0,0,0,3.1,1.3,-1.8,154.8,156.8,2,0.9,0,-0.9,0.3,1.2,0.9,0,0,0,0.9,1.4,0.5,0.1,0.5,0.4,0.1,0.1,0,0,0.3,0.3,0.1,0.6,0.5,0,0,0,5.5,1.4,-4.1,0,0,0,2.9,7.3,4.4,1,16.9,15.9,1.4,2.7,1.3,2,1.7,-0.3,0,0.2,0.2,16,1.4,-14.6,0.4,0.7,0.3,26.1,39,12.9,238.7,111.3,-127.4,4.8,16.3,11.5,0,0.038823,0.038823,78.5,281,202.5,0,3.8,3.8,,,,0,0,0,17.9,7.5,-10.4,0,1,1,6.3,8.9,2.6,0.4,10.6,10.2,0.6,3.4,2.8,8.8,3.3,-5.5,0.2,0.8,0.6,16.8,8.9,-7.9,14.3,11.1,-3.2,0.1,0.5,0.4,0.3,3.9,3.6,0.1,0.9,0.8,932.3,45,-887.3,0.3,0.4,0.1,172.3,5.2,-167.1,0.2,0.4,0.2,1.5,0,-1.5,0,0.7,0.7,0.1,1.7,1.6,266.9,21,-245.9,47.3,8.8,-38.5,0,0,0,0.1,0.1,0,0,0.2,0.2,4.2,3.6,-0.6,23.5,1.6,-21.9,0.6,0.1,-0.5,0.8,0.6,-0.2,0,0.6,0.6,2.3,28.6,26.3,0,6.7,6.7,0,0.7,0.7,1,2.9,1.9,8.1,12.1,4,1,0.5,-0.5,0,0.1,0.1,3.2,2.9,-0.3,22.4,2.5,-19.9,2.6,6.4,3.8,15.2,0.5,-14.7,,,,0.3,0,-0.3,0,0.1,0.1,0,0,0,399.3,371.1,-28.2,4.3,1.6,-2.7,0.8,2.5,1.7,1.1,2.2,1.1,3.5,0.3,-3.2,13,4.2,-8.8,9.7,0.6,-9.1,11.9,0,-11.9,0,24.2,24.2,0,0,0
2000-10-01,6519.8,2070.8,-4449,20953.3,14559.1,-6394.2,106056,66845,-39211,7704.9,0,-7704.9,10865.9,5173.8,-5692.1,21399,20258,-1141,10417.3,7583.6,-2833.7,6468.5,5304.1,-1164.4,33314.4,26056.7,-7257.7,23538.892212,16043.846076,-7495.046136,2554.957159,1043.385891,-1511.571268,40703.5,17778.7,-22924.8,113812.5,69635.2,-44177.3,47240.8,19885.3,-27355.5,,,,692.4,1207.4,515,2199.9,519,-1680.9,1.7,0,-1.7,20500.4,15725.1,-4775.3,0.5,0.1,-0.4,12814,10331.5,-2482.5,214.9,172.1,-42.8,9.5,13.3,3.8,182.9,165.3,-17.6,275.9,220.8,-55.1,47.1,38.6,-8.5,274,212.3,-61.7,33.5,121.2,87.7,0.5,70.9,70.4,22.4,88.9,66.5,0.1,0.2,0.1,52.6,120.6,68,0.6,6.9,6.3,0.6,28.9,28.3,24.2,46.2,22,404.9,389.5,-15.4,0.1,1.4,1.3,1.9,5.4,3.5,3.3,4.1,0.8,0.2,9.7,9.5,0.1,0.2,0.1,0.7,2.4,1.7,1.7,9.6,7.9,0.5,2.7,2.2,2.2,9.8,7.6,3.8,28.1,24.3,231.8,76,-155.8,83.2,97.7,14.5,,,,,,,191.3,29.9,-161.4,0.8,5.5,4.7,0,1.4,1.4,518,365.3,-152.7,1807.4,451.1,-1356.3,17.6,12,-5.6,9.4,13.8,4.4,0.1,0.5,0.4,204.1,86.2,-117.9,167.5,132.2,-35.3,16,18.2,2.2,263.8,306.2,42.4,1069.9,1453.2,383.3,4.3,45.2,40.9,25.5,39.7,14.2,299,400.8,101.8,0.7,0,-0.7,25.5,12.7,-12.8,960.3,371.1,-589.2,0,0.1,0.1,432.7,109,-323.7,323.4,156.4,-167,2.5,0.1,-2.4,289.6,160.8,-128.8,3956.3,3636.1,-320.2,1928.2,610.1,-1318.1,903.3,2057.2,1153.9,951.1,1170.2,219.1,27.6,30.6,3,0,1.1,1.1,0.9,0.2,-0.7,2821.2,1705.7,-1115.5,5161.6,2464,-2697.6,306.2,205.3,-100.9,,,,103.4,53.3,-50.1,20.8,15.8,-5,197.4,47.8,-149.6,23.4,1.4,-22,913.7,814,-99.7,10.4,8.1,-2.3,6.3,9.7,3.4,16.7,6.3,-10.4,126.7,74.1,-52.6,,,,698.2,196.2,-502,6.3,1.5,-4.8,68.2,13.8,-54.4,2.1,4.2,2.1,1.2,23.5,22.3,11.4,22.7,11.3,31.4,11.6,-19.8,0.1,1,0.9,3.1,2.4,-0.7,0.7,0.2,-0.5,1.7,9.4,7.7,5.8,6.2,0.4,435.9,584.4,148.5,171.4,77.4,-94,0.1,0.4,0.3,44.2,33.4,-10.8,0.8,0,-0.8,0,0,0,2102.9,945.9,-1157,,,,8.5,4.2,-4.3,26.4,9.1,-17.3,0.7,2.5,1.8,7.6,9.1,1.5,0.7,2.4,1.7,,,,,,,,,,0.4,1.8,1.4,60.5,106.7,46.2,41.6,20,-21.6,19.1,11.9,-7.2,277.3,201,-76.3,1.8,20,18.2,22.3,29.5,7.2,6.5,33.3,26.8,606.8,0,-606.8,19.7,0,-19.7,225.5,254.1,28.6,0.1,0.1,0,0.2,0,-0.2,9.1,24,14.9,391.7,66,-325.7,,,,1355.8,814.1,-541.7,45.2,17.5,-27.7,68.1,261.4,193.3,0.2,27.8,27.6,21.7,18.9,-2.8,24,130.3,106.3,0,0.4,0.4,985,301.4,-683.6,209.9,59.5,-150.4,15.1,13.9,-1.2,218.3,16.4,-201.9,175.7,33.4,-142.3,44.6,1.1,-43.5,1640.4,753.7,-886.7,109.1,28.6,-80.5,1.2,0.3,-0.9,66.7,1.1,-65.6,2526.5,985.4,-1541.1,1704.7,1662.2,-42.5,978.3,226.9,-751.4,0,0,0,45.2,13.4,-31.8,1287.2,749.4,-537.8,107.6,6.2,-101.4,0,0,0,7.7,0.2,-7.5,10611.6,1487.3,-9124.3,14.3,5.9,-8.4,0.1,0,-0.1,3890.4,2475.5,-1414.9,1043,1287.8,244.8,3779,2158.2,-1620.8,14064.8,5546.1,-8518.7,514.3,1011.9,497.6,0,0.1,0.1,0,0,0,0.1,0,-0.1,0,0,0,2.4,2,-0.4,148.5,166.5,18,0.1,0.1,0,0.3,1.7,1.4,0,0,0,0.7,1,0.3,0,0.5,0.5,0,0.1,0.1,0,0.7,0.7,0.1,0.1,0,0,0,0,1,1.7,0.7,0,0,0,4.1,7.3,3.2,0.1,7.3,7.2,1,2.4,1.4,1.5,2.2,0.7,0,0,0,17.7,1.6,-16.1,0.5,0.8,0.3,37.9,47.6,9.7,240.6,161.8,-78.8,11.8,9.9,-1.9,0,0,0,64.3,304.4,240.1,0,3.5,3.5,,,,0,0,0,23.6,7.9,-15.7,0,0.6,0.6,52,5.1,-46.9,0.5,5.8,5.3,0.4,2.2,1.8,5.7,5.4,-0.3,0.7,1.1,0.4,7.1,8.2,1.1,20.9,18.4,-2.5,0.1,1.1,1,0.2,3.2,3,0.1,0.6,0.5,1006.1,71.9,-934.2,0,0.1,0.1,242,3.8,-238.2,0,0.2,0.2,0,0.1,0.1,0.1,0.9,0.8,0,1.5,1.5,256.2,19.5,-236.7,28.7,7.6,-21.1,0,0,0,2.9,0.3,-2.6,0,0.1,0.1,0.5,1.9,1.4,23.9,0.9,-23,0.3,0.1,-0.2,2,7,5,0.1,0,-0.1,2.2,10,7.8,0.1,1.4,1.3,0,1.5,1.5,0.9,1.5,0.6,8.1,9.7,1.6,0.8,0.5,-0.3,0.3,0.4,0.1,2.5,2.7,0.2,36.7,2.3,-34.4,1,0.9,-0.1,17.6,0.8,-16.8,,,,0,0,0,0,0.3,0.3,0,0,0,385,286.9,-98.1,3.4,11,7.6,28.6,2,-26.6,2,1.7,-0.3,3.5,1.3,-2.2,10.7,2,-8.7,7.6,0.5,-7.1,15.4,0.1,-15.3,0,94.2,94.2,0,0,0
2000-11-01,5653.3,1629.6,-4023.7,20532.8,14604.6,-5928.2,103993,66691,-37302,7294.6,0,-7294.6,10656.3,4809.1,-5847.2,20377,19543,-834,9846,6811,-3035,6302.2,5255.7,-1046.5,31909,25086.5,-6822.5,23000.740725,16300.760021,-6699.98070399999,2406.979747,876.83192,-1530.147827,36515.4,17089.5,-19425.9,106394.5,67613.5,-38781,42000.5,18816.9,-23183.6,,,,771.8,1205.6,433.8,2089.1,560,-1529.1,2.8,0.2,-2.6,19969.2,15159.3,-4809.9,0.8,0.2,-0.6,11939.7,9927.1,-2012.6,192.3,185.6,-6.70000000000002,7.8,15.3,7.5,154.3,152.8,-1.5,287.5,222.7,-64.8,53.7,28.7,-25,260.3,204.1,-56.2,31.2,125.5,94.3,1,41.2,40.2,27.5,103.4,75.9,0,0.4,0.4,49.2,123.9,74.7,0.7,6.3,5.6,0.8,30.8,30,24.2,48.7,24.5,392.9,392.9,0,0,1.5,1.5,1.3,4.8,3.5,3.7,5,1.3,0.3,9.2,8.9,0,1.7,1.7,0.4,2.3,1.9,1.8,11.9,10.1,0.1,4.5,4.4,2,6.1,4.1,4.9,28.3,23.4,223.7,175.1,-48.6,75.3,61.7,-13.6,,,,,,,168.9,27.8,-141.1,0.4,5.4,5,0,1.6,1.6,596.4,317.9,-278.5,1727,425.8,-1301.2,7.7,14.2,6.5,6.8,11.2,4.4,0,3.2,3.2,218.5,100.2,-118.3,164.1,152.1,-12,13.1,17.7,4.6,289.4,329.4,40,1042.8,1332,289.2,4.6,35,30.4,22.8,39.3,16.5,242.9,448.4,205.5,0,0,0,23.9,14.1,-9.8,918.8,305.6,-613.2,0,0,0,434.6,199.8,-234.8,266.6,142.1,-124.5,2.5,0,-2.5,252.8,117,-135.8,3946.5,3682.7,-263.8,1884.9,654.6,-1230.3,853.9,1958.8,1104.9,902.3,1345.7,443.4,22.7,86.6,63.9,0,0.8,0.8,2.1,9.8,7.7,2775.2,1787.1,-988.1,4960.5,2450.7,-2509.8,292.3,287.4,-4.90000000000003,,,,98.2,60,-38.2,20.9,19.6,-1.3,248.9,55,-193.9,19,0.8,-18.2,892.9,812,-80.9,30.9,8.9,-22,26.8,9,-17.8,10.1,4,-6.1,91,70.1,-20.9,,,,659.3,202.9,-456.4,9.2,4.4,-4.8,55.2,11.4,-43.8,1.9,1.7,-0.2,0.8,5.7,4.9,2,11.4,9.4,34,8.2,-25.8,0.2,5,4.8,6.5,0.4,-6.1,0.3,2.1,1.8,4.3,15.3,11,2.4,5.6,3.2,497.4,469.1,-28.3,159.8,88.8,-71,0.1,0.4,0.3,39.4,32.8,-6.6,0,0,0,0,0.1,0.1,2151.3,848.9,-1302.4,,,,12.3,5.2,-7.1,26,14.2,-11.8,1.4,1.8,0.4,9,11,2,0.3,3.7,3.4,,,,,,,,,,1.5,0.9,-0.6,54,88.1,34.1,31,12.6,-18.4,16,9.1,-6.9,245.2,340,94.8,1.4,18.1,16.7,27.3,17.9,-9.4,5.3,34.3,29,570.5,0.3,-570.2,19.1,0.1,-19,219.3,313.9,94.6,0,0,0,0.4,0.2,-0.2,8.9,19.5,10.6,212.2,67.6,-144.6,,,,1096.2,656.1,-440.1,41.3,12.1,-29.2,51.9,176.5,124.6,0.3,15.6,15.3,23.1,18,-5.1,30.1,62.9,32.8,0,0,0,702.1,291.7,-410.4,172.1,45.4,-126.7,17.2,3.5,-13.7,188.3,33.7,-154.6,149.7,25,-124.7,37,0.8,-36.2,1519.4,653.9,-865.5,56.2,26.5,-29.7,0.6,0.1,-0.5,49.9,3,-46.9,2264.7,932.9,-1331.8,1787.8,1515.6,-272.2,882.6,177.4,-705.2,0,0,0,15,13.5,-1.5,1135.1,809.5,-325.6,96.3,6.8,-89.5,0.1,0,-0.1,8.5,0.5,-8,9066.8,1450.4,-7616.4,10.3,0.3,-10,0,0,0,3740.6,2242.5,-1498.1,897.8,1304.8,407,3419.9,1748,-1671.9,12461.3,5759.9,-6701.4,581.2,966.3,385.1,0,0,0,0,0,0,0.1,0.1,0,0,0.1,0.1,4.6,1.9,-2.7,161.8,160,-1.80000000000001,0.1,0.1,0,0.4,0.8,0.4,0,0,0,0.5,50.7,50.2,0.1,0.6,0.5,0.1,0.2,0.1,0,0.2,0.2,0.1,0.4,0.3,0,0,0,1.5,1.5,0,0,0,0,5.3,8.6,3.3,0.2,3.4,3.2,1.3,4.1,2.8,1.2,2,0.8,0,1.9,1.9,12.7,2,-10.7,0.6,1,0.4,46.7,26.5,-20.2,185.8,36.2,-149.6,5.7,23.4,17.7,0,0.039336,0.039336,79.6,224.7,145.1,0,1.9,1.9,,,,0,0,0,29.6,8.9,-20.7,0.1,1,0.9,3,5.5,2.5,0.5,15.9,15.4,0.3,2.2,1.9,7.7,3.4,-4.3,0.2,2.1,1.9,40.8,3.6,-37.2,13.2,20.4,7.2,0,0.9,0.9,0.4,3.2,2.8,0.8,0.9,0.1,866.6,72.5,-794.1,0,0,0,198.6,3.5,-195.1,0.5,5.5,5,0,0,0,0,0.5,0.5,1.5,2.3,0.8,365.1,19.5,-345.6,42,8.6,-33.4,0,0,0,0.1,0.1,0,0,0.2,0.2,5.5,3.1,-2.4,26.4,1.2,-25.2,0.1,0.2,0.1,0.3,1.2,0.9,0,0.1,0.1,1.5,22.5,21,0,0.4,0.4,0,0.8,0.8,2.1,1.7,-0.4,11.9,10.9,-1,1.1,1.1,0,0,0,0,1.8,3,1.2,23.6,1.7,-21.9,0.9,7.9,7,20,0.9,-19.1,,,,0.6,0,-0.6,0,0.5,0.5,0,0,0,375.3,293.1,-82.2,7.9,30.5,22.6,1,4.8,3.8,0.6,1.2,0.6,4.1,0.3,-3.8,10.5,2,-8.5,9.2,0.9,-8.3,11.6,0,-11.6,0,71.1,71.1,0,0,0
2000-12-01,5523.6,1584.5,-3939.1,19020.4,15584.5,-3435.9,103673,65816,-37857,6155.4,0,-6155.4,8794.2,4116.7,-4677.5,19456,20907,1451,8979.4,7032,-1947.4,6112.2,5177.7,-934.5,29099.1,21526.9,-7572.2,21295.670144,17249.243664,-4046.42648,2314.828706,934.529387,-1380.299319,33672.1,17505.7,-16166.4,98452.1,65211.3,-33240.8,38841.9,19104.1,-19737.8,,,,786.4,1200,413.6,1881.1,518.1,-1363,1.3,0.1,-1.2,18989.7,13390.4,-5599.3,0.8,0.1,-0.7,10109.4,8136.6,-1972.8,209.3,182.8,-26.5,5.1,15.7,10.6,149.2,144.1,-5.09999999999999,255,203.8,-51.2,45,31.1,-13.9,261.7,212.3,-49.4,22.4,115.7,93.3,1.1,25.9,24.8,41.1,77.7,36.6,0,0.2,0.2,45.7,133,87.3,0.7,7.7,7,0.3,30.8,30.5,25.7,48.2,22.5,317.7,332,14.3,0.2,1.8,1.6,0.7,5.9,5.2,3.1,4.6,1.5,0.6,10.2,9.6,0,0.7,0.7,0.5,1.9,1.4,1.8,8.4,6.6,0.2,3.8,3.6,1.9,6,4.1,2.5,24.2,21.7,217.9,76.8,-141.1,67,89.6,22.6,,,,,,,179.4,22.3,-157.1,0.3,5.9,5.6,1,2.2,1.2,561.2,335.8,-225.4,1575.2,592.7,-982.5,12.4,20.8,8.4,8.7,15.5,6.8,0,1.6,1.6,175.7,90.9,-84.8,164.3,137.7,-26.6,13.8,13.6,-0.200000000000001,331.2,276.9,-54.3,1134.5,1410,275.5,3.4,37.4,34,18.9,42.7,23.8,255.8,377.1,121.3,0,0,0,24.2,13.2,-11,889.4,384.8,-504.6,0,0,0,409.4,111.5,-297.9,256.2,155.9,-100.3,2.1,0,-2.1,251,128.5,-122.5,3537.5,3994.1,456.6,1209.2,769.2,-440,760.1,1960.4,1200.3,865.2,1180.7,315.5,26.3,28.6,2.3,0,0.7,0.7,1.1,0.4,-0.7,2784.6,2110,-674.6,4865.9,2645,-2220.9,267.2,192.2,-75,,,,87.4,81.4,-6,16.5,7.8,-8.7,268.4,44.4,-224,19.6,0.7,-18.9,885.5,873.2,-12.3,37.7,5.7,-32,29.9,6.2,-23.7,13.1,6.4,-6.7,75,74.1,-0.900000000000006,,,,509.3,158.2,-351.1,12.8,2.1,-10.7,66.5,20.6,-45.9,1.8,11.6,9.8,1.6,72.3,70.7,1.7,10.4,8.7,17,8.5,-8.5,0.1,0.5,0.4,3.6,0.8,-2.8,0.6,5.9,5.3,3.3,5,1.7,2.9,14.1,11.2,482.6,543.8,61.1999999999999,136,114.5,-21.5,0.4,6,5.6,54.7,30.1,-24.6,0.3,0,-0.3,0,0.1,0.1,2037,968.9,-1068.1,,,,4.5,6.4,1.9,25,9.6,-15.4,1.2,2.7,1.5,5.6,3.9,-1.7,0.1,1.8,1.7,,,,,,,,,,0.3,2.3,2,42.1,125,82.9,46.8,25.7,-21.1,26.2,7.5,-18.7,226.7,298.6,71.9,2.4,17.2,14.8,24.1,26.3,2.2,7,23.7,16.7,480.9,1.3,-479.6,16.8,0.2,-16.6,249.4,281.9,32.5,0.1,0,-0.1,0.1,0.1,0,10.7,25.1,14.4,216.8,46.7,-170.1,,,,1233.5,421.1,-812.4,38.8,24.9,-13.9,61.9,171.2,109.3,61.7,10,-51.7,20,15.3,-4.7,43.1,33.5,-9.6,0,0.1,0.1,682.2,351.9,-330.3,154.6,42.9,-111.7,17.8,1,-16.8,141.2,29.5,-111.7,151.8,22.9,-128.9,36.9,2.5,-34.4,1337.8,766.1,-571.7,62.8,29.9,-32.9,0.5,0.3,-0.2,43.5,1.3,-42.2,2117.2,863.3,-1253.9,1591.5,1548.2,-43.3,846.7,190.3,-656.4,0,0,0,13.2,11.1,-2.1,1193.9,809.1,-384.8,78.8,10.1,-68.7,0,0.1,0.1,10.2,0.6,-9.6,7604.7,1586.7,-6018,7.5,0.6,-6.9,0,0,0,3438.9,2147.2,-1291.7,801.6,1425.9,624.3,3147.3,1910.7,-1236.6,12069.8,5824,-6245.8,579.6,1024.6,445,0,0,0,0,0.2,0.2,0.1,0.7,0.6,0,0,0,2.3,1.2,-1.1,186.4,153,-33.4,0,0.1,0.1,0.4,1.2,0.8,0,0,0,0.4,0.9,0.5,0.1,0.6,0.5,0.1,0.2,0.1,0,0.2,0.2,0.3,0.3,0,0,0,0,1.6,1.8,0.2,0,0,0,3,6.4,3.4,0.1,1.8,1.7,0.9,1.8,0.9,0,1.6,1.6,0,0.9,0.9,10.6,1.9,-8.7,0.5,0.6,0.1,41.4,49.5,8.1,297.7,66,-231.7,3.8,27.6,23.8,0,0.116147,0.116147,90.1,262.1,172,0.2,0.1,-0.1,,,,0,0,0,9.7,5.4,-4.3,0,0.9,0.9,11.9,3.3,-8.6,0.3,9.4,9.1,0.4,4.6,4.2,1,14.4,13.4,0.3,0.9,0.6,23.6,9.9,-13.7,11.1,18.9,7.8,0,0.5,0.5,0.4,4.8,4.4,0.1,1.4,1.3,755.1,59.5,-695.6,0,0,0,183.6,5.7,-177.9,0.2,2,1.8,0.6,0.1,-0.5,0,1.5,1.5,0.1,1.2,1.1,385.6,19.3,-366.3,58.1,4.8,-53.3,0,0,0,0.3,0.6,0.3,0.1,0.1,0,3.8,4.5,0.7,14,1,-13,0.1,0.1,0,0.1,0.4,0.3,0,0.5,0.5,0.5,8.2,7.7,0,0.3,0.3,0,0.7,0.7,1,1.4,0.4,10.4,15.9,5.5,0.3,1.7,1.4,0.1,0,-0.1,2.8,2.5,-0.3,23.9,1.6,-22.3,5.9,8.7,2.8,19.1,3.5,-15.6,,,,1.5,0,-1.5,0,0.5,0.5,0,0,0,310.1,250.2,-59.9,8.9,28.4,19.5,1,5.2,4.2,0.8,3.1,2.3,9.3,0.6,-8.7,7.7,2,-5.7,4,1,-3,12.4,0,-12.4,0,18.2,18.2,0,0,0
2001-01-01,5793.1,1705,-4088.1,19413.6,13908.7,-5504.9,105470,65869,-39601,6374.8,0,-6374.8,9516.2,4699.3,-4816.9,17671,18287,616,9064.2,6443.1,-2621.1,6476.1,4779.9,-1696.2,31147.9,22314.6,-8833.3,22021.41503,15567.651076,-6453.763954,2360.67478,1006.710463,-1353.964317,33463.2,15779.1,-17684.1,101869.1,62161,-39708.1,39102.2,17481.8,-21620.4,,,,757.2,1010.5,253.3,1961.7,598.1,-1363.6,3.4,0,-3.4,20441.9,13666.6,-6775.3,0.3,0,-0.3,10706,8648,-2058,228.7,156.6,-72.1,4.1,15.8,11.7,121.4,140.1,18.7,206.7,205.6,-1.09999999999999,51.9,41.5,-10.4,205.5,207.2,1.69999999999999,25.8,106.1,80.3,0.8,27,26.2,24.6,89.1,64.5,0,0.3,0.3,29.3,114.8,85.5,0.4,6.8,6.4,0.1,25.9,25.8,17.7,39.3,21.6,252,339.7,87.7,0,1.6,1.6,0.7,5.6,4.9,3.4,4.3,0.9,0.1,12.4,12.3,0,0.3,0.3,0.3,4,3.7,1.3,7.2,5.9,0.1,2.5,2.4,2.3,3.9,1.6,3.4,22.5,19.1,274.2,68.4,-205.8,61.4,69.1,7.7,,,,,,,204.1,24.4,-179.7,0.2,6.7,6.5,0.2,4.1,3.9,615.9,335.9,-280,1678.3,461.3,-1217,12.1,9.8,-2.3,19.8,9.6,-10.2,0.1,1.8,1.7,190.1,113.1,-77,172.9,107,-65.9,14.8,12.2,-2.6,390.5,249.9,-140.6,1360,1265.3,-94.7,2.9,35.7,32.8,20.1,40.9,20.8,277.7,384.8,107.1,0.1,0,-0.1,19,10.5,-8.5,730.3,322.3,-408,0,0,0,439.3,103.6,-335.7,300.9,132.7,-168.2,1.4,0,-1.4,226.6,122,-104.6,3856.5,3373.5,-483,1496.9,756,-740.9,835.3,1808.5,973.2,870.9,1143.1,272.2,30.4,24.2,-6.2,0,0.8,0.8,0.8,1.3,0.5,2524.9,1641.5,-883.4,4875,2546.3,-2328.7,307.6,196.2,-111.4,,,,98.6,72.3,-26.3,19,6.1,-12.9,165.3,50.7,-114.6,19,0.9,-18.1,872.1,934.6,62.5,37.1,3.4,-33.7,41.1,13.9,-27.2,10.6,5.2,-5.4,78.8,69.8,-9,,,,695.1,198.3,-496.8,15.3,7.8,-7.5,60.3,20.9,-39.4,3.5,2.3,-1.2,3,4.1,1.1,0.3,10.4,10.1,64.4,9,-55.4,0.2,2,1.8,2.2,2,-0.2,0.4,2.4,2,11.3,82.8,71.5,3,14.9,11.9,542,459.2,-82.8,161.5,87.6,-73.9,0.1,0.4,0.3,39.8,21.9,-17.9,0,0,0,0,0.1,0.1,2083.7,918.2,-1165.5,,,,18.9,4.3,-14.6,25.1,7.7,-17.4,1.1,5.4,4.3,15.1,1.4,-13.7,0.3,3,2.7,,,,,,,,,,2.9,0.1,-2.8,53.3,114,60.7,44.4,27,-17.4,26.2,9.5,-16.7,288.3,198.8,-89.5,2.6,12.5,9.9,31.8,13.7,-18.1,9.5,25.6,16.1,292.9,0,-292.9,17,2.1,-14.9,245.8,265,19.2,0.1,0,-0.1,0,0,0,15.9,13.5,-2.4,247.1,73.3,-173.8,,,,1304.7,482.9,-821.8,37.7,23.8,-13.9,132.8,187.3,54.5,0.6,22.2,21.6,26.3,16.4,-9.9,40,28.2,-11.8,0.5,0.4,-0.1,888.6,277.3,-611.3,179.6,36,-143.6,19.2,1.5,-17.7,234.9,17.9,-217,196.5,12.3,-184.2,51,2,-49,1360.4,593.3,-767.1,58.4,26.5,-31.9,0.2,0.1,-0.1,94.9,1.8,-93.1,1869.2,899.3,-969.9,1499.3,1434.4,-64.8999999999999,956.5,234.4,-722.1,0,0,0,35.1,12.3,-22.8,1102.7,756.2,-346.5,130.3,9.4,-120.9,0,0,0,8.7,0.4,-8.3,8427.5,1187.5,-7240,12.5,1.2,-11.3,0,0,0,3514.3,2149.7,-1364.6,981.5,1046.2,64.7,3069,1812.8,-1256.2,11142.5,5252.7,-5889.8,542,856.5,314.5,0,0,0,0,0,0,0,0.3,0.3,0,0,0,4.2,1.7,-2.5,188.9,125.9,-63,0,0,0,0.2,0.9,0.7,0,0,0,0.4,0.7,0.3,0,5,5,0,0.1,0.1,0,0.2,0.2,0.1,0.7,0.6,0,0,0,0.6,1.2,0.6,0,0,0,3.2,7.2,4,0.1,1.7,1.6,1.6,4.6,3,1.9,1.1,-0.8,0,1,1,13.6,1.5,-12.1,0.4,0.2,-0.2,32.4,25.8,-6.6,279.6,174,-105.6,13.7,26,12.3,0,1.438447,1.438447,73,179.9,106.9,0.6,0.1,-0.5,,,,0,0,0,27.8,6.8,-21,0,2.4,2.4,2.1,110.1,108,3.8,4.9,1.1,0.2,1.4,1.2,8.8,8.9,0.0999999999999996,0.3,3.6,3.3,39.7,8.7,-31,12.9,15.9,3,0,0.3,0.3,0.4,5.3,4.9,0.2,0.7,0.5,846.4,65.9,-780.5,0.8,0,-0.8,124.3,6,-118.3,0.3,6.2,5.9,0,2.5,2.5,0,0.3,0.3,0.1,2.3,2.2,267.7,25.6,-242.1,39.2,8.4,-30.8,0,0.4,0.4,0.2,0.7,0.5,0,0.1,0.1,2.1,3.6,1.5,9.7,0.5,-9.2,0.2,1,0.8,0.4,2.7,2.3,0,0.1,0.1,0.6,8.1,7.5,0,1.3,1.3,0.1,1.7,1.6,0.6,3.3,2.7,12,11.4,-0.6,0.5,7,6.5,0,0.1,0.1,3.3,4.8,1.5,21.7,2.2,-19.5,0.4,1.4,1,18.6,2,-16.6,0,0,0,0.3,0,-0.3,0,0.1,0.1,0,0.1,0.1,478.7,235.1,-243.6,2.1,21.4,19.3,0.6,2,1.4,1.2,1.7,0.5,4.9,2.2,-2.7,6.8,3.4,-3.4,7.7,0.5,-7.2,13,0,-13,0,0,0,0,0,0
2001-02-01,4781.4,1483.1,-3298.3,18491.1,14794,-3697.1,100350,66114,-34236,6245.4,0,-6245.4,9156.3,4435.8,-4720.5,16118,18062,1944,7286,6508.2,-777.8,5475.2,4547.2,-928,28560.4,22124.9,-6435.5,20771.993491,16608.260063,-4163.733428,2039.46586,1011.926801,-1027.539059,29210.6,15762.4,-13448.2,91638.8000000001,62742.7,-28896.1000000001,34188.8,17369,-16819.8,,,,600.8,1081.5,480.699999999999,1720.6,550.3,-1170.3,1.8,0,-1.8,18263.4,13356.8,-4906.6,0.3,0,-0.3,10297,8768.1,-1528.9,202.8,159.5,-43.3,14.5,14.7,0.199999999999999,148.9,146.1,-2.80000000000001,266.4,206.3,-60.1,49.6,32.9,-16.7,229.5,182.9,-46.6,15.9,110.1,94.2,0.8,65.3,64.5,25.5,74.1,48.6,0,0.1,0.1,35.3,107.7,72.4,0.5,6,5.5,0.1,22.7,22.6,21.5,45.5,24,324.3,367.9,43.6,0.2,1,0.8,1.1,5.6,4.5,3.4,3.6,0.2,0.1,7.8,7.7,0,0.5,0.5,0.3,2.1,1.8,1.5,6.2,4.7,0.2,2.8,2.6,2.4,4,1.6,3.8,26,22.2,238.7,59.1,-179.6,48.8,65.7,16.9,,,,,,,127.5,17.1,-110.4,0.3,5.5,5.2,0,2.2,2.2,482.2,286.3,-195.9,1323.8,410.8,-913,10.1,10.4,0.300000000000001,8.8,11.5,2.7,0,0.6,0.6,165.2,100.5,-64.7,139.2,121.5,-17.7,14.6,12.9,-1.7,291.4,258.5,-32.9,1049.9,1169,119.1,1.7,32.8,31.1,22.5,39.6,17.1,200.3,341.8,141.5,1.6,0,-1.6,15.9,11.4,-4.5,795.5,362.6,-432.9,0,0,0,445,137.9,-307.1,290.6,132,-158.6,1.6,0,-1.6,243.8,219,-24.8,3546.6,3486.2,-60.4000000000001,1374.9,629.9,-745,725.3,1820.7,1095.4,841.6,1142.9,301.3,31.6,24.2,-7.4,0,0.9,0.9,2.1,0.2,-1.9,2343.6,1972.3,-371.3,4846,2928.4,-1917.6,302.3,203.9,-98.4,,,,82.9,53.2,-29.7,17.9,5,-12.9,338.1,66,-272.1,19.6,0.6,-19,846.9,1132.4,285.5,20.4,4,-16.4,28.1,5.4,-22.7,12.6,7.7,-4.9,80,61.1,-18.9,,,,505.9,156.9,-349,4.6,2,-2.6,43,21.4,-21.6,3.9,2.3,-1.6,8.5,3.4,-5.1,0.3,19.4,19.1,32.8,16,-16.8,0.3,0.6,0.3,2.2,0.9,-1.3,0.6,2.1,1.5,2.8,1.8,-1,5,2.7,-2.3,416.8,529.7,112.9,116,103.2,-12.8,0.4,0.4,0,25.9,25.5,-0.399999999999999,0.8,0.6,-0.2,0,0.8,0.8,1946.4,889.1,-1057.3,,,,19.3,6.3,-13,23.4,10.5,-12.9,0.5,4.2,3.7,9.4,1.3,-8.1,0,2.8,2.8,,,,,,,,,,0.5,1.1,0.6,39.4,87,47.6,42.8,12.4,-30.4,24.4,6,-18.4,241.9,265.2,23.3,1.3,24.7,23.4,11.4,20.7,9.3,6.9,33.9,27,205.5,3.4,-202.1,13.8,0.2,-13.6,235,186.9,-48.1,0,0,0,0.1,0.2,0.1,17,36.4,19.4,191.1,62.1,-129,,,,1280.1,382,-898.1,28.8,22.4,-6.4,116.9,176.8,59.9,35.1,19,-16.1,35.1,21.8,-13.3,48,24.3,-23.7,0,0.5,0.5,743.4,351.5,-391.9,174.4,25.7,-148.7,24.4,0.4,-24,190.9,22.5,-168.4,173,16,-157,43.2,0.6,-42.6,1095.7,589.1,-506.6,50,31.6,-18.4,0.5,0.1,-0.4,85.3,2.6,-82.7,1746.4,778.1,-968.3,1305.5,1541.4,235.9,762.8,203,-559.8,0,0,0,18.5,8.9,-9.6,990.5,689.3,-301.2,74.2,7.1,-67.1,0.1,0.1,0,10.7,0.3,-10.4,6375.6,1289.8,-5085.8,10.3,1,-9.3,0,0,0,2810.7,2024.9,-785.8,616.8,1169.6,552.8,2552.9,1772.2,-780.7,11380,5222.4,-6157.6,396.3,922.3,526,0,0,0,0,0,0,0,0,0,0,0,0,1,0.8,-0.2,179.2,132.6,-46.6,0.1,0.1,0,3.6,2.1,-1.5,0,0,0,0.5,1.2,0.7,0.1,0.2,0.1,0,0,0,0,0.1,0.1,0.1,1.2,1.1,0,0,0,2.6,4.6,2,0,0.1,0.1,3.1,7.5,4.4,0,4.2,4.2,1.4,2.1,0.7,1.6,1.1,-0.5,0,0.1,0.1,10.7,1.2,-9.5,0.5,0.1,-0.4,36.5,19.5,-17,201.2,120.7,-80.5,10.1,28.6,18.5,0,0.580635,0.580635,71,292.5,221.5,0.4,0,-0.4,,,,0,0,0,24.8,2.9,-21.9,0,1.4,1.4,21.5,3.9,-17.6,0.9,14.4,13.5,0.1,9.5,9.4,11.6,3.2,-8.4,0.2,1.6,1.4,53,10.3,-42.7,18.9,23.1,4.2,0.1,0.5,0.4,2.8,6.6,3.8,0.3,0.6,0.3,657.3,101.6,-555.7,0,0,0,171.6,2.6,-169,0.4,7.3,6.9,0,0.1,0.1,0,0.3,0.3,0,2,2,340.8,9.9,-330.9,52.7,4.7,-48,0,0,0,0.3,0.3,0,0.1,0,-0.1,4.3,2.3,-2,4,0.4,-3.6,0.2,0.2,0,0,0.4,0.4,0,0,0,0.3,7.6,7.3,0,2.9,2.9,0,0.6,0.6,0.7,2.3,1.6,8.5,13,4.5,0.6,0.9,0.3,0.1,0,-0.1,2.1,2.9,0.8,22.2,1.9,-20.3,0,1.2,1.2,21.9,0.7,-21.2,0,0,0,1.4,0.2,-1.2,0,0.2,0.2,0,0,0,265.1,270.3,5.19999999999999,1.1,23.4,22.3,0.6,2.6,2,1.8,1.3,-0.5,3.2,0.3,-2.9,11.2,2.4,-8.8,2,0.6,-1.4,11.5,0,-11.5,0,0,0,0,0,0
2001-03-01,5642,2286.5,-3355.5,20720.2,15690,-5030.2,101853,64350,-37503,7356,0,-7356,10320.1,5438.6,-4881.5,18610,20628,2018,8416,6988,-1428,6218.7,5323.2,-895.5,32020.9,24795.9,-7225,23789.248193,17925.666706,-5863.581487,2553.092865,904.265826,-1648.827039,32815.2,18058.5,-14756.7,103536.9,70358.0000000001,-33178.9,38229.6,20021.5,-18208.1,,,,722.3,1387.4,665.1,2151,557.9,-1593.1,2.3,0.1,-2.2,19975.8,15523.7,-4452.1,0.5,0,-0.5,12045.2,9272.2,-2773,255.6,169.9,-85.7,11.5,17.3,5.8,180.9,161.2,-19.7,300.9,238.3,-62.6,57.9,42.8,-15.1,258.5,236.4,-22.1,19,122.7,103.7,1.5,34.4,32.9,15.4,83.1,67.7,0,0.1,0.1,36.1,130.6,94.5,0.4,6.4,6,0.4,30.6,30.2,24.6,55.6,31,386.4,409,22.6,0.3,1.9,1.6,0.9,7,6.1,3.2,3.6,0.4,0.2,9,8.8,0,0.4,0.4,0.3,4.2,3.9,1.6,7.8,6.2,0.5,2.6,2.1,2.3,5.3,3,3.6,25.6,22,243.6,77.6,-166,48.7,70.4,21.7,,,,,,,136.9,18.6,-118.3,0.3,7.1,6.8,0.1,2.4,2.3,460.5,327.4,-133.1,1475.3,516.6,-958.7,10.7,12.4,1.7,13.7,14.5,0.800000000000001,0.2,0.4,0.2,155.4,126,-29.4,153.6,141.5,-12.1,10.4,16.2,5.8,386.1,270.2,-115.9,1201.5,1412.3,210.8,1.7,38.6,36.9,22.4,33.8,11.4,334,431.2,97.2,1.5,0.1,-1.4,23.3,88.9,65.6,855.3,417,-438.3,0,0,0,453.4,169.5,-283.9,289.2,154.5,-134.7,2.1,0.4,-1.7,303.7,196.7,-107,3634,3700.4,66.4000000000001,1382,692,-690,859.8,1912.1,1052.3,1036.1,1285.2,249.1,26.1,25.5,-0.600000000000001,0,0.8,0.8,0.9,0.8,-0.1,3309.3,2042,-1267.3,5344.8,2892.4,-2452.4,347.8,227.2,-120.6,,,,109.2,79.4,-29.8,21.4,8.1,-13.3,199,57.4,-141.6,17.7,0.8,-16.9,937.3,1173.8,236.5,32.8,7.1,-25.7,10.2,7.5,-2.7,28.9,5.3,-23.6,83.2,71.6,-11.6,,,,1113.9,223.5,-890.4,9.3,1.3,-8,73.5,24.2,-49.3,2.8,2.2,-0.6,0.9,2.3,1.4,0.6,8.7,8.1,37.2,9,-28.2,0.1,1.6,1.5,3.4,1,-2.4,0.5,2.1,1.6,3.6,2.2,-1.4,2.2,12.6,10.4,425.3,617.3,192,141.5,118.8,-22.7,0.1,0.6,0.5,35.7,22.3,-13.4,0.6,0.3,-0.3,0,0.3,0.3,2172.9,967.6,-1205.3,,,,11.7,4.8,-6.9,26.2,12,-14.2,1,1.8,0.8,10.1,4.6,-5.5,0.2,6.6,6.4,,,,,,,,,,0.3,2,1.7,44.3,97.5,53.2,45.3,65.3,20,22,20.5,-1.5,295.2,403.2,108,1.6,73.1,71.5,21.4,14.4,-7,8,83.3,75.3,386.7,8.1,-378.6,14,0,-14,247.2,276.2,29,0.3,0,-0.3,0,0.3,0.3,15.2,21.8,6.6,197.7,76.7,-121,,,,1218.8,874.2,-344.6,36.5,29.8,-6.7,100.8,421.9,321.1,51,12,-39,22.6,19.2,-3.4,34.4,56.8,22.4,0,0.2,0.2,846.7,303.7,-543,185.7,40.9,-144.8,33,1.3,-31.7,204,20.3,-183.7,181.1,11.9,-169.2,40.7,0.6,-40.1,1251.6,577.9,-673.7,56.5,31.5,-25,0.2,0.1,-0.1,82.7,2.2,-80.5,1931.7,1011.3,-920.4,1372.6,1689.1,316.5,917.8,217.8,-700,0,0,0,54.3,12.7,-41.6,1051.6,700,-351.6,79.2,10.5,-68.7,0,0.1,0.1,8.7,0.3,-8.4,7590.2,1855.8,-5734.4,12.8,1.4,-11.4,0,0,0,3125.4,2217.4,-908,751.1,1378.5,627.4,3166.9,1702.9,-1464,12076.2,5897.3,-6178.9,522.6,990.3,467.7,0.2,0,-0.2,0,0.1,0.1,0,0.1,0.1,0,0,0,1.3,2.2,0.9,174.4,372.7,198.3,0,0.2,0.2,0.2,0.7,0.5,0,0,0,0.5,1.2,0.7,0.1,0.3,0.2,0,0.1,0.1,0,0.4,0.4,0.1,0.8,0.7,0,0,0,0.6,3,2.4,0,0,0,6.4,6.3,-0.100000000000001,0.1,1.9,1.8,1.6,3.6,2,1.4,1.2,-0.2,0,0.3,0.3,12.2,1.7,-10.5,0.6,0.2,-0.4,48.8,23.4,-25.4,267.2,67.4,-199.8,12.6,18.2,5.6,0,0.334098,0.334098,72.9,237,164.1,0.4,3.3,2.9,,,,0,0,0,42.6,9.4,-33.2,0.1,1.2,1.1,2.1,3.9,1.8,0.5,5.8,5.3,0.7,3.9,3.2,7.6,4.1,-3.5,0.2,3.7,3.5,46,7.7,-38.3,17.8,20,2.2,0.1,0.7,0.6,0.3,3.3,3,1.9,1.3,-0.6,1027.3,74,-953.3,0.6,0.2,-0.4,158.1,9.1,-149,0.1,0.7,0.6,0.5,0.1,-0.4,0,0.1,0.1,0,1.6,1.6,316.1,31.6,-284.5,26.4,5.5,-20.9,0,0,0,0.1,0.2,0.1,0.1,5.1,5,4.2,3.1,-1.1,9,2,-7,0.2,0.2,0,0,6.3,6.3,0,0.5,0.5,7.3,12.4,5.1,0,1,1,0,0.8,0.8,1.7,3.4,1.7,7,13.6,6.6,2.4,1.1,-1.3,0,0,0,1.9,2.1,0.2,21.8,3.8,-18,0,2.9,2.9,26.1,1.5,-24.6,0,0,0,0.1,0,-0.1,0.1,0.3,0.2,0,0,0,377.4,279.6,-97.8,12.7,24.2,11.5,0.7,2.1,1.4,1.1,1.1,0,4.5,4.7,0.2,7.1,4.5,-2.6,2.6,0.4,-2.2,19.3,0,-19.3,0,0,0,0,0,0
2001-04-01,5438.7,1687.8,-3750.9,19677.4,13949,-5728.4,98164,62805,-35359,6559.3,0,-6559.3,9638.1,5261.6,-4376.5,16133,16543,410,7668.9,5840.9,-1828,5702.1,4967.6,-734.5,29213.7,22601.6,-6612.1,22206.707968,15994.554541,-6212.153427,2445.455219,921.310077,-1524.145142,31143.9,15028.5,-16115.4,96264.3000000001,62015.8,-34248.5000000001,35902.9,16508.5,-19394.4,,,,792.2,1014.5,222.3,2003.8,595.7,-1408.1,1,0,-1,18732.9,14403.2,-4329.7,0.3,0.4,0.1,10480.8,8198.4,-2282.4,209.3,165.4,-43.9,6.5,13.6,7.1,138.9,150.6,11.7,248.8,197,-51.8,42.5,43,0.5,228.3,213.8,-14.5,22.9,115.4,92.5,12.2,27.9,15.7,31.8,79.2,47.4,0,0.8,0.8,44.8,107.3,62.5,0.5,6.6,6.1,0.1,23.2,23.1,23.1,40.8,17.7,329.1,419.5,90.4,0.1,1.6,1.5,1.1,8.8,7.7,2.8,5.3,2.5,1.2,7.1,5.9,0,0.2,0.2,0.3,2.4,2.1,1.7,6.7,5,0.4,4.1,3.7,1.6,5.5,3.9,3.2,22.6,19.4,213.7,77.2,-136.5,55.6,165.5,109.9,,,,,,,114.1,35.4,-78.7,0.8,6.1,5.3,0,1.3,1.3,483.9,319.7,-164.2,1410.4,451,-959.4,13.3,11.6,-1.7,9.4,14.7,5.3,0,3.3,3.3,192.8,109.7,-83.1,150.5,121.7,-28.8,15.7,26.4,10.7,365.8,239.1,-126.7,1077.1,1294.8,217.7,2.1,31.9,29.8,24.2,35.9,11.7,221,353.9,132.9,0.8,0.1,-0.7,20.5,19.2,-1.3,751.4,299,-452.4,0,0,0,445.2,113.3,-331.9,321,139.3,-181.7,1.3,0.1,-1.2,273.4,138.1,-135.3,3685.4,3719.1,33.6999999999998,1543.6,536.5,-1007.1,831.3,1756.3,925,816.3,1205.1,388.8,28.8,26.8,-2,0,0.8,0.8,1.2,1.3,0.1,2733.9,1609.5,-1124.4,5377.7,2507.6,-2870.1,300.4,263.1,-37.3,,,,96.8,69.9,-26.9,21.5,4.7,-16.8,165.5,56.7,-108.8,17.4,0.4,-17,1082.9,1011.1,-71.8000000000001,9.1,4.6,-4.5,7.8,8.3,0.500000000000001,12.4,11.4,-1,83.6,65.1,-18.5,,,,506.2,332.9,-173.3,4.4,2,-2.4,55.4,13.4,-42,2.2,5.7,3.5,0.7,3.6,2.9,0.5,4.8,4.3,23.1,14.1,-9,0.2,3,2.8,4.2,1.6,-2.6,0.7,3.4,2.7,2.2,5.1,2.9,2.9,9.5,6.6,435.7,420.1,-15.6,140.7,128.2,-12.5,0.6,0.3,-0.3,31.4,19.8,-11.6,0.5,0.3,-0.2,0,0.3,0.3,1928,791.7,-1136.3,,,,12,25.3,13.3,25.6,12,-13.6,0.5,2.4,1.9,8.5,2,-6.5,0.5,4.6,4.1,,,,,,,,,,0.3,0.5,0.2,50.6,91.3,40.7,43,79.5,36.5,24.8,11.7,-13.1,267.6,373.8,106.2,5.2,65,59.8,7.3,17.4,10.1,4.7,26.6,21.9,533.8,11.2,-522.6,10.8,0,-10.8,213.9,258.6,44.7,0.2,0,-0.2,0,0.7,0.7,14.6,35.6,21,178.8,90.7,-88.1,,,,1120.2,595.2,-525,59.3,28.3,-31,132.9,177.8,44.9,0.7,13,12.3,26.4,22.9,-3.5,25.5,20.3,-5.2,0,0.1,0.1,760.2,277.5,-482.7,161.7,26.8,-134.9,22.1,0.9,-21.2,148.7,24.1,-124.6,152.7,14.3,-138.4,30.4,0.3,-30.1,1116.8,450.9,-665.9,82.3,28.9,-53.4,0.8,0,-0.8,60,1.8,-58.2,1735.6,886.7,-848.9,1290,1232.9,-57.0999999999999,763.6,217.1,-546.5,0,0.8,0.8,31,11.3,-19.7,852.9,642.3,-210.6,76.6,7.1,-69.5,0,0.1,0.1,4.8,0.4,-4.4,7686.8,1398.9,-6287.9,7.2,1.4,-5.8,0,0,0,2824.2,1626.8,-1197.4,661.5,1317.3,655.8,2893.3,1664,-1229.3,11562.3,5032.6,-6529.7,567.5,875.9,308.4,0,0,0,0,0.2,0.2,0,0.1,0.1,0,0,0,2.6,1.7,-0.9,195.8,114,-81.8,0,0.1,0.1,0.3,0.9,0.6,0,0,0,0.5,1.4,0.9,0.1,0.2,0.1,0.1,0.1,0,0,0.8,0.8,0.1,0.4,0.3,0,0,0,0,2.2,2.2,0,0,0,5.2,8,2.8,0,1.7,1.7,1.5,2.9,1.4,2.5,1.3,-1.2,0,1.1,1.1,15.2,1.4,-13.8,0.8,0.4,-0.4,39.6,25,-14.6,303.8,36.9,-266.9,3.6,53.8,50.2,0,0.04052,0.04052,94.4,209.5,115.1,0,4,4,,,,0,0,0,0,9.4,9.4,0.1,2.1,2,8.8,8.6,-0.200000000000001,0.3,6.6,6.3,0.5,1.8,1.3,7.8,9.1,1.3,0,1.2,1.2,5.1,7.9,2.8,17.5,19,1.5,0.1,0.8,0.7,0.1,11.5,11.4,4,4.3,0.3,925.1,79.5,-845.6,0.3,0.4,0.1,138.7,3.9,-134.8,0.8,0.8,0,0,0.4,0.4,0,0.3,0.3,0.1,3.7,3.6,355.2,23.3,-331.9,24.7,6.5,-18.2,0,0,0,0.1,0.2,0.1,0.1,5.1,5,2.2,2.7,0.5,25.2,1.6,-23.6,0.1,0.1,0,0.1,0.5,0.4,0,0.1,0.1,5.5,9.5,4,0,0.4,0.4,0.2,0.9,0.7,2.7,1.2,-1.5,9.8,9.4,-0.4,0.9,106.7,105.8,0,0,0,2,2.6,0.6,19.1,2.8,-16.3,0,8.4,8.4,15.8,0.7,-15.1,0,0,0,0.7,0.2,-0.5,0,0.2,0.2,0,0,0,404.4,212.4,-192,2.3,23.9,21.6,0.8,1.8,1,2.7,1.2,-1.5,3.8,0.3,-3.5,4.5,3.5,-1,2.7,1.5,-1.2,11.3,0,-11.3,0,6.4,6.4,0,0,0
2001-05-01,5789.9,1670.1,-4119.8,19596.3,14427.2,-5169.1,95150,63772,-31378,7083.2,0,-7083.2,10495.1,5551.1,-4944,15257,17254,1997,7577.7,5786.3,-1791.4,5801.7,5216.1,-585.599999999999,31033.6,23757.2,-7276.4,21929.776305,16890.606264,-5039.170041,2455.037939,1090.162687,-1364.875252,29259,15196.2,-14062.8,96604.8,64931.5,-31673.3,34599.2,16685.8,-17913.4,,,,783.6,1280.4,496.8,1928.1,685.8,-1242.3,1.8,0.3,-1.5,19602.9,15107.8,-4495.1,0,0.1,0.1,11430.8,8649.4,-2781.4,229,147.5,-81.5,10.7,13.6,2.9,153,144.3,-8.69999999999999,280.7,206.7,-74,54.2,34.1,-20.1,261.3,204.3,-57,36.4,111.7,75.3,2.2,28.3,26.1,13.7,75.7,62,0,0.1,0.1,33.3,114.4,81.1,0.5,6.8,6.3,0.4,17.3,16.9,24.5,54.9,30.4,373.6,376.4,2.79999999999995,0.2,1.9,1.7,1,5.8,4.8,3.5,4.6,1.1,0.4,8.7,8.3,0,0.3,0.3,0.4,2.2,1.8,2,8.8,6.8,0.8,2.8,2,1.8,5,3.2,3.7,22,18.3,219.5,89,-130.5,14.4,85.3,70.9,,,,,,,51.7,17.7,-34,0.8,3.6,2.8,0,1.4,1.4,500.2,296.9,-203.3,1338.7,493.6,-845.1,10.8,12.4,1.6,13.4,12.8,-0.6,0,108.3,108.3,215.3,125.8,-89.5,120.1,140.7,20.6,8.5,20,11.5,271.3,264.4,-6.90000000000003,1261.1,1485.9,224.8,1.5,26.7,25.2,18.5,33.7,15.2,268.5,399.7,131.2,0,0,0,12.2,11.4,-0.799999999999999,763.3,313.1,-450.2,0,0,0,533.7,482.2,-51.5000000000001,300.7,127,-173.7,1,0.5,-0.5,276.8,137.6,-139.2,3567.4,4036.4,469,1408.9,569.6,-839.3,879.7,1593.7,714,946.3,1255.3,309,27.4,109,81.6,0,0.7,0.7,2.8,1.7,-1.1,2611.6,1686.6,-925,5219.3,2604.5,-2614.8,341.8,216.2,-125.6,,,,102,43.1,-58.9,21.8,5.6,-16.2,271.6,65.8,-205.8,21,0.8,-20.2,846,1236.2,390.2,21.1,4.5,-16.6,6.9,11.1,4.2,10.6,8.5,-2.1,72,69.7,-2.3,,,,423.1,272.6,-150.5,7.5,1.4,-6.1,53.4,16.5,-36.9,2.1,7.4,5.3,0.8,6.1,5.3,9.8,12.3,2.5,34,13.5,-20.5,0.1,5.3,5.2,5.2,1.1,-4.1,0.7,3.2,2.5,4.2,2.1,-2.1,3.3,12.8,9.5,476,491.2,15.2,139.5,114.4,-25.1,0.6,0.3,-0.3,27.1,26.5,-0.600000000000001,0.2,0.2,0,0,0.1,0.1,2044,841.4,-1202.6,,,,10.8,7.7,-3.1,23.5,12.2,-11.3,1.7,3,1.3,8.8,3.2,-5.6,0.3,1.5,1.2,,,,,,,,,,0.5,0.4,-0.1,35.9,66.9,31,53.1,15,-38.1,36,9,-27,260.7,335.1,74.4,1.1,17.3,16.2,5,13.2,8.2,7.6,33.2,25.6,598.7,1.1,-597.6,10.9,0.3,-10.6,256.3,313.9,57.6,0.1,0,-0.1,0,0.2,0.2,14.9,21.5,6.6,167,85.6,-81.4,,,,1330.6,465.3,-865.3,61.2,32.5,-28.7,122,194.6,72.6,0.3,10.1,9.8,17.4,18.6,1.2,24.9,23.3,-1.6,0.1,0.1,0,787.2,351.5,-435.7,187.5,38.8,-148.7,14,1,-13,179.2,28.5,-150.7,136.4,14.9,-121.5,32.8,0.4,-32.4,1152.5,662.1,-490.4,78.8,77.5,-1.3,0.1,0.2,0.1,64.3,2.4,-61.9,1704.2,678.7,-1025.5,1279.8,1550.2,270.4,859.4,238.9,-620.5,0,0,0,40.8,9.4,-31.4,861.9,740.9,-121,91.3,5.2,-86.1,0,0,0,11.3,1.6,-9.7,7757.9,1596,-6161.9,7.3,1.5,-5.8,0,0,0,2757.7,1691.8,-1065.9,758.6,1111.6,353,2781.6,1432.8,-1348.8,9606,4878.4,-4727.6,554.1,881.8,327.7,0,0,0,0,0,0,0,0.2,0.2,0,0,0,6.2,1.8,-4.4,199.4,378.9,179.5,0,0,0,0.2,0.6,0.4,0,0,0,0.6,1.6,1,0.1,0,-0.1,0,0,0,0,1,1,0.1,0.2,0.1,0,0,0,0.1,1.5,1.4,0,0,0,4.2,6.2,2,0,1.6,1.6,2.2,2.2,0,2.1,1.5,-0.6,0,0.3,0.3,13.6,1.1,-12.5,0.7,0.3,-0.4,43.5,28.2,-15.3,377.3,86.8,-290.5,12.2,15.4,3.2,0.008962,0.574664,0.565702,92.4,273.8,181.4,0.4,0,-0.4,,,,0,0,0,40.9,8.6,-32.3,0,1.2,1.2,1.3,10,8.7,0.3,5,4.7,0.8,3,2.2,13.4,2.3,-11.1,0.1,1.6,1.5,19.1,5.3,-13.8,18,11.7,-6.3,0.1,0.3,0.2,0.1,11.7,11.6,1.5,0.9,-0.6,924,71.5,-852.5,0.3,0.1,-0.2,118.3,2.2,-116.1,0.9,7.2,6.3,1.4,0,-1.4,0.1,0.2,0.1,0.2,2.1,1.9,257.2,23.7,-233.5,20.1,17.6,-2.5,0,0,0,0.1,0.5,0.4,0,0.1,0.1,4,3,-1,12.2,0.7,-11.5,0.9,0.1,-0.8,1.3,1.8,0.5,0,0.4,0.4,2.3,10.6,8.3,0,0.4,0.4,0.1,0.3,0.2,2.4,1.7,-0.7,11.3,128.4,117.1,0.5,2,1.5,0.1,0,-0.1,2.7,4.6,1.9,20.9,3.2,-17.7,0.2,0.7,0.5,23.2,2.1,-21.1,0,0,0,1.8,0,-1.8,0,0.3,0.3,0,0.1,0.1,388.9,311.7,-77.2,1,22.5,21.5,1.2,1.9,0.7,1.4,1.9,0.5,4.3,0.7,-3.6,11.5,2.7,-8.8,2.4,3.4,1,15.2,0,-15.2,0,10.7,10.7,0,0,0
2001-06-01,5223.6,1652.6,-3571,18334.9,13996.9,-4338,94978,61102,-33876,7144.4,0,-7144.4,10311.9,5522.6,-4789.3,16651,17715,1064,7732.6,5895.3,-1837.3,5695.1,5148.1,-547,30352.4,23455.3,-6897.1,20609.123016,15666.641609,-4942.481407,2228.728212,1134.019598,-1094.708614,30843,15245.7,-15597.3,95662.9000000001,63333.6,-32329.3000000001,35967,16843.8,-19123.2,,,,809.2,1075.1,265.9,1884.5,737.2,-1147.3,1.4,0.4,-1,18914.8,15050.6,-3864.2,0.1,0.1,0,11437.5,8404.7,-3032.8,228.6,148.7,-79.9,5.9,10.9,5,160.4,140.8,-19.6,261.8,207.4,-54.4,50.3,41,-9.3,268.3,209.5,-58.8,28.2,96.3,68.1,5.3,30.7,25.4,25.2,89.6,64.4,0,0,0,44.4,111.9,67.5,0.2,7.3,7.1,0.2,19.5,19.3,24.8,54,29.2,355.9,404.3,48.4,0.1,1.7,1.6,0.8,6.4,5.6,3.1,4,0.9,0.4,6.9,6.5,0.1,0.6,0.5,0.2,2.5,2.3,1.6,8.3,6.7,0.3,3.3,3,1.3,6.2,4.9,2.7,22.6,19.9,212,96.2,-115.8,15.6,46.1,30.5,,,,,,,85.4,16.3,-69.1,1,4,3,0,2.3,2.3,474.5,310.9,-163.6,1400.9,524,-876.9,12.5,11.3,-1.2,8.9,13.2,4.3,0,2.3,2.3,165.2,127,-38.2,163.8,140,-23.8,13.3,15.8,2.5,225.4,256.3,30.9,1188,1514.4,326.4,2.1,29.6,27.5,15.9,37,21.1,240.3,366.9,126.6,0,0,0,18.9,14.3,-4.6,721.2,283.5,-437.7,0,0.8,0.8,507.4,112,-395.4,273.5,127.8,-145.7,0.8,3.1,2.3,310.7,119.6,-191.1,3326.7,3824.3,497.6,1473,514.3,-958.7,777.4,1627.1,849.7,877,1171.9,294.9,23.8,22.6,-1.2,0,0.3,0.3,1.1,5.5,4.4,2303.4,1749.1,-554.3,4783.2,2431.7,-2351.5,360.3,264.5,-95.8,,,,95.9,91.7,-4.2,19.3,6.3,-13,191.6,61.6,-130,19.9,0.8,-19.1,784.8,980.1,195.3,26.8,4.2,-22.6,9.1,15.8,6.7,10.6,5.6,-5,79.6,53,-26.6,,,,453,212.5,-240.5,7.3,0.6,-6.7,36.7,14.3,-22.4,1.4,3.9,2.5,1.6,7.4,5.8,5.7,18,12.3,39.4,7.1,-32.3,1.8,0.3,-1.5,8,1.6,-6.4,0.5,1.4,0.9,3.2,12.6,9.4,3.3,7.5,4.2,454.3,505.3,51,138.5,100,-38.5,0.4,0.4,0,32.8,23.2,-9.6,0,0.1,0.1,0,0.2,0.2,1981.2,807.7,-1173.5,,,,11.8,4.3,-7.5,25.5,7.5,-18,1.9,1.5,-0.4,7.6,2.2,-5.4,1,10,9,,,,,,,,,,0.3,0.7,0.4,38.5,165.5,127,36.9,17.1,-19.8,22.9,7.4,-15.5,296.5,221.9,-74.6,1.1,13.2,12.1,18.8,17.6,-1.2,5.1,24.8,19.7,555.5,1.3,-554.2,12.6,0.2,-12.4,245.3,279.8,34.5,0.4,0,-0.4,0,0.1,0.1,15,34.3,19.3,167.1,70.6,-96.5,,,,1147.8,395.5,-752.3,71.9,22.7,-49.2,97.5,213.6,116.1,0.5,13,12.5,50.2,16.7,-33.5,38.7,22.9,-15.8,0,0.1,0.1,720.2,343.6,-376.6,206.6,47.6,-159,15.7,0.5,-15.2,213,29,-184,169.7,13.9,-155.8,42,0.8,-41.2,1205.9,646.1,-559.8,102.2,27,-75.2,0.5,0.1,-0.4,89.3,2.4,-86.9,2065.9,681.9,-1384,1186.8,1452.7,265.9,856.4,201.1,-655.3,0,0,0,17.6,9,-8.6,896.8,625.8,-271,117.7,4.3,-113.4,0,0,0,8.3,1.9,-6.4,8398.2,1786.4,-6611.8,11.8,0.3,-11.5,0,0,0,2860.7,1782.8,-1077.9,868.4,1295,426.6,2816.6,1364.8,-1451.8,9968.6,4985.6,-4983,537.6,927,389.4,0,0,0,0,0.1,0.1,0,0.1,0.1,0,0,0,1,1.1,0.1,250.6,128.1,-122.5,0,0.1,0.1,0.3,0.4,0.1,0,0,0,0.7,0.5,-0.2,0,0.1,0.1,0,0.1,0.1,0,0.2,0.2,0.1,0.1,0,0,0,0,1.5,2.4,0.9,0,0,0,3.5,6.3,2.8,0.1,1.9,1.8,1.2,2.4,1.2,0.5,1.6,1.1,0,0.1,0.1,11.4,1.3,-10.1,0.7,0.5,-0.2,29.6,23.1,-6.5,196.6,131.9,-64.7,5.9,22.3,16.4,0,9.530758,9.530758,112.3,219.1,106.8,0.6,0.1,-0.5,,,,0,0,0,0.2,4.2,4,0,1.1,1.1,11.1,3.2,-7.9,0.4,5.9,5.5,0.6,1.7,1.1,11.2,7,-4.2,0.8,6.5,5.7,20.5,6.1,-14.4,22.7,14.7,-8,0.1,0.4,0.3,0.3,2.1,1.8,2.2,0.7,-1.5,717.2,91.9,-625.3,0.1,0,-0.1,187.3,3.4,-183.9,0.6,2.6,2,0,0,0,0.1,0.7,0.6,0.1,2.7,2.6,275.8,28.9,-246.9,55.1,5.7,-49.4,0,0,0,0.1,5.2,5.1,0,0,0,3.5,2.2,-1.3,16.2,2.3,-13.9,0.4,0.6,0.2,0.1,0.5,0.4,0,0.7,0.7,2.2,9.6,7.4,0,0.6,0.6,0.2,0.8,0.6,1.6,4.5,2.9,13,173.4,160.4,6.4,0.4,-6,0,0,0,1,2.4,1.4,28.7,1.4,-27.3,0.3,0.6,0.3,23.1,3.2,-19.9,0,0,0,0.2,0.4,0.2,0,0.3,0.3,0,0,0,441.5,306.6,-134.9,7.7,18.4,10.7,1.4,3.9,2.5,0.3,2.4,2.1,3.6,0.2,-3.4,8.1,2.8,-5.3,2,1.2,-0.8,15.6,0,-15.6,0,10.1,10.1,0,0,0
2001-07-01,5299.6,1652.6,-3647,20129,11531.9,-8597.1,93680,59298,-34382,6614.7,0,-6614.7,7584.3,4827.5,-2756.8,16485,14870,-1615,7783.9,5865.6,-1918.3,5712.8,5013.4,-699.400000000001,26370.7,19375.4,-6995.3,22302.628436,12713.406033,-9589.222403,2224.189453,1025.610986,-1198.578467,31742.9,14119.8,-17623.1,94625.1999999999,54611.2,-40013.9999999999,37203.7,15425.6,-21778.1,,,,809.1,1035.5,226.4,1910.4,535.3,-1375.1,1.8,2.9,1.1,15792.5,11700.2,-4092.3,0.3,0,-0.3,10578.2,7675.2,-2903,239.8,134.3,-105.5,16.9,13.7,-3.2,171,127.5,-43.5,280.5,179.6,-100.9,55.5,32.3,-23.2,241.6,205,-36.6,29,120,91,32,28.9,-3.1,13.5,93.5,80,0,0.3,0.3,37.7,141.5,103.8,0.2,6.3,6.1,0.4,21.6,21.2,22.8,41.8,19,372.3,326.9,-45.4,0.2,1.8,1.6,1.1,8,6.9,3.2,4.9,1.7,0.3,8.7,8.4,0,1.3,1.3,0.2,1.5,1.3,1.1,6.1,5,3.5,2.2,-1.3,1.1,3.5,2.4,2.8,24.5,21.7,210,90.2,-119.8,44.9,43,-1.9,,,,,,,50.3,15.8,-34.5,0.7,3.4,2.7,0,1.5,1.5,469.6,294.5,-175.1,1328.9,477.4,-851.5,9.3,16.7,7.4,15.1,14.6,-0.5,0.1,6.3,6.2,177.8,110.8,-67,133.8,136.7,2.89999999999998,14,13.7,-0.300000000000001,269.3,393.6,124.3,1211.1,1433.7,222.6,2,46.4,44.4,19.2,35.3,16.1,229.3,344.1,114.8,0.6,0,-0.6,17.3,11.8,-5.5,750.6,243.8,-506.8,0,0,0,451,88.6,-362.4,261.7,106.2,-155.5,0.8,0.1,-0.7,345.7,97.2,-248.5,3549.7,3087.2,-462.5,1695.5,453.8,-1241.7,734.1,1289.9,555.8,902.7,995.5,92.8,28.2,24.4,-3.8,0,0.9,0.9,1.2,0.2,-1,2628.5,1232.6,-1395.9,5422.7,2443.4,-2979.3,356.7,137,-219.7,,,,95.2,44,-51.2,20.8,7.1,-13.7,295.3,46.4,-248.9,20.1,0.4,-19.7,753.8,486.1,-267.7,26.6,3.2,-23.4,10.6,9.5,-1.1,9.5,4.2,-5.3,80,57.6,-22.4,,,,459.3,259.3,-200,7.5,7.8,0.3,53.1,11.5,-41.6,2.7,2.8,0.0999999999999996,1.1,6,4.9,0.5,5,4.5,20,20.5,0.5,0.2,0.2,0,4.6,1.3,-3.3,0.6,2.2,1.6,3.7,10.7,7,4.2,6.9,2.7,414.2,314.4,-99.8,137.8,102.2,-35.6,0,0.8,0.8,26.9,15.9,-11,0,0.2,0.2,0,0.2,0.2,2253,719.8,-1533.2,,,,11.1,12,0.9,26.1,7.7,-18.4,0.9,1.5,0.6,7.8,2.2,-5.6,0.5,6.5,6,,,,,,,,,,0.2,0.4,0.2,41,77.2,36.2,57.7,11.6,-46.1,26.2,10.2,-16,267.5,213.8,-53.7,15.9,11.8,-4.1,16.8,24.8,8,8.6,30.1,21.5,476,0.7,-475.3,10.5,0.5,-10,271,316.9,45.9,0,0,0,0,0.3,0.3,20.5,28.2,7.7,176,54.3,-121.7,,,,1157.3,526.5,-630.8,58.3,55.2,-3.09999999999999,88.8,187.8,99,22.1,6.2,-15.9,81.6,18.3,-63.3,31.1,40.7,9.6,0.1,0.3,0.2,878.1,278.7,-599.4,207,51.6,-155.4,16.1,1.9,-14.2,231.1,16.1,-215,194.3,24.1,-170.2,49.6,2.6,-47,1271.4,376.4,-895,103.8,30.7,-73.1,0.2,0,-0.2,89.9,1.4,-88.5,1848.7,688.6,-1160.1,1204.5,1434.2,229.7,938.6,185.4,-753.2,0,0,0,42.5,7.5,-35,940.4,556.8,-383.6,116.6,3.2,-113.4,0.2,0.1,-0.1,8.4,0.4,-8,8975.3,1487,-7488.3,16.3,0.6,-15.7,0,0,0,2843.8,1773.7,-1070.1,930.3,1144.7,214.4,2805.3,1513.1,-1292.2,10317.6,4307.8,-6009.8,581.7,890.2,308.5,0,0,0,0,0.1,0.1,0,0.2,0.2,0,0,0,3.2,1.7,-1.5,194.4,125.8,-68.6,0,0,0,3.3,0.6,-2.7,0,0.1,0.1,0.8,0.9,0.1,0,0.1,0.1,0.1,0.1,0,0,0.9,0.9,0.1,0.2,0.1,0,0,0,1.6,2,0.4,0,0,0,2.7,6.4,3.7,0.2,1.4,1.2,3,1.5,-1.5,2.2,1.1,-1.1,0,0.1,0.1,15,1.4,-13.6,0.7,0.8,0.1,30.8,18.5,-12.3,194.7,87,-107.7,6.9,16.3,9.4,38.376419,3.521357,-34.855062,81.1,362.3,281.2,0.3,0.1,-0.2,,,,0,0,0,69.9,4.1,-65.8,0,2.8,2.8,18.4,5.6,-12.8,0.3,3.2,2.9,0.2,2.1,1.9,7.2,5.5,-1.7,0.9,0.8,-0.1,13.4,10.8,-2.6,15.5,14.3,-1.2,0,1.2,1.2,0.2,2,1.8,1.8,1.9,0.0999999999999999,870.5,73.3,-797.2,0,0.2,0.2,125.7,4.4,-121.3,0.6,5,4.4,0.2,0.6,0.4,0.1,0.1,0,0.1,3.2,3.1,207.9,22.4,-185.5,46.3,4.5,-41.8,0,0,0,0.1,0.1,0,0,0,0,4.6,2.3,-2.3,23.4,0.5,-22.9,0.3,0.3,0,0.3,0.6,0.3,0,0,0,2,10.7,8.7,0,0.5,0.5,0,4,4,1.4,2.6,1.2,12.9,130.6,117.7,1.7,0.6,-1.1,0,0.1,0.1,1.7,4.3,2.6,23.1,2.4,-20.7,0.3,1,0.7,26,0.4,-25.6,0,0.1,0.1,0,0,0,0,0.6,0.6,0.2,0.1,-0.1,381.8,188.9,-192.9,1.4,14,12.6,1.3,4,2.7,1.2,0.8,-0.4,9,0.8,-8.2,6.2,2.1,-4.1,5.3,1.1,-4.2,26.4,0.3,-26.1,0,19.2,19.2,0,0,0
2001-08-01,4932.5,1530.4,-3402.1,18010.5,12844.9,-5165.6,92569,59648,-32921,7152.5,0,-7152.5,9941.4,5330.7,-4610.7,15416,15753,337,7693.7,5641.4,-2052.3,5960.2,5147.5,-812.7,29565.7,22787.7,-6778,20063.626723,14123.369858,-5940.256865,2019.853757,991.251651,-1028.602106,32654.2,14730.5,-17923.7,96727.7,60111.4999999999,-36616.2000000001,38338.2,15995.3,-22342.9,,,,777.9,1041.4,263.5,1717.4,591.4,-1126,2.3,0.6,-1.7,18001,13764.2,-4236.8,0,0,0,11564.7,9023.4,-2541.3,234.5,150.2,-84.3,8.6,17.9,9.3,164.9,141.8,-23.1,261.3,209.6,-51.7,61.1,45.1,-16,244.1,210.4,-33.7,23,102.3,79.3,1.4,27.9,26.5,35.4,122.5,87.1,0,0.3,0.3,36.3,121,84.7,0.8,8.6,7.8,0.8,20.8,20,23.4,47.8,24.4,385.8,371,-14.8,0.2,1.4,1.2,1,5.2,4.2,3.3,3.8,0.5,0.3,7,6.7,0.1,0.5,0.4,1.6,2.3,0.7,11.7,10.5,-1.2,2.4,3.6,1.2,1.8,9.6,7.8,2.3,26.9,24.6,204,163.9,-40.1,36.1,55.7,19.6,,,,,,,86.2,30.7,-55.5,1.1,3.2,2.1,0.1,2.2,2.1,514.7,319.3,-195.4,1299.7,511,-788.7,13.7,12.2,-1.5,7.4,14.3,6.9,0,1.8,1.8,160.7,95.1,-65.6,181.4,140.6,-40.8,20.1,20.9,0.799999999999997,236.8,252.9,16.1,1428.4,1476.2,47.8,4,38.2,34.2,21.2,34.5,13.3,238.3,306.6,68.3,0.2,0.1,-0.1,16.4,9.7,-6.7,528.1,276.7,-251.4,0,0.1,0.1,387.2,106.1,-281.1,246,114.8,-131.2,1,9.7,8.7,270.6,124.8,-145.8,3171.7,3252.2,80.5,1359.5,532,-827.5,744.5,1530.3,785.8,639.6,1188.5,548.9,24.1,203.9,179.8,0,0.4,0.4,0.9,0.6,-0.3,2363.7,1404,-959.7,5055.2,2389.2,-2666,322.9,225.4,-97.5,,,,100.7,42.6,-58.1,19.4,4.4,-15,262.4,54.7,-207.7,20.3,0.6,-19.7,681.1,514.9,-166.2,19.1,5.8,-13.3,6,6.5,0.5,9.2,9,-0.199999999999999,74.5,63.9,-10.6,,,,449.8,185.5,-264.3,16.2,1.5,-14.7,67.7,22.1,-45.6,3.2,2.9,-0.3,1.2,7.2,6,0.6,6.8,6.2,18.5,16.9,-1.6,0.2,1.7,1.5,7.4,2.4,-5,0.1,1,0.9,3.2,75.6,72.4,10.9,21.7,10.8,433.3,427.5,-5.80000000000001,161.8,103.1,-58.7,0,5.7,5.7,27.7,18.4,-9.3,0.1,0,-0.1,0,0.2,0.2,2105,735.4,-1369.6,,,,13.5,3.1,-10.4,24.9,6.8,-18.1,1,2.1,1.1,7.8,2.9,-4.9,0.5,3.9,3.4,,,,,,,,,,0.4,1.1,0.7,39.7,119.4,79.7,57,31.1,-25.9,34.4,4.3,-30.1,252.5,236.7,-15.8,0.9,5.5,4.6,18.6,21,2.4,15.1,36.2,21.1,414.6,4.5,-410.1,9.6,0.2,-9.4,233.4,293.2,59.8,0.8,0,-0.8,0,0,0,28.7,27.4,-1.3,193.9,49,-144.9,,,,1256.1,406.1,-850,38.2,25.2,-13,85.8,209.7,123.9,65.5,17.5,-48,97.5,19.1,-78.4,26,70,44,0,0.3,0.3,951.9,340.8,-611.1,219.1,46.1,-173,13.8,2.4,-11.4,257.8,23.5,-234.3,172.5,9,-163.5,47,1.1,-45.9,1319.4,405.1,-914.3,119,38.6,-80.4,0.3,0.3,0,89.1,1.4,-87.7,1894.5,700.4,-1194.1,1203.4,1370,166.6,925.9,197.5,-728.4,0,0,0,60.5,7.9,-52.6,937.7,622.4,-315.3,129.2,5.4,-123.8,0,0,0,6.4,0.2,-6.2,10042.9,1929.7,-8113.2,14.7,0.4,-14.3,0,0,0,2753.6,1746.9,-1006.7,909.6,1162.3,252.7,2827,1362.1,-1464.9,10218.8,4604,-5614.8,566.8,891.3,324.5,0,0,0,0.1,1.8,1.7,0,0.2,0.2,0,0,0,5.1,1.9,-3.2,179.2,128.7,-50.5,0,0.1,0.1,0.1,0.2,0.1,0,0,0,1.1,0.8,-0.3,0.1,0.1,0,0,0,0,0,0.3,0.3,0.1,0.2,0.1,0,0,0,2.7,1.8,-0.9,0,0.1,0.1,3.4,5.3,1.9,0.3,2.2,1.9,2.7,2.1,-0.6,0.3,1.6,1.3,0,0.2,0.2,15.3,1.7,-13.6,0.6,0.7,0.1,41.4,27,-14.4,181.7,51.1,-130.6,14.5,16.6,2.1,51.827427,2.227829,-49.599598,64.6,305,240.4,0.6,1.7,1.1,,,,0,0,0,24.6,14.9,-9.7,0,0.7,0.7,1.7,4.5,2.8,3.2,5.1,1.9,0.2,1.2,1,6.4,8.6,2.2,0.8,1.1,0.3,11.6,11.2,-0.4,18.4,17.2,-1.2,0,0.5,0.5,0.2,5.8,5.6,0.2,1.3,1.1,527.1,76.3,-450.8,0.1,1.4,1.3,163.5,3.4,-160.1,0.7,38.1,37.4,0.1,0.1,0,0,0.7,0.7,0.3,3.2,2.9,332.5,23.1,-309.4,53.8,3.1,-50.7,0,0,0,0.1,0.2,0.1,0,0.1,0.1,3.4,4.2,0.8,27.1,1.4,-25.7,0,0.1,0.1,1,0.5,-0.5,0.1,1.2,1.1,3.6,4.7,1.1,0,4.6,4.6,0,5.9,5.9,1.3,1.7,0.4,11,28.3,17.3,0.7,1.2,0.5,0,0,0,3.1,3.8,0.7,28.9,3.1,-25.8,0,1,1,37.5,0.6,-36.9,0,0,0,0,0,0,0.1,0.1,0,0,0.1,0.1,405.5,263.8,-141.7,1.1,37.9,36.8,1.9,1.5,-0.4,1.5,1.4,-0.1,3.8,0.6,-3.2,5.5,1.7,-3.8,12.4,0.8,-11.6,22.7,0,-22.7,0,24.5,24.5,0,0,0
2001-09-01,4872,1577.2,-3294.8,15676.7,12250.4,-3426.3,90957,56375,-34582,6610.2,0,-6610.2,9066.8,4972,-4094.8,14773,14804,31,7323.3,6119.5,-1203.8,5275.8,4308.8,-967,27385.5,20123.3,-7262.2,17692.727094,13289.356233,-4403.370861,2053.204104,902.076101,-1151.128003,31070.2,14331,-16739.2,89483.4,55232.1,-34251.3,36296.2,15491,-20805.2,,,,776.1,1087.3,311.2,1773.5,541.9,-1231.6,3.6,0.1,-3.5,16698.1,12423,-4275.1,0.3,0,-0.3,10687.4,7700.4,-2987,180.2,140.8,-39.4,3.9,13.4,9.5,163.5,139.7,-23.8,239.3,200.4,-38.9,51.5,29.4,-22.1,241.3,175,-66.3,16.6,103.4,86.8,4.5,23.2,18.7,23.5,65.4,41.9,0,0.2,0.2,42.2,94.9,52.7,0.5,6,5.5,2.9,16.6,13.7,19.3,45,25.7,350.1,334.5,-15.6,0.2,1.8,1.6,0.6,6.4,5.8,2.7,3.3,0.6,0.2,5.5,5.3,0,0.6,0.6,0.9,2.6,1.7,2.1,6.2,4.1,8.4,2.9,-5.5,2,4.6,2.6,2.2,22.7,20.5,170.8,88.5,-82.3,44.2,28.6,-15.6,,,,,,,77.3,18.8,-58.5,0.8,3.1,2.3,0.1,1,0.9,518.2,241.5,-276.7,991.8,416.3,-575.5,7.6,11.2,3.6,14.8,10.9,-3.9,0,0.2,0.2,146.4,103.5,-42.9,157.7,116,-41.7,13.1,16.6,3.5,256.9,235.4,-21.5,1209.1,1249.4,40.3000000000002,4.4,25,20.6,13.6,28.6,15,290.8,269.7,-21.1,0,0,0,19.3,10.1,-9.2,662.9,258.6,-404.3,0,0,0,429.3,97.8,-331.5,212,150.3,-61.7,0.5,0.3,-0.2,328.8,113.4,-215.4,2746.8,3156.5,409.7,1693,503.4,-1189.6,690.2,1363.1,672.9,699.6,1046.2,346.6,18.5,23.7,5.2,0,0.6,0.6,0.9,2.3,1.4,1872.9,1613,-259.9,4147.3,2255.1,-1892.2,281.1,194.2,-86.9,,,,73.7,43.8,-29.9,15.2,6.3,-8.9,149.9,52.9,-97,19.8,0.4,-19.4,624.3,400.9,-223.4,9.6,5.1,-4.5,4.3,7.1,2.8,11.9,8.3,-3.6,65.7,58.1,-7.6,,,,445.3,196.4,-248.9,8.9,3,-5.9,115.1,13.4,-101.7,2.7,8.2,5.5,0.7,7,6.3,0.5,5.6,5.1,23.2,12.1,-11.1,0,0.7,0.7,5.8,4.8,-1,0.6,0.3,-0.3,2,14.5,12.5,8.1,10.7,2.6,358.5,488.7,130.2,97.5,92.2,-5.3,0,0.2,0.2,34.6,11.5,-23.1,0.1,0.5,0.4,0,0,0,1448.3,723.9,-724.4,,,,9.6,11.5,1.9,19,8.2,-10.8,0.7,2.7,2,6.3,5.7,-0.6,0.3,2.7,2.4,,,,,,,,,,0.7,0.5,-0.2,34.4,52.1,17.7,39.2,30.8,-8.4,35,11.3,-23.7,217.1,183.9,-33.2,0.9,14.8,13.9,7.4,15.3,7.9,11.7,20.2,8.5,681.4,5.3,-676.1,8.7,0.3,-8.4,224.4,254.5,30.1,0.7,0,-0.7,0,0,0,23,26.7,3.7,142.5,86.5,-56,,,,1124.3,520.5,-603.8,38.2,18.1,-20.1,123.9,188.7,64.8,24.8,4.1,-20.7,17.3,25.9,8.6,28,34.7,6.7,0,0.1,0.1,857,300.3,-556.7,183.4,51.7,-131.7,9.5,1.1,-8.4,207.4,19,-188.4,182.5,14.9,-167.6,46.2,0.5,-45.7,1257.5,362.5,-895,89,33.1,-55.9,0.3,0,-0.3,82.6,1,-81.6,1771.3,677.9,-1093.4,1065.9,1523.1,457.2,770.7,172.6,-598.1,0.1,0,-0.1,25,10.5,-14.5,929.6,572.6,-357,111.8,4.1,-107.7,0.1,0,-0.1,8.3,0.2,-8.1,9927.8,1427.8,-8500,16.1,1.8,-14.3,0,0,0,2782,2000.3,-781.7,914.9,1216.5,301.6,2560.5,1379.7,-1180.8,9456.8,4336.3,-5120.5,597.1,883.7,286.6,0,0,0,0,0.3,0.3,0.1,0.1,0,0,0,0,4.8,0.9,-3.9,151.9,124.9,-27,0,0,0,0.6,0.7,0.1,0,0,0,0.6,59,58.4,0.1,0.1,0,0,0.1,0.1,0,0.3,0.3,0.1,0.2,0.1,0,0,0,1.2,1.7,0.5,0,0,0,2.4,6.9,4.5,0.1,2.4,2.3,1.7,2.1,0.4,0.1,1.2,1.1,0,0.2,0.2,14.8,2.1,-12.7,0.5,0.4,-0.1,39.3,19.6,-19.7,164.2,97,-67.2,21.5,20.2,-1.3,82.006497,6.061796,-75.944701,54.3,218.6,164.3,0,0,0,,,,0,0,0,85,4.8,-80.2,0,8.1,8.1,9.5,6.1,-3.4,0.8,4.4,3.6,0.2,1.6,1.4,4,7.8,3.8,0.3,2,1.7,12.4,6,-6.4,13.7,21.6,7.9,0,0.6,0.6,0,4.5,4.5,0.1,0.8,0.7,826.2,67.6,-758.6,0,0.3,0.3,124.5,26.8,-97.7,0.5,14,13.5,0,0,0,0,0.2,0.2,0,3.3,3.3,209.7,20.6,-189.1,27,1.8,-25.2,0,0.1,0.1,0.1,0,-0.1,0,0,0,4.1,3.8,-0.3,1.9,2.5,0.6,0,1.2,1.2,1,1.1,0.1,0,1,1,0.9,8.8,7.9,0,3.3,3.3,0,0.4,0.4,0.8,1.2,0.4,10.2,11.2,1,2,6.4,4.4,0,0,0,1.6,5.7,4.1,28.3,1.3,-27,0.1,3.2,3.1,26.7,0.7,-26,0,0,0,0.9,0.6,-0.3,0.1,0.2,0.1,0,0,0,332.8,242.3,-90.5,4.2,44.8,40.6,3.8,1.6,-2.2,0.4,0.7,0.3,9,0.3,-8.7,5.5,1.3,-4.2,5.6,0.7,-4.9,18,0.3,-17.7,0,30.2,30.2,0,0,0
2001-10-01,4717,1623.6,-3093.4,20810.4,13317.2,-7493.2,91322,56987,-34335,7292.6,0,-7292.6,9784.7,5431.5,-4353.2,17016,15677,-1339,8260.5,5727,-2533.5,5332.8,4649.9,-682.900000000001,29451,23168.1,-6282.9,22976.790088,14695.610415,-8281.179673,1992.172392,1317.460814,-674.711578,35269.9,14384,-20885.9,101176.8,60700.8,-40476,40619.1,15681,-24938.1,,,,801.9,1121.1,319.2,1718.1,528.9,-1189.2,2.6,0.2,-2.4,17542.4,13894.7,-3647.7,0.3,0,-0.3,11908.5,9273.4,-2635.1,197.8,163.3,-34.5,4.8,15.3,10.5,171.3,145,-26.3,267.8,195.3,-72.5,49.9,33.7,-16.2,235.6,218.6,-17,25.5,113.7,88.2,2,27.9,25.9,35.3,70.2,34.9,0,0.1,0.1,40.4,133.5,93.1,0.4,5.9,5.5,0.3,21.1,20.8,23.9,44.2,20.3,386.6,379.7,-6.90000000000003,0,2.2,2.2,1.2,4.8,3.6,4.6,3.2,-1.4,0,9,9,0,0.5,0.5,0.3,2.4,2.1,1.7,5.6,3.9,5.5,5,-0.5,5.3,3.7,-1.6,3.5,25.6,22.1,139.4,95.6,-43.8,46.5,60,13.5,,,,,,,42.3,28.9,-13.4,1.7,5.1,3.4,0,1.2,1.2,434.3,303,-131.3,1160.2,499.1,-661.1,14,10.5,-3.5,7.1,14.6,7.5,0,0.5,0.5,185.5,126,-59.5,161.5,139.8,-21.7,15.3,28.7,13.4,218,251.8,33.8,1174.6,1134.4,-40.1999999999998,5.4,26,20.6,18.8,29.1,10.3,242.4,266,23.6,2,0,-2,20.7,14.5,-6.2,828.8,255.6,-573.2,0,0,0,428.1,101.1,-327,304.4,124.9,-179.5,0.8,0,-0.8,329.1,120.8,-208.3,3918.9,3190.2,-728.7,2040.1,781.4,-1258.7,888.8,1500.9,612.1,993.2,1016.1,22.9,21,27.5,6.5,0,0.9,0.9,1.2,0.2,-1,2714.4,1699.9,-1014.5,5037.2,2370.8,-2666.4,347.4,225.7,-121.7,,,,90,42.6,-47.4,21.9,4,-17.9,358.2,70.5,-287.7,19.9,0.2,-19.7,827.8,650.4,-177.4,18.3,5,-13.3,6.4,8.3,1.9,24,11.1,-12.9,90.9,69.5,-21.4,,,,431.7,208.6,-223.1,11.2,2.1,-9.1,41,15.7,-25.3,3.2,4.8,1.6,0.7,6.9,6.2,2.7,6.4,3.7,20.5,12.6,-7.9,0.2,5.8,5.6,12.2,12.4,0.200000000000001,0.3,3.3,3,3,36.9,33.9,3.3,24.7,21.4,426,525.2,99.2,118.8,102.7,-16.1,0.1,0.4,0.3,26.5,25.4,-1.1,0.1,0.1,0,0,0.4,0.4,2133.2,960.8,-1172.4,,,,8.1,6.1,-2,25,9.7,-15.3,0.9,2.5,1.6,9.2,4.5,-4.7,0.8,2.8,2,,,,,,,,,,0.3,2,1.7,46,153.6,107.6,41,26.4,-14.6,27.9,6.8,-21.1,249.7,218.6,-31.1,1.7,15.2,13.5,4.8,20.7,15.9,4.8,39.8,35,716.9,8.4,-708.5,13.9,0.1,-13.8,273.3,256.8,-16.5,1.3,0,-1.3,0,0,0,23,31.1,8.1,150.9,77.9,-73,,,,849.4,397.9,-451.5,22.1,26.9,4.8,69.6,267.5,197.9,0.5,37.3,36.8,11.8,25.2,13.4,27.7,28.9,1.2,0,1.5,1.5,905.9,290.8,-615.1,224.3,64.7,-159.6,12.7,0.8,-11.9,212.4,41,-171.4,175.8,18.2,-157.6,36.3,0.6,-35.7,1394.2,452.5,-941.7,124.2,40.6,-83.6,0.2,2,1.8,88.6,3,-85.6,2118.4,715.1,-1403.3,1289.1,1765.8,476.7,898.9,212,-686.9,0,0,0,42.7,5.7,-37,1057.7,624.5,-433.2,130.9,4,-126.9,0.2,0.1,-0.1,8.8,0.4,-8.4,10808.3,1647.7,-9160.6,15.6,1.4,-14.2,0,0,0,3159,1532.3,-1626.7,922.2,1063.9,141.7,2890.2,1365.1,-1525.1,11186.9,4352,-6834.9,591.9,936.7,344.8,0.2,0,-0.2,0.2,0,-0.2,0,0.2,0.2,0,0,0,4.2,5.1,0.899999999999999,169.6,154.1,-15.5,0,0.1,0.1,0.6,1,0.4,0,0,0,0.6,0.9,0.3,0.2,0.6,0.4,0.1,0.1,0,0.1,0.7,0.6,0.1,0.1,0,0,0.025,0.025,0.1,1.8,1.7,0,0,0,3.5,9.2,5.7,0,3.4,3.4,1.6,2.2,0.6,1,1.4,0.4,0,0.5,0.5,27.3,2.6,-24.7,0.7,0.4,-0.3,33.2,20.6,-12.6,171.8,51.8,-120,4,22.6,18.6,102.306808,2.634857,-99.671951,65.1,692.7,627.6,0.1,5,4.9,,,,0,0,0,61.9,4.7,-57.2,0.1,2,1.9,13.8,15.1,1.3,41.8,6.8,-35,1.8,2.3,0.5,6.1,6.1,0,0.2,2.3,2.1,8,8.5,0.5,11,22.5,11.5,0.1,0.4,0.3,0,3.1,3.1,0.1,0.9,0.8,663.2,82,-581.2,0.1,0.5,0.4,134.5,4,-130.5,0.1,10.5,10.4,0.1,0.3,0.2,0,0.7,0.7,0.3,4,3.7,241.5,16.1,-225.4,48.4,6.6,-41.8,0,0.1,0.1,0.1,0,-0.1,0,0.2,0.2,3.6,3.4,-0.2,9.4,0.9,-8.5,0.1,0.9,0.8,1.1,2.4,1.3,0,0.4,0.4,2.1,22.5,20.4,0,4.1,4.1,0.1,1,0.9,3.1,3.3,0.2,11.5,23,11.5,2.8,0.6,-2.2,0.1,0,-0.1,2,9.1,7.1,27.1,1.3,-25.8,0.1,1.8,1.7,27.7,2.3,-25.4,0,0,0,0.1,0,-0.1,0.1,0.1,0,0,0.1,0.1,340,249,-91,1.2,11.5,10.3,3.2,1.8,-1.4,1.8,0.8,-1,5.2,0.9,-4.3,7.7,2,-5.7,14.2,0.8,-13.4,20.7,0,-20.7,0,68,68,0,0,0
2001-11-01,3777.5,1597.2,-2180.3,18664.4,12399.8,-6264.6,89979,56711,-33268,6884.9,0,-6884.9,9457.3,4872.1,-4585.2,16161,14923,-1238,7595.4,5771.2,-1824.2,4992.9,4765.7,-227.2,28043.3,21560,-6483.3,20677.83537,13873.833762,-6804.001608,1516.02362,958.254727,-557.768893,31152.5,14280.5,-16872,91705.3,57900,-33805.3,35745.4,15623.5,-20121.9,,,,725,1052.4,327.4,1236.1,486.3,-749.8,4.4,0.1,-4.3,17170.2,13214,-3956.2,0.3,0,-0.3,10873.1,8346,-2527.1,194.1,185.9,-8.19999999999999,5.1,15,9.9,145.9,151.8,5.90000000000001,266.9,181,-85.9,41.7,30.8,-10.9,250.3,229.6,-20.7,30.9,118.1,87.2,2.1,26.1,24,31.6,106.4,74.8,0,0.1,0.1,43.6,118.6,75,3.2,5.3,2.1,0.5,22.6,22.1,20.4,38.2,17.8,350.5,346.9,-3.60000000000002,0.1,1.4,1.3,1.6,5.3,3.7,4.3,3,-1.3,0.1,8.5,8.4,0,0.4,0.4,0.2,2,1.8,1.4,7,5.6,0.4,3.8,3.4,1.7,5.2,3.5,5.8,24.6,18.8,123,97.6,-25.4,40.6,68.8,28.2,,,,,,,44.9,20.1,-24.8,1.8,3.6,1.8,0,1.7,1.7,391.9,266.4,-125.5,964.5,481,-483.5,12.9,14.1,1.2,8.7,13.7,5,0,3.7,3.7,113.9,137.4,23.5,170.7,134.8,-35.9,13.1,13.4,0.300000000000001,253.2,227.4,-25.8,1182.6,1344.4,161.8,2.4,24.5,22.1,15.4,29.1,13.7,251.1,246.3,-4.79999999999998,0,0.1,0.1,30.9,12.8,-18.1,740.7,248.6,-492.1,0,0,0,436,104.1,-331.9,322.1,124.7,-197.4,1.3,5.6,4.3,274.5,108.6,-165.9,3475.9,2935.9,-540,1802.1,531.7,-1270.4,774.6,1614.2,839.6,739.2,1063.6,324.4,23.4,20.5,-2.9,0,0.5,0.5,0.8,0.1,-0.7,2469.3,1643.8,-825.5,4581.6,2173.1,-2408.5,373.9,220.8,-153.1,,,,90.2,65.8,-24.4,19.2,5.9,-13.3,388.3,55.4,-332.9,13.3,0.6,-12.7,764.5,706.6,-57.9,7.2,7,-0.2,7.7,6.8,-0.9,10.6,10.2,-0.4,77.2,62.9,-14.3,,,,377.9,262.7,-115.2,7.7,3.1,-4.6,37.4,15.4,-22,2.4,2.6,0.2,0.8,3,2.2,0.5,5.3,4.8,12.1,15.8,3.7,0,1.9,1.9,5.7,4.9,-0.8,0.1,1.3,1.2,3.3,1.6,-1.7,3.9,16.7,12.8,421.7,522.4,100.7,113.1,93.5,-19.6,0.4,0.5,0.1,26,22.4,-3.6,0,0.6,0.6,0,0.1,0.1,1857.4,769.9,-1087.5,,,,6.1,14.6,8.5,21.2,11.4,-9.8,0.6,4.6,4,17.6,1.7,-15.9,0.4,11.3,10.9,,,,,,,,,,0.4,2.5,2.1,45.9,71.8,25.9,32,30.4,-1.6,33.2,5.8,-27.4,224,237.2,13.2,1.4,9.1,7.7,4.7,32,27.3,4.1,31.6,27.5,438.2,2.2,-436,11.2,4,-7.2,278.3,225.3,-53,1.7,0,-1.7,0,0.4,0.4,17.3,27.6,10.3,112.9,77.4,-35.5,,,,822.3,480.9,-341.4,23.2,32.5,9.3,67.7,199.7,132,0.6,15.4,14.8,19,20,1,41.1,28,-13.1,0.1,0.9,0.8,736.7,304.3,-432.4,189,50.6,-138.4,12.4,1,-11.4,137,31.4,-105.6,121.4,18,-103.4,25.4,1,-24.4,1225.4,433.8,-791.6,93,54.4,-38.6,0,0.5,0.5,73.1,2.6,-70.5,1940.7,719.5,-1221.2,1287.7,1475.2,187.5,771,198,-573,0,0,0,20.9,6.6,-14.3,876.4,590.2,-286.2,86.7,3.9,-82.8,0,0.1,0.1,6.2,0.2,-6,8878.8,1674.5,-7204.3,10.1,0.6,-9.5,0,0,0,3010.2,1858.3,-1151.9,712,1024.1,312.1,2585.5,1413.7,-1171.8,10288.4,4286.8,-6001.6,542.2,879.1,336.9,0,0,0,0.3,0.3,0,0,0.1,0.1,0,0,0,3,1.8,-1.2,149,148.9,-0.0999999999999943,0,0,0,0.3,1,0.7,0,0,0,0.5,0.9,0.4,1.7,0.5,-1.2,0.2,0.1,-0.1,0,0.8,0.8,0.1,1.5,1.4,0.007236,0.048885,0.041649,1.6,1.3,-0.3,0,0,0,3.9,7.5,3.6,0,2.3,2.3,0.6,2.2,1.6,0.1,1.8,1.7,0,0.2,0.2,20.8,2.2,-18.6,0.7,0.4,-0.3,36.8,22.2,-14.6,177.7,48.6,-129.1,12.7,16.6,3.9,49.404736,2.633289,-46.771447,52.6,384.3,331.7,0,2.6,2.6,,,,0,0,0,18.8,5.5,-13.3,0,1.9,1.9,4.6,8.6,4,45.5,10.9,-34.6,0.4,0.9,0.5,1.9,5.8,3.9,0.4,1,0.6,35.4,6.1,-29.3,6.4,8.9,2.5,0,2,2,0.1,2.8,2.7,0.2,1.2,1,388.9,72.9,-316,0.1,0.5,0.4,103.1,2.5,-100.6,0.2,32,31.8,0.1,0.1,0,4.5,0.4,-4.1,0,3.2,3.2,152,26.1,-125.9,12.3,7,-5.3,0,0.2,0.2,0.3,0.1,-0.2,0,0,0,3.8,3,-0.8,8.2,5.2,-3,0.1,0.4,0.3,1,0.4,-0.6,0.1,0.2,0.1,3.5,32.8,29.3,0,0.6,0.6,0,1.4,1.4,0.7,1.2,0.5,7.7,16.4,8.7,2.9,48.2,45.3,0,0,0,4.3,8.2,3.9,15.2,2.9,-12.3,5.4,1.8,-3.6,11.4,2.4,-9,0,0,0,1.7,0,-1.7,0.1,0.2,0.1,0,0,0,333.5,171.6,-161.9,1.9,3.9,2,3.1,5.8,2.7,0.9,1,0.1,9.6,0.7,-8.9,8.8,2.6,-6.2,15.5,0.3,-15.2,21.3,0,-21.3,0,66.1,66.1,0,0,0
2001-12-01,3486.6,1586.3,-1900.3,17043.7,12821,-4222.7,86527,56069,-30458,5844.4,0,-5844.4,7907.1,4120.1,-3787,14886,15112,226,6800,5394.9,-1405.1,4726.6,4288.5,-438.1,24460.7,18656.5,-5804.2,18734.902033,14179.748536,-4555.15349699999,1543.440839,856.293394,-687.147445,27439,14474.9,-12964.1,81702.9,55002.4,-26700.5,31555.8,15803,-15752.8,,,,678.6,1191.9,513.3,1281.1,532.8,-748.3,2.4,0,-2.4,15132,11319.3,-3812.7,0.7,0,-0.7,9328.7,7337.3,-1991.4,188.2,147.6,-40.6,5,12.1,7.1,160.2,170.5,10.3,245.4,188.6,-56.8,37.7,36.4,-1.3,221.9,209.6,-12.3,17.5,110.7,93.2,0.9,23.4,22.5,38.4,77.5,39.1,0,4.8,4.8,37.1,109.3,72.2,0.3,5.1,4.8,0.6,19.9,19.3,17.2,43.3,26.1,316.8,321.6,4.80000000000001,0.1,1.8,1.7,0.8,5.7,4.9,3.8,2.7,-1.1,0.4,5.1,4.7,0,0.4,0.4,0.2,2.3,2.1,1,6.3,5.3,0,3.1,3.1,0.5,3.4,2.9,2.6,21,18.4,131.2,83.9,-47.3,27.7,58.3,30.6,,,,,,,13.3,32.8,19.5,1,7.6,6.6,0,1.9,1.9,364.4,281.4,-83,877.9,400.1,-477.8,13.4,8.7,-4.7,15.9,10.9,-5,0,0.7,0.7,141.2,137.2,-4,138.7,123.9,-14.8,13.5,19.1,5.6,330.5,218.8,-111.7,1122.9,1099.6,-23.3000000000002,2.4,33.3,30.9,15.9,28.8,12.9,219.7,209,-10.7,0,0,0,18,10.9,-7.1,780.5,260.4,-520.1,0,0,0,247.2,218.5,-28.7,271.7,119.8,-151.9,0.6,0.1,-0.5,222.9,111.4,-111.5,2889.1,2952.3,63.2000000000003,1229.9,643.4,-586.5,774.2,1668,893.8,795.9,989,193.1,22.2,16.2,-6,0.1,0.6,0.5,1.1,0.7,-0.4,2532.5,1570.2,-962.3,4386.6,2452.9,-1933.7,326.4,230.6,-95.8,,,,81.1,57.8,-23.3,20.2,6.4,-13.8,179.4,47.5,-131.9,16.3,0.6,-15.7,648.1,580.2,-67.9,12.9,3.8,-9.1,6.2,10.5,4.3,13.4,13.4,0,87.1,85.3,-1.8,,,,403.2,207,-196.2,8.2,2.3,-5.9,37.2,11.3,-25.9,2.7,4.8,2.1,0.6,7.3,6.7,8.7,3.3,-5.4,26.8,13.7,-13.1,0.1,4.5,4.4,7.5,1.5,-6,0.2,5.9,5.7,3.1,2.6,-0.5,3.5,4.1,0.6,393.5,455,61.5,88.6,93.9,5.30000000000001,0.1,0.4,0.3,34.4,26.2,-8.2,0.1,0.6,0.5,0,0.3,0.3,1836.6,790.3,-1046.3,,,,6.2,9.8,3.6,20.6,13.7,-6.9,1,11.5,10.5,3.5,1.3,-2.2,1.3,10.5,9.2,,,,,,,,,,0.6,4,3.4,36.3,197.2,160.9,27.5,27.7,0.199999999999999,24,6,-18,193.7,206.7,13,1.5,5.8,4.3,10.6,20.6,10,3.5,32.9,29.4,520.2,0,-520.2,10.5,0.1,-10.4,247.7,317.1,69.4,0.4,0,-0.4,0,0,0,24.1,34.9,10.8,65.5,98.4,32.9,,,,660.6,430.6,-230,26.5,18.4,-8.1,55.5,212.6,157.1,0.5,15.5,15,14.9,82.2,67.3,58.6,54.7,-3.9,0,1.5,1.5,661.4,337,-324.4,131.2,61,-70.2,7.5,1.3,-6.2,142.5,33.7,-108.8,128.3,15.4,-112.9,25.3,0.9,-24.4,1076.2,439.7,-636.5,96,40,-56,0.4,0.2,-0.2,62.7,7,-55.7,1713.7,920.2,-793.5,1015.4,1182.8,167.4,681.9,242.7,-439.2,0,0,0,9.9,2,-7.9,827.3,539,-288.3,80.6,6,-74.6,0.2,0.1,-0.1,7.1,0.3,-6.8,7409.1,1901.2,-5507.9,9.1,0.4,-8.7,0,0.5,0.5,2739.9,1775.8,-964.1,619.2,1097.8,478.6,2425.5,1338.5,-1087,9269,4295.6,-4973.4,478,995.7,517.7,0,0,0,0.1,0.1,0,0,0,0,0,0,0,2.7,1.7,-1,166.8,175.9,9.09999999999999,0.2,0,-0.2,0.3,0.9,0.6,0,0,0,0.6,1,0.4,0.1,0.2,0.1,0.1,0.1,0,0,0.4,0.4,0.1,0.3,0.2,0,0.002687,0.002687,2,1.6,-0.4,0,0,0,6.5,6.1,-0.4,4.6,1.8,-2.8,1.6,2.1,0.5,1.8,2.5,0.7,0,0.1,0.1,12.4,1.2,-11.2,0.7,0.4,-0.3,22.7,29,6.3,186.2,84.7,-101.5,4.1,19.4,15.3,7.657663,9.623766,1.966103,48.6,189.8,141.2,0,0,0,,,,0,0,0,67.3,5,-62.3,0,0.6,0.6,6.8,4.4,-2.4,6.2,6.6,0.399999999999999,0.3,3.2,2.9,1.8,4.9,3.1,0.2,2.4,2.2,69.1,8.2,-60.9,14.3,10.7,-3.6,0,0.7,0.7,0,4.8,4.8,0.1,1.9,1.8,401.7,98.6,-303.1,0.1,0.1,0,110.2,4.7,-105.5,0.5,12.8,12.3,0.8,0.1,-0.7,0.2,0.4,0.2,0,1.1,1.1,139.4,24.6,-114.8,67.6,18.6,-49,0,0,0,0.1,0,-0.1,0,0,0,2.7,3,0.3,7.8,0.6,-7.2,0.2,0.1,-0.1,0.9,0.1,-0.8,0.1,2,1.9,4.4,10.7,6.3,0,1.9,1.9,0.2,0.8,0.6,0.7,5.3,4.6,13.2,18.9,5.7,2.4,1.2,-1.2,0,0.2,0.2,2,13.5,11.5,21,2.6,-18.4,0.2,4.7,4.5,13.7,4.4,-9.3,0,0,0,3.4,0,-3.4,0.1,0.2,0.1,0,0,0,282.9,228.1,-54.8,0.6,9.7,9.1,2.2,14.3,12.1,1.3,1.5,0.2,4.1,0.3,-3.8,7.8,2.3,-5.5,5.5,1.5,-4,20.3,0,-20.3,0,26.8,26.8,0,0,0
2002-01-01,3733.2,1238.1,-2495.1,16444.7,11619.6,-4825.1,89443,55939,-33504,6167.875933,0,-6167.875933,8457.412402,4371.2,-4086.212402,14780,13605,-1175,7275.4,5215.5,-2059.9,4844.9,3875.7,-969.2,26316.9,19795.6,-6521.3,18092.757388,12746.069128,-5346.68826,1579.748507,913.450809,-666.297698,28562.1,13256.4,-15305.7,85111.7,52667.2,-32444.5,33569.831294,14227.238494,-19342.5928,,,,704.9,1109.2,404.3,1316.6,429.9,-886.7,1.8,0,-1.8,16335.1,12061.5,-4273.6,0.6,0,-0.6,9981.9,7734,-2247.9,216.5,153.7,-62.8,4.3,10.4,6.1,146.1,121,-25.1,194.6,191.9,-2.69999999999999,49.8,24,-25.8,188.1,201.1,13,21.3,85.2,63.9,0.7,20.9,20.2,33.6,59.1,25.5,0,10,10,28.6,95.1,66.5,0.6,4.1,3.5,0.4,16.3,15.9,13.9,34.3,20.4,194.5,314.3,119.8,0,1.8,1.8,7.8,5.1,-2.7,2.9,3.3,0.4,0.1,5.1,5,0,0.4,0.4,1.3,2.4,1.1,1.2,5.5,4.3,1.1,3.5,2.4,0.4,4.2,3.8,2.1,19.4,17.3,131.3,64.5,-66.8,28.8,68.5,39.7,,,,,,,82,20.7,-61.3,0.4,3.7,3.3,0,1.6,1.6,413.8,271.3,-142.5,916.3,374.2,-542.1,11.3,6.4,-4.9,13.4,12.6,-0.800000000000001,0,2.9,2.9,140.2,122.9,-17.3,157.3,124.6,-32.7,16.4,11.2,-5.2,447.4,219.9,-227.5,1093,1016.1,-76.9,2.6,35.8,33.2,13.4,18.6,5.2,266.7,108,-158.7,0.6,0.1,-0.5,21,8.8,-12.2,581.2,250.9,-330.3,0,0.1,0.1,311.1,98.7,-212.4,229.9,93.3,-136.6,1.1,0.3,-0.8,250.5,144.5,-106,3046.1,2764.1,-282,1516.6,598.7,-917.9,679.2,1460.4,781.2,733.9,959,225.1,20.6,20.7,0.0999999999999979,0,0.5,0.5,0.6,0.8,0.2,2283.6,1543,-740.6,4194.7,2021.9,-2172.8,224.1,169.9,-54.2,,,,84.8,41.6,-43.2,16.4,4.2,-12.2,128.2,62.2,-66,17.6,9.7,-7.9,595.5,497.4,-98.1,15.7,2.7,-13,4.4,6.1,1.7,15.1,5.6,-9.5,78.4,50.9,-27.5,,,,316.9,185.5,-131.4,10.4,1.5,-8.9,21.8,11.2,-10.6,4.7,2.8,-1.9,0.7,3.2,2.5,0.7,7.8,7.1,23.2,12.4,-10.8,0.4,1.5,1.1,3.1,1,-2.1,0.3,3.7,3.4,4.2,1.3,-2.9,3.2,3,-0.2,436,502.3,66.3,98.3,101.3,3,0,0.3,0.3,24.1,16,-8.1,0.1,0.3,0.2,0,0,0,1730,713.6,-1016.4,,,,11.8,6.9,-4.9,18.9,10.1,-8.8,0.9,0.8,-0.1,11,3.1,-7.9,0.3,4.5,4.2,,,,,,,,,,1.5,3,1.5,32.9,64.4,31.5,35.9,16.4,-19.5,22.2,4.2,-18,227.9,235.8,7.90000000000001,1.4,12.1,10.7,3.3,24.5,21.2,4.9,36.1,31.2,554.5,0.8,-553.7,15.5,0.2,-15.3,1.2,0,-1.2,0.5,0,-0.5,0,0,0,29.2,22.7,-6.5,134,63.9,-70.1,,,,803.3,289.3,-514,27.1,19.5,-7.6,55.9,170.5,114.6,0.2,6.9,6.7,33.2,61.6,28.4,43.8,21.3,-22.5,0,0.5,0.5,960.3,282.7,-677.6,185.2,49.2,-136,14,2.7,-11.3,208.5,21.4,-187.1,178.1,6.8,-171.3,34.3,0.6,-33.7,1092,382,-710,101.7,35.1,-66.6,0.1,0.5,0.4,91.3,1.4,-89.9,1774.6,726.2,-1048.4,1198.7,1385.8,187.1,746.3,135.7,-610.6,0,0,0,14.4,3.6,-10.8,861.2,567.7,-293.5,115.8,4.4,-111.4,0,0.3,0.3,9.1,0.2,-8.9,8415.4,1569.3,-6846.1,10.8,0.5,-10.3,0,0,0,2755.5,1706.1,-1049.4,835.6,899.8,64.1999999999999,2485.6,1223.8,-1261.8,8674,3944.8,-4729.2,533.4,947.1,413.7,0.1,0,-0.1,0,0.1,0.1,0.1,0,-0.1,0.019405,0.001247,-0.018158,4.9,2.8,-2.1,146.7,139.2,-7.5,0,0.1,0.1,0.1,1.1,1,0,0,0,0.5,0.5,0,0,0.3,0.3,0,0,0,0,0.18526,0.18526,0.1,1.1,1,0,0.20242,0.20242,0.7,3.3,2.6,0,0.143219,0.143219,3.4,6.1,2.7,2.2,1.9,-0.3,1.4,1.8,0.4,1.1,1.9,0.8,0,0.1,0.1,9.6,1.3,-8.3,0.6,0.3,-0.3,32.9,149.9,117,151.8,68.6,-83.2,9.3,31.4,22.1,25.798963,3.35067,-22.448293,68.7,233.6,164.9,0,0.3,0.3,,,,0,0,0,30.9,5.6,-25.3,0.1,0.7,0.6,3.5,5.3,1.8,0.3,5.9,5.6,0.1,1.1,1,6.7,4.7,-2,0.3,3.1,2.8,49.7,7.4,-42.3,5.9,23.6,17.7,0,0.4,0.4,0,3.8,3.8,0.1,1.3,1.2,328.5,115.4,-213.1,0,0.1,0.1,123.6,3,-120.6,0.1,2.8,2.7,0.5,0.1,-0.4,0,0.4,0.4,0.1,2.5,2.4,213.9,18.9,-195,10,7.3,-2.7,0,0.2,0.2,0.3,0.7,0.4,0,0.1,0.1,3,3.2,0.2,3.4,3.7,0.3,0.1,0.1,0,0.5,0.2,-0.3,0.2,0.5,0.3,4.6,8.4,3.8,0,6.4,6.4,0.1,1.2,1.1,0.4,3.2,2.8,11.9,9.9,-2,3,0.6,-2.4,0,0,0,1.8,3.2,1.4,27.6,1.5,-26.1,0.3,6.8,6.5,41,0.8,-40.2,0,0,0,2.5,0,-2.5,0,0.2,0.2,0,0,0,377.6,158.9,-218.7,0.7,7.3,6.6,2.9,2.3,-0.6,0.4,0.9,0.5,6.5,0.3,-6.2,19.7,2.1,-17.6,6.5,0.6,-5.9,30,0,-30,0,0.1,0.1,0,0,0
2002-02-01,3297.6,1347.7,-1949.9,17043.8,12381.6,-4662.2,91539,55717,-35822,6323.12645,0,-6323.12645,9032.175844,4696.5,-4335.675844,14500,12959,-1541,6477.6,4618.9,-1858.7,4553.6,3958.9,-594.7,26202,19618,-6584,18708.670238,13839.274575,-4869.395663,1208.625421,979.180616,-229.444805,27778.6,12513.1,-15265.5,83472.6,53061.5,-30411.1,32248.027687,13607.197381,-18640.830306,,,,548.5,1058.6,510.1,990.6,427.6,-563,2.6,0,-2.6,16179.5,12368.2,-3811.3,0.8,0.3,-0.5,10022.5,7249.8,-2772.7,195.7,150.1,-45.6,5.8,12.9,7.1,143.3,120.6,-22.7,249.1,191.7,-57.4,53.7,38.2,-15.5,232.4,215.8,-16.6,25.5,75.1,49.6,1.1,20.8,19.7,25.4,60.4,35,0,14.1,14.1,33.1,93.2,60.1,0.5,4.3,3.8,0.2,16.8,16.6,16.3,38,21.7,312.3,333.8,21.5,0.1,1.4,1.3,2.7,5.7,3,3.8,3.8,0,0.5,6.3,5.8,0,0.4,0.4,0.6,3.3,2.7,1.4,4.5,3.1,1.1,3.8,2.7,0.2,3.1,2.9,2.8,26.1,23.3,122.9,90.4,-32.5,23.4,92.8,69.4,,,,,,,78.3,32.1,-46.2,1.1,3.4,2.3,0.1,1.2,1.1,372.6,259.7,-112.9,752.8,379,-373.8,8.7,9.8,1.1,11.5,8.8,-2.7,0,3.1,3.1,153.6,147.2,-6.40000000000001,128.6,121.7,-6.89999999999999,10.2,15.4,5.2,350.6,209.6,-141,1024.2,1004.3,-19.9000000000001,2.8,29.4,26.6,12.5,15,2.5,192,91.6,-100.4,0.1,0.1,0,23.6,9.4,-14.2,726,275.6,-450.4,0,0,0,206.7,194.4,-12.3,229.4,112.4,-117,1.2,0.6,-0.6,189.5,123.3,-66.2,2860.1,2771.1,-89,1811.1,591.1,-1220,714.9,1480.1,765.2,746,1073.6,327.6,19.3,20.1,0.800000000000001,0,0.9,0.9,0.5,0.8,0.3,2184,1872.3,-311.7,4635.7,2182.8,-2452.9,304,201.7,-102.3,,,,72.2,42,-30.2,15.4,4.2,-11.2,146.4,57.3,-89.1,18.1,0.6,-17.5,614,526.5,-87.5,10.7,4.6,-6.1,9.5,8.5,-1,26,7.9,-18.1,66.7,59.6,-7.1,,,,369.2,229.9,-139.3,3.4,1.5,-1.9,31.8,12.8,-19,2.1,1.9,-0.2,0.3,2.6,2.3,0.4,6.4,6,16.3,218,201.7,0.3,0.7,0.4,4,8.4,4.4,0.2,2.1,1.9,3.5,0.4,-3.1,12.1,4.9,-7.2,378.7,496,117.3,102.8,80.1,-22.7,0,10.4,10.4,23.7,16.5,-7.2,0.2,0.7,0.5,0.8,0,-0.8,1713.6,796.9,-916.7,,,,10.8,8.6,-2.2,21.1,12.7,-8.4,0.9,3.1,2.2,5.7,1.2,-4.5,0.4,3.2,2.8,,,,,,,,,,0.5,1,0.5,36.4,75.7,39.3,35.2,23.9,-11.3,28.3,7.2,-21.1,274.5,175.6,-98.9,0.9,15.7,14.8,12.5,25.4,12.9,4.2,23.3,19.1,393.1,11.5,-381.6,11.3,2.3,-9,0.6,0,-0.6,0,0,0,0,0,0,25,19.4,-5.6,153.7,68.1,-85.6,,,,800.5,321.8,-478.7,24.9,20.3,-4.6,59.8,203.8,144,0.2,15.2,15,42,12.9,-29.1,32.2,21.9,-10.3,0,7.6,7.6,792.1,265,-527.1,162.9,64.3,-98.6,11.8,1.2,-10.6,176.9,31.5,-145.4,151.2,6.7,-144.5,32,1.1,-30.9,1016.7,391.1,-625.6,87.3,36.2,-51.1,0.2,0.3,0.1,69.1,2,-67.1,1747.6,688.1,-1059.5,1050.3,1069.1,18.8,671.9,197.6,-474.3,0,0,0,25.4,1.3,-24.1,788.4,560.4,-228,92.1,13.2,-78.9,0.1,0,-0.1,5.9,0.3,-5.6,8020.8,1529.5,-6491.3,8.7,0.4,-8.3,0,0.2,0.2,2539,1486.9,-1052.1,602.9,911.2,308.3,2285.4,1151.7,-1133.7,9426.4,3862.1,-5564.3,397.4,917,519.6,0,0,0,0,0,0,0.1,0,-0.1,0,0.021066,0.021066,2.2,2,-0.2,128.6,123,-5.59999999999999,0.1,0,-0.1,0.4,0.8,0.4,0,0.1,0.1,0.3,0.7,0.4,0,0.2,0.2,0.1,0.1,0,0.002669,0.256664,0.253995,0.1,0.1,0,0,0.056384,0.056384,0.7,2,1.3,0,0.079886,0.079886,2.2,6.6,4.4,0.4,1.4,1,1.8,1.4,-0.4,1.2,1.1,-0.0999999999999999,0,0,0,12.4,1.4,-11,0.5,0.5,0,24.2,142.1,117.9,137.2,59.9,-77.3,4.5,18.2,13.7,116.250017,5.628735,-110.621282,50.9,330.6,279.7,0,0.6,0.6,,,,0,0,0,13.3,8.3,-5,0,1.3,1.3,7.7,13.4,5.7,0.3,4.8,4.5,0.1,0.8,0.7,7.6,4.6,-3,0.3,2,1.7,47.1,7.7,-39.4,5.2,9.4,4.2,0.1,0.3,0.2,0,2,2,0.1,0.7,0.6,292.3,83.4,-208.9,0,0.2,0.2,67.7,3.5,-64.2,0.1,20.4,20.3,0.8,0,-0.8,2.4,0.1,-2.3,0,2.9,2.9,182.1,19.7,-162.4,21.2,5.6,-15.6,0,0.1,0.1,0.2,0.2,0,0,0,0,3.6,2,-1.6,2.4,0.8,-1.6,0.1,0.2,0.1,0.2,1.2,1,0,0.1,0.1,2.3,4.8,2.5,0.1,0.6,0.5,0,1.3,1.3,0.8,1.6,0.8,10.5,11.2,0.699999999999999,1.3,0.6,-0.7,0,0,0,1.3,4.3,3,22,1.7,-20.3,0,6.9,6.9,21.6,0.6,-21,0,0,0,1,0,-1,0,0.4,0.4,0,0.3,0.3,228.7,178.8,-49.9,7.2,7.6,0.399999999999999,2.1,2.8,0.7,0,1.1,1.1,4.2,6.3,2.1,7.4,2.1,-5.3,5.7,2.5,-3.2,21.1,0.1,-21,0,0,0,0,0,0
2002-03-01,3897.6,1430.7,-2466.9,19295.3,13604.1,-5691.2,91447,55925,-35522,7053.064901,0,-7053.064901,9776.448476,5463.8,-4312.648476,16203,17098,895,7185,6289.3,-895.7,5273.7,4503.3,-770.4,28535.9,21578.1,-6957.8,21376.962298,15229.030304,-6147.931994,1589.205648,1021.5009,-567.704748,29255.1,15971,-13284.1,91414.9,60728.5,-30686.4,33972.993502,17143.672091,-16829.321411,,,,663.3,1252.7,589.4,1293.3,470.7,-822.6,2.3,0.1,-2.2,17481.1,13954,-3527.1,0.3,0,-0.3,11054.8,7624.1,-3430.7,224.2,179.9,-44.3,9.9,12.2,2.3,156.6,144.8,-11.8,263.7,205.8,-57.9,67,37.8,-29.2,257.2,265.1,7.90000000000003,22.8,101.4,78.6,2.1,28,25.9,28.8,82.8,54,0,8.1,8.1,40.5,120.6,80.1,0.3,3.6,3.3,1.1,20.1,19,21.8,43.8,22,333.9,365.3,31.4,0.1,2.2,2.1,2.4,6.2,3.8,3.5,4,0.5,0.2,6.6,6.4,0,0.5,0.5,0.2,4,3.8,1.5,6.3,4.8,0.3,2.7,2.4,0.3,9.4,9.1,2.3,21.9,19.6,168.6,93.4,-75.2,35.8,69.4,33.6,,,,,,,89.2,22.4,-66.8,1.1,2.5,1.4,0,2.3,2.3,461,316.6,-144.4,1035.3,365.4,-669.9,10,11,1,10.7,13.2,2.5,0,160.1,160.1,147.8,151.9,4.09999999999999,136.6,126.9,-9.69999999999999,11.1,16.9,5.8,361.6,226.5,-135.1,1104.3,1075.5,-28.8,1.9,45.3,43.4,18,18.2,0.199999999999999,239.7,102.5,-137.2,0.3,0.1,-0.2,25.9,91.6,65.7,862.3,305.2,-557.1,0,0,0,455.3,127.7,-327.6,305.7,201,-104.7,2,0,-2,268.9,167.1,-101.8,3253.1,2984.7,-268.4,1853,556.2,-1296.8,765.3,1709.8,944.5,869.2,1097.9,228.7,19.6,22.1,2.5,0.1,1.2,1.1,0.9,0.6,-0.3,2465.4,1801.4,-664,5254.7,2530.3,-2724.4,311.1,438.7,127.6,,,,92.9,56.9,-36,18.3,6.2,-12.1,176.8,62.9,-113.9,20.4,0.4,-20,791.1,722.7,-68.4,9.2,5,-4.2,8.1,5.8,-2.3,16.3,5.5,-10.8,85.7,73.7,-12,,,,387.2,195.9,-191.3,8.9,1.1,-7.8,12.6,17,4.4,1.1,2,0.9,1,3.3,2.3,3.1,9.5,6.4,17.6,8.8,-8.8,0.1,0.8,0.7,4.3,0.9,-3.4,0.1,2.2,2.1,2.4,10.7,8.3,6,10.1,4.1,493.9,433.6,-60.3,114.9,75.3,-39.6,0,4,4,36.5,18.6,-17.9,0,0.9,0.9,0.1,0.2,0.1,1938.8,884.8,-1054,,,,10.7,9.7,-1,19.8,14.9,-4.9,1.1,1.5,0.4,5.9,0.9,-5,0.3,8.2,7.9,,,,,,,,,,0.5,0.5,0,53,90.5,37.5,45.3,16.3,-29,20.5,6.7,-13.8,257.2,369.4,112.2,2.6,56.1,53.5,5.5,15.9,10.4,4.1,36.2,32.1,416.9,1.4,-415.5,13.8,6.5,-7.3,1,0.3,-0.7,0.1,0,-0.1,0.1,0,-0.1,20.8,34.3,13.5,119.1,79,-40.1,,,,845.7,376.6,-469.1,28.4,21.2,-7.2,61.8,225.1,163.3,0.5,12.8,12.3,29.4,21,-8.4,26.6,26.1,-0.5,0,12.4,12.4,952.2,380.3,-571.9,149.7,49.2,-100.5,15.3,0.6,-14.7,166,39.8,-126.2,157.1,17.6,-139.5,25.4,0.4,-25,1145.8,457.4,-688.4,90.5,41.1,-49.4,0.1,0.7,0.6,73.2,2.5,-70.7,1941.8,1252.9,-688.9,1179.3,1704.8,525.5,764.8,201.3,-563.5,0,0,0,16.2,3.3,-12.9,907.5,627.4,-280.1,70.2,6.4,-63.8,0.3,0.1,-0.2,8.5,0.2,-8.3,7259,1620.5,-5638.5,8.6,0.3,-8.3,0,1.9,1.9,2940.1,1877,-1063.1,588.7,1134.2,545.5,2476.9,1573.2,-903.7,10466.3,4743.6,-5722.7,462.4,1049,586.6,0,0,0,0,0.1,0.1,0,0.1,0.1,0.065959,0.000239,-0.06572,6.1,2.1,-4,175.8,175.3,-0.5,0.1,0,-0.1,0.3,2,1.7,0,0,0,0.4,0.5,0.1,0,0.1,0.1,0,0.1,0.1,0.003431,0.367922,0.364491,0.1,0.5,0.4,0,0.002543,0.002543,0.5,2.8,2.3,0,0.075302,0.075302,4.2,8.5,4.3,0.5,4.4,3.9,1,2.2,1.2,1.9,1.2,-0.7,0,1.1,1.1,9.4,1.2,-8.2,0.6,1.1,0.5,31.5,82.1,50.6,185.7,75.7,-110,4.7,22,17.3,73.486963,5.523246,-67.963717,74.1,370.6,296.5,0,0.1,0.1,,,,0,0,0,19.5,9.7,-9.8,0,1.6,1.6,12.7,11.7,-1,0.4,4.9,4.5,0,0.6,0.6,9.3,3.9,-5.4,0.5,1,0.5,29.1,10.5,-18.6,16,16.8,0.800000000000001,0.1,1.3,1.2,0,5.5,5.5,0.3,1.5,1.2,426.1,78.4,-347.7,0.1,0.2,0.1,148.8,5.1,-143.7,0.1,12.9,12.8,0,0.1,0.1,0.1,4.6,4.5,0,6.7,6.7,232.4,27.9,-204.5,6.1,2.4,-3.7,0,0.2,0.2,0.1,0.1,0,0,0,0,4.5,1.6,-2.9,7.9,2.2,-5.7,0.1,0.1,0,0.1,1,0.9,0,0.7,0.7,2.2,5,2.8,0,0.4,0.4,0.4,3.5,3.1,1,2.2,1.2,11.8,9.3,-2.5,0.6,1,0.4,0,0,0,3.1,6.7,3.6,19.9,1.2,-18.7,0.2,2,1.8,16.9,0.4,-16.5,0,0,0,0,0,0,0,0.3,0.3,0,0,0,268.2,213.4,-54.8,4,5.5,1.5,1.7,3.7,2,1.2,2.2,1,6.9,0.3,-6.6,8.2,2.3,-5.9,2.9,0.8,-2.1,28.2,0,-28.2,0,0,0,0,0,0
2002-04-01,4512,1590.8,-2921.2,19730.8,12360.7,-7370.1,95972,57958,-38014,7233.63669,0,-7233.63669,10265.092277,5371.4,-4893.692277,15534,14399,-1135,7634.9,5818.5,-1816.4,5407,4306.1,-1100.9,29657.2,22371,-7286.2,22297.388572,14004.794771,-8292.593801,1883.79346,880.371268,-1003.422192,31860.3,14106.6,-17753.7,96890.8000000001,58145.9,-38744.9000000001,36829.253204,15467.939958,-21361.313246,,,,814.5,1104.9,290.4,1500.2,499.8,-1000.4,1.6,0,-1.6,18185.8,14113.5,-4072.3,0.2,0.1,-0.1,11471.3,8257.5,-3213.8,255.2,155,-100.2,9.9,11,1.1,132,130.8,-1.19999999999999,242.3,201.8,-40.5,51.1,30.9,-20.2,250.5,244.6,-5.90000000000001,26.2,94.6,68.4,1.4,29,27.6,23.4,89.2,65.8,0,17.7,17.7,30,102.3,72.3,0.4,4,3.6,0.3,18.1,17.8,20.3,49.8,29.5,332.2,371.1,38.9,0.1,2.4,2.3,2.7,6.7,4,3.9,4.4,0.5,0.6,5.7,5.1,0,0.5,0.5,0.2,2.9,2.7,2.7,6.3,3.6,1.9,2.1,0.2,0.4,5.2,4.8,2.9,17.8,14.9,155.1,85.1,-70,27.1,53.7,26.6,,,,,,,79.9,92.1,12.2,1.6,2.4,0.8,0.1,1.8,1.7,440.9,314.3,-126.6,1056.5,320.1,-736.4,11.2,11.1,-0.0999999999999996,6.6,10.1,3.5,0.1,1,0.9,174.6,163.3,-11.3,132.6,135.2,2.59999999999999,11.7,14.3,2.6,414.2,212.7,-201.5,1250.1,1058.6,-191.5,2.8,46.7,43.9,13.6,19,5.4,236.3,160.9,-75.4,1.6,0.1,-1.5,28.7,9.3,-19.4,833.5,241.4,-592.1,0,0.1,0.1,652.8,101,-551.8,280.3,179.2,-101.1,1.4,0.1,-1.3,272.1,122.5,-149.6,3702.2,2957.1,-745.1,1447.6,480.5,-967.1,889,1714.4,825.4,767.9,1070.9,303,25.5,23.5,-2,0.1,0.8,0.7,0.9,0.6,-0.3,2575.5,1577.6,-997.9,5184.6,2133,-3051.6,334,219.5,-114.5,,,,107.8,55.7,-52.1,20.7,6.6,-14.1,396.8,64.4,-332.4,19.3,0.1,-19.2,856.9,683.3,-173.6,23.1,4.5,-18.6,32.3,5.1,-27.2,25.7,5.9,-19.8,82.8,56.9,-25.9,,,,547.5,197.1,-350.4,5.3,1.6,-3.7,20.4,32.4,12,2.3,3.4,1.1,0.4,3.9,3.5,0.3,5.9,5.6,29.8,135,105.2,0,6.5,6.5,3.3,1.2,-2.1,0.1,1.2,1.1,2.3,3.4,1.1,5.1,13.8,8.7,528.4,395.5,-132.9,131.9,62.5,-69.4,0,0.8,0.8,21.4,16.8,-4.6,0.2,0.5,0.3,0,0.3,0.3,1975.3,824.2,-1151.1,,,,13.4,7.8,-5.6,20.2,10.1,-10.1,1.7,1.3,-0.4,5.7,1,-4.7,0.9,3.3,2.4,,,,,,,,,,0.2,1.5,1.3,49.3,77,27.7,44.9,17.9,-27,22.3,6.1,-16.2,300.6,403.2,102.6,2.8,55.8,53,14.9,25.3,10.4,5.1,22.2,17.1,513.7,2.9,-510.8,10.4,0.2,-10.2,1.9,1.7,-0.2,0.1,0,-0.1,0,0,0,24.6,28.8,4.2,144.1,71.3,-72.8,,,,1131.3,367.6,-763.7,38.3,20.6,-17.7,77.8,420.5,342.7,0.4,12.3,11.9,31.2,16.4,-14.8,28.1,35.7,7.6,0,0.6,0.6,967.5,309,-658.5,171.5,60.1,-111.4,11.9,1.1,-10.8,141.4,18.6,-122.8,139.4,10.2,-129.2,24.2,0.5,-23.7,1135.7,383.4,-752.3,134.2,39.4,-94.8,0.1,0.2,0.1,65.9,1.6,-64.3,1901.4,960,-941.4,1208.6,1329.1,120.5,763.6,194.7,-568.9,0,0.1,0.1,38.9,1.9,-37,854,604.4,-249.6,79.1,3.7,-75.4,0.1,0.1,0,4.4,0.2,-4.2,9097.6,1544.5,-7553.1,5.7,0.4,-5.3,0,1.8,1.8,3020.7,1930.8,-1089.9,674.1,1042.7,368.6,2731.4,1515.8,-1215.6,10699.2,3900.7,-6798.5,580.6,954.6,374,0,0,0,0,0.1,0.1,0,0.1,0.1,0,0,0,0.7,2,1.3,210.4,121.5,-88.9,0.1,0,-0.1,0.3,1.6,1.3,0,0,0,0.4,0.4,0,0,0,0,0,0,0,0.07267,0.279746,0.207076,0.1,0.1,0,0.004384,0.05776,0.053376,0.1,3.2,3.1,0,0.004032,0.004032,6.5,5.2,-1.3,0.9,5.3,4.4,0.8,3.7,2.9,1.9,1.2,-0.7,0,0.2,0.2,11,1.7,-9.3,0.7,3.2,2.5,28.3,18.3,-10,259.5,94.7,-164.8,7.3,11,3.7,102.406927,6.603728,-95.803199,87.4,255.6,168.2,0,1.6,1.6,,,,0,0,0,39.7,8.6,-31.1,0,1.3,1.3,10.6,61.2,50.6,0.3,5.5,5.2,0.1,0.5,0.4,8.3,3.1,-5.2,0.1,1.2,1.1,23.2,6.6,-16.6,16.7,15.7,-1,0,0.2,0.2,0,1.4,1.4,0.3,0.4,0.1,516.7,98.2,-418.5,0,0.3,0.3,115.6,3.8,-111.8,0.4,12.8,12.4,0.4,0.2,-0.2,0,0.3,0.3,0.1,1.8,1.7,292,19.5,-272.5,2.1,3.2,1.1,0,0,0,0.3,5,4.7,0,0.2,0.2,4.2,2.7,-1.5,13.1,4.6,-8.5,0.1,0.2,0.1,0.2,1.3,1.1,0,0.4,0.4,9.2,6.7,-2.5,0,0.4,0.4,0.2,1,0.8,1.7,1.3,-0.4,14,12.5,-1.5,3.1,0.5,-2.6,0,0,0,2.5,6.1,3.6,20.6,1.4,-19.2,0,7.8,7.8,43.7,0.4,-43.3,0,0,0,0.1,0,-0.1,0.3,0.3,0,0,0,0,317.7,186.5,-131.2,6.1,9.6,3.5,1.2,3.7,2.5,0.9,1.5,0.6,6.8,0.2,-6.6,11.1,1.3,-9.8,2.8,1.9,-0.9,21.5,0.1,-21.4,0,10.6,10.6,0,0,0
2002-05-01,4586.1,2042.6,-2543.5,19423.5,12215.8,-7207.7,96395,58182,-38213,7549.051767,0,-7549.051767,10583.627833,5741.3,-4842.327833,15634,14760,-874,7752.5,5817,-1935.5,5770.4,4551.6,-1218.8,30722,23116.6,-7605.4,21936.130403,13725.850899,-8210.279504,1900.973292,823.877487,-1077.095805,31508.1,14976.5,-16531.6,97648.9,59884.1,-37764.8,36438.504664,16257.57698,-20180.927684,,,,879.8,1405.7,525.9,1525.2,480,-1045.2,1.1,0.1,-1,18793.5,14586.2,-4207.3,0.1,0.1,0,11928.5,8530.3,-3398.2,237.4,171.4,-66,8.2,11.6,3.4,206.8,143.3,-63.5,276,224.1,-51.9,52.5,35.5,-17,275.9,262.7,-13.2,25.4,103,77.6,1.3,34.5,33.2,23,81.5,58.5,0,6.5,6.5,31.4,115.4,84,0.4,4.6,4.2,1.3,19.2,17.9,26,57,31,379.8,387,7.19999999999999,0,1.4,1.4,1.9,5.4,3.5,6.9,3.2,-3.7,0.7,7,6.3,0,0.6,0.6,0.2,2.5,2.3,1.7,9.3,7.6,3,3.4,0.4,0.6,3.1,2.5,3.5,19.9,16.4,211.4,64.8,-146.6,27.7,40.7,13,,,,,,,59,23.5,-35.5,0.8,3,2.2,0,1.8,1.8,441,315.2,-125.8,1256.9,677.3,-579.6,7.8,13,5.2,13.6,11.4,-2.2,5.9,0.6,-5.3,219.4,132.6,-86.8,147.7,156.8,9.10000000000002,11.9,23.9,12,276,217,-59,1260.8,968.5,-292.3,3.7,38.2,34.5,18,18.9,0.899999999999999,244.8,131.5,-113.3,0,0,0,19.2,8.9,-10.3,861.4,315.8,-545.6,0,0,0,594,122.9,-471.1,392.4,126.8,-265.6,1.5,0.2,-1.3,254.9,101,-153.9,3587.5,2701.8,-885.7,1913.1,621.2,-1291.9,887.7,1592.9,705.2,993.5,1128.4,134.9,22.6,20.5,-2.1,0,1.3,1.3,1.3,0.8,-0.5,2043.4,1570,-473.4,4900.2,2084.1,-2816.1,294.8,235.7,-59.1,,,,107,105,-2,19.7,7.2,-12.5,159.7,49.1,-110.6,22.6,0.8,-21.8,810.1,745.9,-64.2,14.4,8.3,-6.1,10.6,6.3,-4.3,32.9,4,-28.9,95.5,58.2,-37.3,,,,612.6,151.3,-461.3,13.9,1.4,-12.5,28.5,11.9,-16.6,2.4,6.3,3.9,1.1,4.2,3.1,0.6,15.2,14.6,48.8,102.1,53.3,0.1,1.3,1.2,2.4,5.5,3.1,0.2,0.5,0.3,3.8,12.8,9,4.7,4.3,-0.4,494.5,364.9,-129.6,173.2,56.1,-117.1,0,0.9,0.9,25.7,15.4,-10.3,0,0.2,0.2,0,0.2,0.2,2052.4,932.6,-1119.8,,,,12.6,7.2,-5.4,23,10.6,-12.4,1.3,0.7,-0.6,3.8,2.3,-1.5,1.8,4.2,2.4,,,,,,,,,,0.6,0.7,0.1,60.8,95.8,35,29,22,-7,17.3,8.4,-8.9,278.3,265.7,-12.6,2.7,4,1.3,4.3,24,19.7,4.7,20.7,16,338.2,4.4,-333.8,13.9,0.2,-13.7,3.5,1.8,-1.7,0,0,0,0,0,0,25.3,49,23.7,112.8,65.8,-47,,,,1134.1,472.4,-661.7,43.4,21.6,-21.8,63.8,382.3,318.5,0.2,74.2,74,14.1,64,49.9,25.7,45.1,19.4,0.2,23.4,23.2,993.7,314.7,-679,186.9,56.7,-130.2,11.3,1.1,-10.2,148.3,17.4,-130.9,114,28.5,-85.5,20.3,0.8,-19.5,1187.3,391,-796.3,151.9,45.2,-106.7,0.5,0.1,-0.4,57.6,2.4,-55.2,2035.8,855.7,-1180.1,1300.1,1234.8,-65.3,848.8,222,-626.8,0,0,0,20.1,2,-18.1,891,657.3,-233.7,84.6,13.2,-71.4,0,0,0,8.8,0.1,-8.7,9846.9,1773.9,-8073,8.2,0.7,-7.5,0,0.4,0.4,3075.3,1990.7,-1084.6,738.1,1053.8,315.7,2639.1,1537.7,-1101.4,9167.2,4261.9,-4905.3,582,1204.3,622.3,0,0,0,0.1,0.1,0,0,0.1,0.1,0,0,0,3.7,1.5,-2.2,275.5,167.7,-107.8,0.1,0,-0.1,0.2,6.9,6.7,0,0,0,0.4,0.8,0.4,0,0.2,0.2,0,0,0,0.010178,0.212592,0.202414,0.1,0.1,0,0,0.003269,0.003269,0.1,8.2,8.1,0,0.08528,0.08528,4.2,5.7,1.5,0.7,2.1,1.4,1,3,2,1.2,1.4,0.2,0.3,0.4,0.1,9.5,1.1,-8.4,0.7,1.1,0.4,28.7,16.7,-12,262.3,113.8,-148.5,3.8,12.9,9.1,59.361757,9.675386,-49.686371,80.8,199.9,119.1,0,2.1,2.1,,,,0,0,0,67.1,4.6,-62.5,0,0.2,0.2,9.4,6.8,-2.6,0.2,6.9,6.7,0.3,0.9,0.6,5.3,1.3,-4,0.3,2.6,2.3,26.6,4.3,-22.3,11.9,10.1,-1.8,0,1.1,1.1,0.3,2.3,2,0.1,0.9,0.8,512.1,82.9,-429.2,0.5,0.3,-0.2,171.2,5.4,-165.8,0.5,18.7,18.2,0,0.3,0.3,0,0.1,0.1,0.2,2,1.8,247.9,24.7,-223.2,28.5,3.6,-24.9,0,0.1,0.1,0.1,0.8,0.7,0,0,0,4.5,3.9,-0.6,10.5,2.5,-8,0,0.1,0.1,0,1.4,1.4,0,0.6,0.6,6.2,7.4,1.2,0,1,1,0,2.1,2.1,0.7,1.5,0.8,15.2,67.7,52.5,2.6,0.7,-1.9,0,0,0,1.8,4.8,3,21.9,1.9,-20,0,1.9,1.9,27.3,1.1,-26.2,0,0,0,0.2,0,-0.2,0.3,0.2,-0.1,0,0,0,317.9,186.5,-131.4,0.7,7.5,6.8,1.6,1.3,-0.3,1.4,3.2,1.8,6.7,0.3,-6.4,7.2,5.1,-2.1,1.6,0.4,-1.2,18.7,0,-18.7,0,2.6,2.6,0,0,0
2002-06-01,4153.2,1431.3,-2721.9,18696.7,12146.4,-6550.3,97848,58772,-39076,7128.665062,0,-7128.665062,9855.109761,5513.3,-4341.809761,16371,16414,43,7436.5,6408.3,-1028.2,5558.9,4187.4,-1371.5,28747.5,22301.6,-6445.9,21315.00896,13520.510405,-7794.498555,2366.524923,880.551142,-1485.973781,33013.1,16462.1,-16551,96415.9,59920.7,-36495.2,37642.672803,17664.32368,-19978.349123,,,,783.6,1354,570.4,1622.9,469,-1153.9,0.8,0.3,-0.5,17436.2,14213.7,-3222.5,0,0,0,11311.3,8087.9,-3223.4,206.1,178.2,-27.9,4.9,9.5,4.6,155.5,145.2,-10.3,266.6,217,-49.6,49,38.4,-10.6,276.7,268.5,-8.19999999999999,28.1,141.4,113.3,1.2,33.9,32.7,29.1,79.8,50.7,0,18.1,18.1,27.9,104.2,76.3,0.3,4.2,3.9,1,18.6,17.6,20.7,44.6,23.9,365.9,347,-18.9,0.2,1.5,1.3,1.3,5.2,3.9,3.9,2.9,-1,0.3,7.5,7.2,0,0.6,0.6,0.2,2.1,1.9,2.4,11,8.6,2.7,2.9,0.2,0.5,3.1,2.6,2.7,20.5,17.8,194.2,63.6,-130.6,35.8,48.6,12.8,,,,,,,27.9,21.7,-6.2,1,4.9,3.9,0,1.9,1.9,390.3,270,-120.3,1196.5,272.4,-924.1,8.8,11.3,2.5,7.7,10.6,2.9,0.2,78.3,78.1,164.1,109.2,-54.9,132.7,127.4,-5.29999999999998,10.7,14,3.3,269.9,240.5,-29.4,1383.5,1017.2,-366.3,2.7,43.5,40.8,14.7,16.1,1.4,271.4,130.4,-141,0,0,0,12.9,10.1,-2.8,777.5,240.5,-537,0,0,0,583.9,88.1,-495.8,284.9,118,-166.9,1,0,-1,283.8,123.2,-160.6,3326.9,2966.1,-360.8,2029.1,581.5,-1447.6,800,1531.2,731.2,821.7,1147.4,325.7,30.2,19.2,-11,0.1,0.9,0.8,2,1.1,-0.9,2311.4,1532,-779.4,4619.5,2197.3,-2422.2,329.2,173.5,-155.7,,,,102,46.6,-55.4,19.2,24,4.8,154.4,63,-91.4,21,0.4,-20.6,841.9,754,-87.9,7,10,3,14.2,5.8,-8.4,27.8,6,-21.8,85.2,53.5,-31.7,,,,639.7,194,-445.7,8.7,1.2,-7.5,56.7,11,-45.7,1.6,2,0.4,26,5.9,-20.1,0.4,8,7.6,15.3,47,31.7,0.1,1.9,1.8,1.5,1.9,0.4,0.1,0.4,0.3,4.7,7.7,3,4.5,10.5,6,424.9,373.9,-51,147.2,61.1,-86.1,0,3.1,3.1,25.5,13.5,-12,0.1,0.4,0.3,0,0.2,0.2,2006.5,775.2,-1231.3,,,,11.2,5.7,-5.5,23.1,9.3,-13.8,1.9,1.7,-0.2,3.8,1.5,-2.3,0.6,4.2,3.6,,,,,,,,,,0.3,0.2,-0.1,43.2,67.7,24.5,50.7,14.4,-36.3,24.7,7.7,-17,303,188.9,-114.1,2.5,7,4.5,15.6,27.9,12.3,4.5,16.6,12.1,74.3,2.5,-71.8,11.6,1.6,-10,8.2,1.1,-7.1,0.1,0,-0.1,0,0,0,21,25.4,4.4,194.7,76,-118.7,,,,899.4,396.3,-503.1,59,21.3,-37.7,85.3,205,119.7,55.1,21.8,-33.3,12.4,66.7,54.3,25.6,37.5,11.9,0,3.9,3.9,875.4,343.7,-531.7,193.3,50.8,-142.5,9.4,2.8,-6.6,186.2,28.9,-157.3,134.8,11.3,-123.5,27.1,0.3,-26.8,1236.4,406.4,-830,226.4,40,-186.4,0.5,1,0.5,87.2,2.1,-85.1,2098.1,1002.5,-1095.6,1022.2,1538.2,516,826.6,195.1,-631.5,0,0.1,0.1,21.6,9.3,-12.3,942,634.5,-307.5,107.5,5,-102.5,0,0.1,0.1,11.2,0.5,-10.7,10727.2,2205.9,-8521.3,14.1,0.3,-13.8,0,0.5,0.5,2748.1,1975.3,-772.8,786.7,1134.6,347.9,2879.6,1760.3,-1119.3,10090.4,4669.7,-5420.7,513.9,1140.6,626.7,0,0,0,0,0.1,0.1,0.1,0.1,0,0,0,0,3,1.4,-1.6,246.4,189.8,-56.6,0,0.2,0.2,0.2,0.5,0.3,0,0,0,0.7,0.7,0,0.1,0.1,0,0.3,0,-0.3,0.009,0.305647,0.296647,0.1,0.3,0.2,0,0,0,0.3,3,2.7,0,0.064671,0.064671,3.2,9.3,6.1,0.6,1.7,1.1,1.7,1.7,0,1.7,1.2,-0.5,0,0.4,0.4,10.6,1.1,-9.5,0.7,1.6,0.9,30.6,24.6,-6,244.7,169,-75.7,4.9,20.7,15.8,172.300492,5.262978,-167.037514,462,193.3,-268.7,0,0.2,0.2,,,,0,0,0,76.1,11.2,-64.9,0,0.2,0.2,10.1,4.8,-5.3,0.2,7.7,7.5,0.1,0.9,0.8,7.4,9.2,1.8,0.1,2.2,2.1,11.5,4.4,-7.1,9.4,21.3,11.9,0,0.4,0.4,0,2.3,2.3,0.1,0.8,0.7,561.2,88.8,-472.4,0.1,0.3,0.2,91.2,4,-87.2,0.8,3.4,2.6,0.9,0.2,-0.7,0,2.7,2.7,0.1,2.2,2.1,389.3,29.1,-360.2,16,3.1,-12.9,0,0.7,0.7,0.1,0.2,0.1,0,0,0,3.3,1.2,-2.1,8.7,3.2,-5.5,0,0.4,0.4,0.5,1.5,1,0.1,0,-0.1,8.2,16.6,8.4,0,0.8,0.8,0.3,0.8,0.5,1,1.2,0.2,16.4,12.8,-3.6,1.5,0.5,-1,0.1,0,-0.1,1.7,10.7,9,21.7,2.7,-19,0.8,4.9,4.1,20.5,0.1,-20.4,0,0,0,0.6,0,-0.6,0.2,0.3,0.1,0,0,0,323.3,208.2,-115.1,0.9,3.4,2.5,1.2,1.3,0.1,1.8,1.8,0,8.7,0.8,-7.9,8.5,7.2,-1.3,2.2,0.9,-1.3,23.2,0.4,-22.8,0,11.8,11.8,0,0,0
2002-07-01,4714.1,1569.1,-3145,21471.8,10748.3,-10723.5,97197,59129,-38068,7134.972371,0,-7134.972371,8299.692033,4432.7,-3866.992033,16961,14859,-2102,7988.3,6312.9,-1675.4,6222.4,4098,-2124.4,27203.5,19570.2,-7633.3,24143.340631,12277.272128,-11866.068503,1771.970456,855.448838,-916.521618,34580.8,15809.2,-18771.6,100471.9,55031.6,-45440.3,40223.234632,16638.321985,-23584.912647,,,,905.7,1588,682.299999999999,1483.6,551.3,-932.3,2.1,0.2,-1.9,15910.8,11607.2,-4303.6,0,0.1,0.1,11292.7,7962.9,-3329.8,253.7,170,-83.7,5.8,8.2,2.4,187.5,133.3,-54.2,313.2,195.7,-117.5,60.1,34.4,-25.7,282.4,270.3,-12.1,35.5,136.3,100.8,5.8,27,21.2,48.4,87,38.6,0,8.6,8.6,29.2,126.7,97.5,0.3,3.4,3.1,1.3,18.9,17.6,23.5,52.4,28.9,390.8,363,-27.8,0.1,1.7,1.6,1.6,5.7,4.1,3.6,4.5,0.9,0.4,8.4,8,0,0.5,0.5,0.1,3.7,3.6,1.8,8.1,6.3,3.1,3.8,0.7,1,2.9,1.9,2.9,26.3,23.4,201.7,75.9,-125.8,35.8,50.3,14.5,,,,,,,31,38.2,7.2,1.1,2.1,1,0.1,1.5,1.4,501,288.8,-212.2,1497.3,303.9,-1193.4,8.9,7.4,-1.5,14.1,8.7,-5.4,0,0.9,0.9,163.6,133.7,-29.9,163.6,131.6,-32,9.4,13.1,3.7,233.9,192.7,-41.2,1399.9,970.4,-429.5,3,38.4,35.4,21.4,17.1,-4.3,282.5,122.5,-160,2,0,-2,17.9,12.4,-5.5,831.1,247.4,-583.7,0,0,0,546.5,88.8,-457.7,321,100.8,-220.2,1.8,0.1,-1.7,270.8,111.9,-158.9,3766.9,2455.9,-1311,1844,524.5,-1319.5,875.4,1353.1,477.7,1009.6,1085.8,76.1999999999999,29.9,18.6,-11.3,0.3,0.6,0.3,1.7,3.3,1.6,2686.6,1249.4,-1437.2,5796.1,1990.1,-3806,372.2,93.3,-278.9,,,,120,40.8,-79.2,27.7,7.3,-20.4,170.7,48,-122.7,24.3,0.5,-23.8,869.5,715.4,-154.1,8.2,8.6,0.4,16.5,7.5,-9,21.3,11.1,-10.2,104.3,51.9,-52.4,,,,624.4,248.4,-376,17.8,2.4,-15.4,40.5,38,-2.5,2.2,7.3,5.1,1.4,7,5.6,0.5,6.6,6.1,17.2,8.3,-8.9,0.4,4.1,3.7,3.2,2.3,-0.9,0,8.8,8.8,6.1,1,-5.1,8.5,6.7,-1.8,521.1,357.1,-164,163.5,47.2,-116.3,0,1.4,1.4,22.1,18.4,-3.7,0.2,0.4,0.2,0.7,0.1,-0.6,2421.3,835.8,-1585.5,,,,16.7,5.7,-11,25.7,9.1,-16.6,1.1,2.6,1.5,8.9,1.4,-7.5,0.7,21.8,21.1,,,,,,,,,,0.2,1.3,1.1,43,66.3,23.3,92.3,35.5,-56.8,32.1,8.9,-23.2,334.4,287.8,-46.6,2.6,8.3,5.7,15.3,26,10.7,7.3,16.4,9.1,201.8,2.5,-199.3,11.4,3,-8.4,299.6,11.3,-288.3,0.2,0,-0.2,0,0,0,46.2,36.1,-10.1,140.6,81.4,-59.2,,,,1175.9,413.3,-762.6,73.8,24.1,-49.7,109.6,387,277.4,0.3,7.3,7,52.8,15.8,-37,27,42.5,15.5,0.1,0.9,0.8,1074.3,289.1,-785.2,226.7,44.2,-182.5,13.3,1.6,-11.7,249.1,17.1,-232,186.1,9.9,-176.2,33.2,0.7,-32.5,1328.8,344.1,-984.7,238.4,48.3,-190.1,0.2,0.3,0.1,109.2,2.3,-106.9,2182.2,828.1,-1354.1,1244.8,1322.5,77.7,942.1,198.3,-743.8,0,0,0,26.9,2.5,-24.4,992.6,550.1,-442.5,123.8,8.6,-115.2,0,0,0,12.6,0.2,-12.4,11213.2,1848,-9365.2,18.8,60.7,41.9,0,8.6,8.6,2930.9,1889.5,-1041.4,933.7,1035.4,101.7,2878.8,2065.5,-813.3,10230,4492.6,-5737.4,629.7,1414.9,785.2,0,0,0,0,0.1,0.1,0.1,0.2,0.1,0,0.028583,0.028583,25.2,2.2,-23,226.8,151,-75.8,0.1,0.1,0,0.2,0.6,0.4,0,0.1,0.1,1,0.5,-0.5,0.2,0.1,-0.1,0,0,0,0,0.22122,0.22122,0.1,0,-0.1,0,0,0,0.3,1.3,1,0.008778,0.086116,0.077338,3.4,7,3.6,1.4,2.7,1.3,1.8,1.9,0.0999999999999999,1.1,2.1,1,0,0.1,0.1,13.4,1.6,-11.8,0.9,0.6,-0.3,46.2,20.7,-25.5,131,33.2,-97.8,6.3,17.3,11,153.238506,4.740726,-148.49778,104.3,217.6,113.3,0.1,0.2,0.1,,,,0,0,0,40.7,9.4,-31.3,0.1,1.7,1.6,11.7,8.9,-2.8,0.3,6.7,6.4,0.4,0.6,0.2,5.7,11.5,5.8,0.2,2.1,1.9,10.6,4.5,-6.1,9,13.2,4.2,0,0.5,0.5,0,2.6,2.6,0.8,0.7,-0.1,430.5,107.5,-323,0.1,0.7,0.6,179.6,12.8,-166.8,0.8,11.3,10.5,0.1,0.1,0,0,1,1,0.1,1.7,1.6,240.5,24.4,-216.1,34.2,3.1,-31.1,0,0,0,0,0.4,0.4,0,0.2,0.2,4.4,1,-3.4,31.7,3.2,-28.5,0,0.1,0.1,0.1,0.7,0.6,0,0.2,0.2,10,7.6,-2.4,0,0.5,0.5,0.2,4.5,4.3,0.7,1,0.3,16.6,15.7,-0.900000000000002,5.9,1,-4.9,0.1,0,-0.1,1.6,6.1,4.5,31.8,3.6,-28.2,0.2,14.7,14.5,7.9,0.1,-7.8,0,0,0,0,0,0,0.5,0.1,-0.4,0,0,0,359,254.3,-104.7,0.9,3,2.1,0.9,3.4,2.5,0.3,1.7,1.4,11.4,0.3,-11.1,4.6,4.5,-0.0999999999999996,3,3,0,34.2,0,-34.2,0,4.7,4.7,0,0,0
2002-08-01,5139,1491.8,-3647.2,18790.5,11975.6,-6814.9,99721,59173,-40548,7595.329563,0,-7595.329563,10439.67584,5216.9,-5222.77584,16546,15130,-1416,8026.8,6245.6,-1781.2,6492.2,4401.7,-2090.5,29797.3,22472.5,-7324.8,21295.161922,13197.875789,-8097.286133,2029.800329,993.572946,-1036.227383,36067.7,15895.7,-20172,102276.6,59490.4,-42786.2,41853.14392,17214.141264,-24639.002656,,,,807.2,1196.1,388.9,1715.9,582.3,-1133.6,2.3,0.1,-2.2,17943.3,13913.1,-4030.2,0.2,0,-0.2,11854,8559.4,-3294.6,263.7,168.4,-95.3,7.3,9.3,2,167.4,145.1,-22.3,293.8,226.5,-67.3,62.5,42.9,-19.6,275,337.9,62.9,26.7,101,74.3,1.5,63.8,62.3,49.4,67.9,18.5,0,11.4,11.4,33.3,137.5,104.2,0.5,5.5,5,0.3,20.4,20.1,21.6,42.9,21.3,372.4,377.6,5.20000000000005,0.2,1.5,1.3,1.4,4.7,3.3,3.4,5.1,1.7,0.1,5.7,5.6,0,0.4,0.4,0.3,4.5,4.2,1.7,10.8,9.1,1.1,3.3,2.2,0.6,3,2.4,2,20.7,18.7,226.5,97.3,-129.2,24.2,37.9,13.7,,,,,,,61.8,29.9,-31.9,1,3.2,2.2,0,1.9,1.9,476.8,268.2,-208.6,1581.7,328.9,-1252.8,9.7,9.7,0,9.1,10.5,1.4,0,0.3,0.3,193.6,122.9,-70.7,170.1,119.4,-50.7,13.8,14.2,0.399999999999999,289.4,215.8,-73.6,1580.7,1134,-446.7,4.6,43.8,39.2,16.7,14.4,-2.3,245.4,131.4,-114,0.7,0,-0.7,11.9,10.1,-1.8,520.6,261.8,-258.8,0,0,0,516.5,133.7,-382.8,276.4,123.1,-153.3,0.9,0.8,-0.1,232.8,115.7,-117.1,3371.8,2914.3,-457.5,1890.6,506.9,-1383.7,766,1513.9,747.9,602,1136.3,534.3,25.7,252.2,226.5,0,1.7,1.7,1.1,0.8,-0.3,2200.9,1287.3,-913.6,5107.5,2147.2,-2960.3,333.3,134.7,-198.6,,,,114.7,62.1,-52.6,17.9,5,-12.9,308.1,54.9,-253.2,16.2,0.4,-15.8,722.7,536.4,-186.3,6.2,4.9,-1.3,11.7,4.4,-7.3,10.6,11.8,1.2,102,53.2,-48.8,,,,686.4,222.5,-463.9,14.5,0.9,-13.6,50.8,13.1,-37.7,2.4,4.3,1.9,0.4,9.5,9.1,4.2,13.1,8.9,27.8,11.9,-15.9,0.3,1.2,0.9,3.5,2.7,-0.8,0,0.8,0.8,6.4,1.9,-4.5,8.4,21.6,13.2,474.8,392.2,-82.6,164.4,50.1,-114.3,0,3.1,3.1,22.8,15.7,-7.1,0,1.2,1.2,0,0.2,0.2,2154.4,822.7,-1331.7,,,,12.6,4.7,-7.9,26.3,8.1,-18.2,1.4,1.4,0,6.1,0.9,-5.2,1.5,5.6,4.1,,,,,,,,,,0.3,0.4,0.1,46.5,93.1,46.6,75.6,19.3,-56.3,28.1,9.5,-18.6,304.4,188.6,-115.8,2.5,3.9,1.4,13.8,19.8,6,4.5,16.2,11.7,199.9,0,-199.9,11.7,3.4,-8.3,238.8,135.3,-103.5,2.4,0,-2.4,0,0,0,52,34.2,-17.8,159.8,91,-68.8,,,,1198,403.5,-794.5,36.6,14.3,-22.3,100.2,232.9,132.7,108.6,80.3,-28.3,43.3,18.8,-24.5,33.9,58.3,24.4,0.1,1.1,1,1114.8,381.7,-733.1,225.1,48.9,-176.2,8.2,2.1,-6.1,267.6,20.2,-247.4,175,20,-155,35.9,0.5,-35.4,1374.5,393.7,-980.8,289,33.9,-255.1,0.2,0.2,0,109.1,2,-107.1,2307.3,907.4,-1399.9,1375.4,1600.4,225,967.6,281.9,-685.7,0,0,0,34.6,6.4,-28.2,1072.1,640.8,-431.3,125.5,5.1,-120.4,0,0,0,8.4,1.5,-6.9,12671.4,1839.8,-10831.6,20.8,0.7,-20.1,0,5,5,2882.3,1918.7,-963.6,867.4,1112.5,245.1,2901.6,1614,-1287.6,10081.4,4791.1,-5290.3,570.8,1027.5,456.7,0,0,0,0,0,0,0.1,0.1,0,0,0.001309,0.001309,6.7,2.3,-4.4,203.6,147.9,-55.7,0,0,0,0.3,0.8,0.5,0,0.1,0.1,0.7,0.4,-0.3,0,0.1,0.1,0.4,0.2,-0.2,0.028651,0.310397,0.281746,0.1,0,-0.1,0.002075,0,-0.002075,0.3,2.1,1.8,0,0.005451,0.005451,2.9,6.3,3.4,0.8,1.6,0.8,0.7,2.7,2,0.9,1.3,0.4,0,0.1,0.1,17.1,1.5,-15.6,1.8,0.7,-1.1,33.4,19.5,-13.9,180.1,43.6,-136.5,16.6,18,1.4,280.939837,11.4762,-269.463637,82.2,329.9,247.7,0.2,0.9,0.7,,,,0,0,0,59.5,8.5,-51,0.1,1.8,1.7,53.6,3.1,-50.5,0.6,8.3,7.7,0.2,1.2,1,4.1,6.9,2.8,0.2,1.5,1.3,23.5,7.7,-15.8,6.8,17.2,10.4,0,0.7,0.7,0.2,3.3,3.1,0.2,0.9,0.7,703.3,92.2,-611.1,0,0.7,0.7,161.7,4.5,-157.2,0.9,3.8,2.9,0.4,0.2,-0.2,0.1,1.2,1.1,0,1.6,1.6,211.1,31.4,-179.7,14.1,5.7,-8.4,0,0.3,0.3,0,0.9,0.9,0.3,1.1,0.8,5,2.6,-2.4,18.1,1.9,-16.2,0.1,0.2,0.1,0.2,0.7,0.5,0,0.1,0.1,14,10.4,-3.6,0.1,1.1,1,0.2,14.7,14.5,0.9,1.4,0.5,23.3,13.8,-9.5,1.6,0.8,-0.8,0,0,0,2.2,5.1,2.9,23.1,3.5,-19.6,0.3,8.5,8.2,5.1,0.2,-4.9,0,0,0,0.1,0,-0.1,1.3,0,-1.3,0,0,0,327.3,270.2,-57.1,1,4.2,3.2,1.1,3.9,2.8,0.2,5,4.8,12.6,1.3,-11.3,5.7,9.6,3.9,13.1,2.2,-10.9,32.3,0.4,-31.9,0,14.9,14.9,0,0,0
2002-09-01,4879.6,1923.5,-2956.1,18190,11790.4,-6399.6,99364,58639,-40725,7163.243456,0,-7163.243456,9984.124588,4997.6,-4986.524588,16834,14841,-1993,7935.1,5812.6,-2122.5,6363.6,4320.7,-2042.9,29270.7,21616.6,-7654.1,20504.895019,13045.77713,-7459.117889,1893.914753,776.417555,-1117.497198,35097.9,14743.6,-20354.3,99428.8000000001,57277.5,-42151.3000000001,40641.46674,16330.717527,-24310.749213,,,,752.5,1176.5,423.999999999999,1567.3,520.7,-1046.6,1.3,1.1,-0.2,17861.5,13333.9,-4527.6,0.2,0,-0.2,11409.2,8282.8,-3126.4,239.5,149.9,-89.6,5.9,6.6,0.699999999999999,177.4,134.9,-42.5,285.2,215.4,-69.8,61.1,31.5,-29.6,282,256.8,-25.2,22.7,105.5,82.8,1.2,28.9,27.7,54.2,90.9,36.7,0,16.3,16.3,36.7,131.4,94.7,0.6,4.6,4,0.4,19.1,18.7,24.4,40.6,16.2,378.7,351.9,-26.8,0.1,1,0.9,1,4.7,3.7,3.3,4.7,1.4,0,7.1,7.1,0.2,0.3,0.1,0.3,8.8,8.5,1.3,7.5,6.2,1.2,3.2,2,0.4,3.1,2.7,2.5,20.1,17.6,230.1,111.7,-118.4,34.7,30.7,-4,,,,,,,70.6,39.7,-30.9,0.9,2.6,1.7,0.1,1.7,1.6,494.7,355.6,-139.1,1721.9,400,-1321.9,7.7,12.8,5.1,5.9,11,5.1,0,0.5,0.5,171,113.4,-57.6,173.1,112.8,-60.3,15.8,30.4,14.6,246.9,211.6,-35.3,1350,1052.5,-297.5,5.9,39.2,33.3,14.5,18.6,4.1,239.1,131.1,-108,0.4,0,-0.4,17.1,26.5,9.4,638.7,255.1,-383.6,0,0,0,467.2,99.9,-367.3,255.1,103.7,-151.4,1,0.8,-0.2,333.9,152,-181.9,3256.7,2643.2,-613.5,1956.5,432,-1524.5,788.7,1504.5,715.8,701.8,1119.7,417.9,20.8,18.6,-2.2,0,0.8,0.8,2.1,0.7,-1.4,2166.3,1502.5,-663.8,4913.8,2327.8,-2586,343,191,-152,,,,99.3,46.8,-52.5,24.4,6.5,-17.9,156.3,59.5,-96.8,19.8,0.2,-19.6,745.6,585.1,-160.5,25.4,4.2,-21.2,10.6,8.7,-1.9,20.3,9.3,-11,98.4,54,-44.4,,,,521.1,142.1,-379,9,1.3,-7.7,35.3,16.4,-18.9,3.3,72.1,68.8,1.2,6.1,4.9,0.3,6.4,6.1,19.7,9.5,-10.2,0.9,2.5,1.6,3.4,0.8,-2.6,0.1,0.3,0.2,5.5,1.5,-4,3.4,17.3,13.9,404.5,441,36.5,141.6,48,-93.6,0,0.3,0.3,24.5,17.1,-7.4,0,0.3,0.3,0,0.3,0.3,1737.2,679.2,-1058,,,,18,4.8,-13.2,24,10.1,-13.9,1.5,6.6,5.1,5.9,1.2,-4.7,0.7,5.7,5,,,,,,,,,,0.3,1.1,0.8,46,152.4,106.4,62.9,14.6,-48.3,33.2,12.5,-20.7,336.3,217.5,-118.8,2.3,3.4,1.1,4.7,20,15.3,5.9,40.1,34.2,119.1,3.4,-115.7,12,1.8,-10.2,301.9,195.1,-106.8,2.1,0,-2.1,0,0.1,0.1,46,25.4,-20.6,205.4,86.7,-118.7,,,,1144,418.7,-725.3,56.3,43,-13.3,87,646.1,559.1,47,63.8,16.8,70.7,20.6,-50.1,34.6,26,-8.6,0,1.5,1.5,1065.8,341.2,-724.6,220.6,77.9,-142.7,10,2.1,-7.9,208.6,14.2,-194.4,167.9,17.4,-150.5,34,1.1,-32.9,1361.8,373.1,-988.7,251.8,45.1,-206.7,0.2,0.1,-0.1,114.3,4.6,-109.7,2032.1,798,-1234.1,1232.3,1133,-99.3,851.1,187.3,-663.8,0,0,0,16.3,3.7,-12.6,1048.9,615.8,-433.1,126,4.5,-121.5,0,0.2,0.2,11.2,0.2,-11,12291.5,2023.7,-10267.8,21.4,0.9,-20.5,0,0.7,0.7,3068,1974.3,-1093.7,861.1,1117,255.9,2773.7,1588.3,-1185.4,10074,4138.3,-5935.7,559.1,1014.9,455.8,0,0,0,0,0.1,0.1,0.1,0.1,0,0,0,0,3.8,1.2,-2.6,160,143.7,-16.3,0,0.1,0.1,0.1,0.9,0.8,0,0,0,0.5,0.5,0,0,0.1,0.1,1.6,0.1,-1.5,0.207564,0.139172,-0.068392,0.1,0.3,0.2,0,0,0,2.7,1.3,-1.4,0,0,0,2.5,6.3,3.8,0.5,1.6,1.1,1.6,1.5,-0.1,1.6,1.1,-0.5,0,0.2,0.2,17.1,1.6,-15.5,1.2,0.6,-0.6,29.4,16,-13.4,195.7,56.1,-139.6,14,8.4,-5.6,141.699623,4.017968,-137.681655,87.4,174.6,87.2,0.3,3.8,3.5,,,,0,0,0,55.6,10.7,-44.9,0,1.9,1.9,28.5,6.9,-21.6,0.3,5.2,4.9,0.3,1.1,0.8,4.7,3.6,-1.1,0.2,3.3,3.1,6.3,6.2,-0.0999999999999996,11.2,12.3,1.1,0,0.5,0.5,0.1,1.5,1.4,0.2,1.3,1.1,487.2,80.7,-406.5,0.1,0.4,0.3,155.2,11.4,-143.8,1.3,16.2,14.9,0,0.2,0.2,0,2.2,2.2,0,1.4,1.4,241.3,33.2,-208.1,8.2,5.2,-3,0,0.1,0.1,0.1,0.3,0.2,0,0.1,0.1,3.6,3.1,-0.5,16.5,2.2,-14.3,0.1,0.1,0,0.2,0.1,-0.1,0,0.3,0.3,2.2,4.4,2.2,0,7.1,7.1,0,10.5,10.5,3.3,2.1,-1.2,20.5,13.2,-7.3,0.6,0.7,0.1,0,0.1,0.1,2.1,2.8,0.7,27,2,-25,0,8.3,8.3,6.7,1.2,-5.5,0,0,0,0,0,0,0,0.1,0.1,0,0.3,0.3,395.6,238.1,-157.5,5,2.2,-2.8,7.6,2.5,-5.1,0.4,1.6,1.2,16.7,0.6,-16.1,7.3,3.3,-4,8.9,5.7,-3.2,42.1,0.5,-41.6,0,9.4,9.4,0,0,0
2002-10-01,5129.7,1645.8,-3483.9,21443,13258.2,-8184.8,96860,58066,-38794,7806.462863,0,-7806.462863,10449.718037,5691.8,-4757.918037,17391,15729,-1662,7862.1,6078.4,-1783.7,6997.7,4567.8,-2429.9,31701.9,23923.2,-7778.7,24193.057633,14715.326464,-9477.731169,2037.181649,783.140998,-1254.040651,34532.5,15176.6,-19355.9,106250.8,61975.6,-44275.2,40549.472095,16626.782703,-23922.689392,,,,770.8,1307.1,536.3,1735.5,505.3,-1230.2,0.8,1,0.2,19044.1,14702.4,-4341.7,0.2,0,-0.2,12657.9,9220.8,-3437.1,246.2,191.2,-55,5.8,11.8,6,186.9,151.7,-35.2,305.9,231.7,-74.2,59.8,35.7,-24.1,283.9,244.5,-39.4,24.7,148,123.3,2.2,30.9,28.7,54.4,92.3,37.9,0.2,5,4.8,31.3,121.7,90.4,0.2,4.1,3.9,0.8,20.9,20.1,22.5,54.5,32,396.4,379.2,-17.2,0,1.5,1.5,0.6,6.4,5.8,5,5.2,0.2,0.1,7.3,7.2,0,0.3,0.3,0.5,3.1,2.6,1.4,9.9,8.5,0.9,3.2,2.3,1.8,4.4,2.6,6,22.2,16.2,291.4,82.1,-209.3,21.4,84.8,63.4,,,,,,,68.2,33.8,-34.4,1.3,2,0.7,0,2.8,2.8,594.9,309.5,-285.4,1654.4,373.9,-1280.5,12.7,12.4,-0.299999999999999,13.1,8.6,-4.5,0,1,1,229,157.9,-71.1,207.2,126.4,-80.8,19.1,13.8,-5.3,266.6,207.6,-59,1648.5,1159.4,-489.1,5.1,23,17.9,13.5,15.5,2,313.3,166.5,-146.8,0.3,0,-0.3,41,11.4,-29.6,836,237.3,-598.7,0,0.1,0.1,485.4,117.3,-368.1,298.6,118.1,-180.5,1.5,0.7,-0.8,306.5,126.3,-180.2,3722.5,2903.8,-818.7,2144.6,519.7,-1624.9,951.9,1475.6,523.7,942.1,1223.2,281.1,29.8,23.4,-6.4,0,1.5,1.5,1.3,0.7,-0.6,2525.6,1992.6,-533,5992.8,2402.1,-3590.7,336.7,168.9,-167.8,,,,116.5,51.2,-65.3,23.6,5.3,-18.3,159.5,63.1,-96.4,21.2,0.3,-20.9,906.3,657.1,-249.2,18.5,2.6,-15.9,7.4,10.2,2.8,63.9,11,-52.9,102,59.4,-42.6,,,,697.5,254,-443.5,7.9,0.6,-7.3,18.9,60.9,42,3.4,2.4,-1,0.7,4.8,4.1,3.2,4.6,1.4,52.2,14.9,-37.3,0.6,3.2,2.6,5.9,2.2,-3.7,0.1,4.8,4.7,3.8,1.4,-2.4,10.1,28.2,18.1,449,566.8,117.8,155,93.5,-61.5,0,0.3,0.3,27.5,21,-6.5,0.1,0.1,0,0,0.2,0.2,2162.7,977.3,-1185.4,,,,10,5.2,-4.8,25.7,10.2,-15.5,2,1.3,-0.7,5,2.4,-2.6,0.7,6.6,5.9,,,,,,,,,,0.4,2.2,1.8,43.2,186.4,143.2,88.1,18.1,-70,34.6,10.3,-24.3,348.1,239.3,-108.8,1.1,9.3,8.2,14.7,31.2,16.5,4.1,41.1,37,183.2,0.9,-182.3,17.1,1.9,-15.2,262.4,219.8,-42.6,1.4,0,-1.4,0,0,0,44.8,53.1,8.3,190.1,126.6,-63.5,,,,1468.3,484.4,-983.9,52.5,28.5,-24,57.6,253.2,195.6,0.5,25.4,24.9,17.8,23.4,5.6,31.1,52.6,21.5,0,22.9,22.9,1240.9,367.3,-873.6,216.9,75.2,-141.7,14.9,0.8,-14.1,155.3,18.2,-137.1,158.5,9.9,-148.6,26.7,0.9,-25.8,1311,454.8,-856.2,232,120.7,-111.3,0.2,0.1,-0.1,100,1.7,-98.3,2066.6,874.1,-1192.5,1333.9,1582.9,249,773,211.9,-561.1,0,0,0,21.2,4.5,-16.7,939.9,599.1,-340.8,111.2,5.4,-105.8,0.1,0,-0.1,10.5,0.2,-10.3,11455,1962.7,-9492.3,15.9,0.8,-15.1,0,3.9,3.9,3046.7,1982.3,-1064.4,896.4,1009.2,112.8,2585.1,1503.9,-1081.2,10561.4,4151,-6410.4,565.8,1139.2,573.4,0,0,0,0.1,0.1,0,0,0.1,0.1,0,0.329396,0.329396,23.5,2.4,-21.1,152.7,148,-4.69999999999999,0.3,0.1,-0.2,0.3,1,0.7,0,0,0,0.5,0.4,-0.1,0.1,0.1,0,0.3,0.1,-0.2,0.062911,0.188946,0.126035,0,0.4,0.4,0.000481,0,-0.000481,1.8,1.6,-0.2,0,0,0,5.5,6.5,1,0.5,1.7,1.2,0.6,1.4,0.8,0.9,1.5,0.6,0,0.1,0.1,17.3,1.4,-15.9,0.5,0.3,-0.2,34.1,30.3,-3.8,189.6,74.5,-115.1,5.2,12.1,6.9,145.732948,10.179418,-135.55353,72.6,160.7,88.1,0.2,0.4,0.2,,,,0,0,0,48.8,8.8,-40,0.1,1.8,1.7,12.4,6,-6.4,0.1,4,3.9,0.2,1.2,1,5.4,5.7,0.3,0.5,2.6,2.1,22.7,4.6,-18.1,6.8,16.1,9.3,0,0.8,0.8,0.1,9.2,9.1,0.2,1.1,0.9,544.1,90,-454.1,0.5,0.3,-0.2,159.5,3.6,-155.9,0,8.1,8.1,0,0.2,0.2,0.2,2.2,2,0,2.9,2.9,320.6,51,-269.6,10.8,2.2,-8.6,0,0.7,0.7,0.3,0.2,-0.1,0,0,0,4,2.2,-1.8,54.6,1.7,-52.9,0,0.1,0.1,0.3,0.2,-0.1,0,2.5,2.5,5,17.6,12.6,0,0.4,0.4,0,0.9,0.9,2.5,1.4,-1.1,17.8,18.7,0.899999999999999,0.7,0.5,-0.2,0.1,0,-0.1,3.3,4.8,1.5,27.4,3.3,-24.1,0.4,10.9,10.5,5.4,2.9,-2.5,0,0,0,0,0,0,0,0.1,0.1,0,0,0,402.3,211,-191.3,25.1,2.1,-23,4.9,2.6,-2.3,0.1,2.1,2,9.7,0.6,-9.1,8,4.8,-3.2,9.5,4.8,-4.7,24.7,0.5,-24.2,0,51,51,0,0,0
2002-11-01,4591.3,1641,-2950.3,20511.7,12703,-7808.7,102120,58815,-43305,7227.338733,0,-7227.338733,10003.920101,5340.9,-4663.020101,17595,14623,-2972,8349.3,5614.1,-2735.2,6144.4,4693.4,-1451,29168.6,22514.7,-6653.9,23175.168664,14046.513008,-9128.655656,1932.596057,763.160213,-1169.435844,36152.3,14923.2,-21229.1,102564.5,59670.2,-42894.3,41458.629833,16444.265133,-25014.3647,,,,681,1164.7,483.699999999999,1610,562.6,-1047.4,3.6,0.2,-3.4,17684.9,13908.3,-3776.6,0.3,0.1,-0.2,11483.8,8606.4,-2877.4,218,203.6,-14.4,3.9,19.7,15.8,151.4,155.2,3.79999999999998,271.2,258.3,-12.9,55.9,46.7,-9.2,278.3,268.2,-10.1,19.8,177.5,157.7,1.4,75.3,73.9,28.1,91.4,63.3,0,21.5,21.5,35.4,134.8,99.4,0.7,5.3,4.6,0.8,22.2,21.4,18.2,58.3,40.1,355.6,347.7,-7.90000000000003,0,1.8,1.8,1.5,6.2,4.7,4.5,4.4,-0.0999999999999996,0.1,8.1,8,0,0.3,0.3,0.4,4,3.6,1.2,9.6,8.4,0.1,4.9,4.8,0.3,10.1,9.8,2.5,26.5,24,277.1,74.9,-202.2,52.8,80,27.2,,,,,,,77,31.4,-45.6,0.1,4.6,4.5,0.1,2.5,2.4,505.1,295.3,-209.8,1459.2,469.9,-989.3,10.3,10.5,0.199999999999999,11.4,10.4,-1,0.1,0.4,0.3,180.5,135.2,-45.3,198.2,153,-45.2,19,9.8,-9.2,252.8,222.2,-30.6,1295.8,1037.4,-258.4,3.9,19.8,15.9,20.8,16.4,-4.4,330.9,158,-172.9,0,0,0,50.5,12,-38.5,846,268.3,-577.7,0,0,0,421.3,109.7,-311.6,266.2,149.6,-116.6,1.1,0.9,-0.2,300.8,112.4,-188.4,3506.7,2618.6,-888.1,2020.6,673,-1347.6,823.3,1490.4,667.1,809.2,1259.1,449.9,29.5,21.6,-7.9,0,0.5,0.5,1.3,0.7,-0.6,2274.9,1703.7,-571.2,5750.4,2419,-3331.4,295.6,212.4,-83.2,,,,105.8,49.6,-56.2,28,8.7,-19.3,460,51.5,-408.5,17,0.8,-16.2,845.2,621.3,-223.9,8,6.4,-1.6,25.8,12.9,-12.9,21.8,9.5,-12.3,98.3,50.1,-48.2,,,,802.7,207.5,-595.2,15.4,2.5,-12.9,18.5,16.1,-2.4,2.6,1.9,-0.7,0.8,5.6,4.8,2.8,6.5,3.7,40,17.2,-22.8,0.3,1.9,1.6,2.6,2.8,0.2,0,2.1,2.1,11.4,0.9,-10.5,8.5,8,-0.5,560.2,441.7,-118.5,140.8,89,-51.8,0.6,0.5,-0.1,28.8,20.8,-8,0.2,0.4,0.2,0.1,0.4,0.3,2033.2,913.7,-1119.5,,,,8.8,5.6,-3.2,22.7,13.1,-9.6,0.8,6.4,5.6,7.6,1.5,-6.1,0.8,4.1,3.3,,,,,,,,,,0.5,2.3,1.8,53.8,97.3,43.5,79.6,19.5,-60.1,45.4,9.4,-36,276.9,274.5,-2.39999999999998,1.6,10.7,9.1,31.2,16.2,-15,4.6,18.6,14,213.5,0.8,-212.7,11.8,3.2,-8.6,281,246.5,-34.5,0,0,0,0,0,0,35.5,48.8,13.3,190.5,89,-101.5,,,,1073.1,412.3,-660.8,24.5,30.4,5.9,82,251.1,169.1,32.8,14.1,-18.7,33.6,16.2,-17.4,41,27,-14,2.5,2.6,0.1,892.8,410.2,-482.6,188.5,59.8,-128.7,16.5,1.5,-15,117,18.9,-98.1,114.2,23.6,-90.6,33.3,2.1,-31.2,1320.8,466.7,-854.1,286.7,45.1,-241.6,0.1,0.5,0.4,97.2,4.1,-93.1,2009.3,723,-1286.3,1355.5,1302.4,-53.0999999999999,780.7,267.9,-512.8,0,0,0,35.8,4.1,-31.7,840.3,598.8,-241.5,97.7,4.8,-92.9,0,0,0,11.3,0.4,-10.9,12569.6,2160.8,-10408.8,13.8,0.1,-13.7,0,1,1,3410.3,1799.9,-1610.4,818,1089.2,271.2,2765.5,1422.5,-1343,10814.9,4411.5,-6403.4,496.2,984.9,488.7,0,0.1,0.1,0,0.1,0.1,0,0.3,0.3,0,0.0235,0.0235,6.8,0.9,-5.9,151.9,152.3,0.400000000000006,0.2,0.1,-0.1,0.1,0.9,0.8,0,0,0,0.4,1.6,1.2,0,0.3,0.3,0,0,0,0.027289,0.250086,0.222797,0.1,0.6,0.5,0.031875,0,-0.031875,1.6,4.1,2.5,0,0.007741,0.007741,3.4,6.3,2.9,0.5,2.6,2.1,1.3,3.3,2,1.5,2.9,1.4,0.2,0.1,-0.1,16.3,1.8,-14.5,0.5,0.7,0.2,38,20.6,-17.4,186.9,41.4,-145.5,4.4,8.9,4.5,176.431941,10.218441,-166.2135,92.4,129,36.6,0,0,0,,,,0,0,0,38.9,12.5,-26.4,0.1,1.8,1.7,9.8,13.2,3.4,0.3,4.8,4.5,0.6,1,0.4,4.4,3.5,-0.9,0.7,2,1.3,84.7,8,-76.7,5.4,22.8,17.4,0,0.9,0.9,0,3.7,3.7,0.2,2.4,2.2,569.2,75.1,-494.1,0.1,1.1,1,126,3.3,-122.7,0.2,12.1,11.9,0.9,0,-0.9,0.1,0.6,0.5,0,3.8,3.8,329.8,71.8,-258,3.8,5.5,1.7,0,0,0,0.1,0.2,0.1,0,0.1,0.1,4.9,2.1,-2.8,7.9,1.2,-6.7,0,0,0,0.3,0.6,0.3,0,0.1,0.1,3.4,17.9,14.5,0,3.1,3.1,0.4,10.4,10,1,1.8,0.8,14.3,19.1,4.8,2,0.9,-1.1,0.1,0,-0.1,1.9,4.1,2.2,19.7,1.8,-17.9,0.3,10.7,10.4,8,3,-5,0,0,0,0.7,0,-0.7,0,0.1,0.1,0,0,0,315.5,235.8,-79.7,2.1,2.2,0.1,2.3,2.5,0.2,0.5,3.1,2.6,14.5,0.2,-14.3,9.7,1.6,-8.1,7.3,1.8,-5.5,21.1,0,-21.1,0,43.8,43.8,0,0,0
2002-12-01,4611.2,1459.4,-3151.8,21271.6,11817.5,-9454.1,103460,56789,-46671,6331.299599,0,-6331.299599,8591.587642,4626.1,-3965.487642,16801,14149,-2652,7926.6,5538.8,-2387.8,5874.4,4086.6,-1787.8,26379.9,19514.9,-6865,23827.003011,13278.102312,-10548.900699,1905.887316,992.394206,-913.49311,35064,14735.3,-20328.7,99419,55248.1999999999,-44170.8000000001,40614.01244,15871.75761,-24742.25483,,,,814.4,1466.2,651.8,1530,525.8,-1004.2,2.2,0.9,-1.3,16231.9,12160.7,-4071.2,0.7,0,-0.7,10148.1,7354.2,-2793.9,240.2,173,-67.2,5.9,14.3,8.4,171.4,138.2,-33.2,299.7,211.2,-88.5,57,41,-16,259.5,281,21.5,23.8,137.6,113.8,3,22,19,51.9,93,41.1,0,8.6,8.6,39,137.2,98.2,0.4,6,5.6,0.9,21,20.1,26,57,31,356.3,312.2,-44.1,0,1.7,1.7,15.6,5.3,-10.3,3.9,4,0.1,0.3,6.6,6.3,0.1,0.3,0.2,0.4,3.7,3.3,1,10.6,9.6,0.1,3.6,3.5,0.3,4.8,4.5,2.2,26.2,24,229.9,116.7,-113.2,14.4,84.2,69.8,,,,,,,48.8,79.1,30.3,0.1,5.2,5.1,0.1,2.8,2.7,512.3,317.8,-194.5,964.8,164.7,-800.1,8.4,12.8,4.4,15.5,9.1,-6.4,1.1,0.6,-0.5,206,115.4,-90.6,191.6,126.7,-64.9,11.5,15.1,3.6,375.2,232.7,-142.5,1389.7,882,-507.7,4.7,29.6,24.9,16.1,20.8,4.7,325.2,151.1,-174.1,0,0,0,27.3,8.4,-18.9,902.1,253.7,-648.4,0,0.3,0.3,601.8,124.3,-477.5,307.2,109,-198.2,1,0.2,-0.8,272.8,96,-176.8,3344.4,2524,-820.4,2010.8,659.7,-1351.1,907,1484.4,577.4,809.8,1024.8,215,26.5,19.6,-6.9,0,0.3,0.3,1.3,0.7,-0.6,2522.5,1384.1,-1138.4,6155.7,2194,-3961.7,337.2,188.1,-149.1,,,,110.4,55.4,-55,29.1,7.5,-21.6,220.6,52.1,-168.5,20.2,0.2,-20,783.3,737.5,-45.8,17.1,19.7,2.6,45.8,9.7,-36.1,17.9,15.2,-2.7,109.1,64.8,-44.3,,,,664.9,168.7,-496.2,10.3,2.8,-7.5,26.6,14,-12.6,2.6,5.4,2.8,0.4,13.5,13.1,0.8,9,8.2,26.7,19.7,-7,1.3,5.5,4.2,2.1,0.9,-1.2,0,6.2,6.2,5.6,4.1,-1.5,2.6,10.1,7.5,567.1,532.8,-34.3000000000001,139.2,97,-42.2,0.2,0.5,0.3,27.3,20.3,-7,0.1,0.5,0.4,0.1,0.8,0.7,2295.1,900.7,-1394.4,,,,9.2,6.3,-2.9,56.2,12.6,-43.6,0.8,4.2,3.4,3.8,1.3,-2.5,0.7,6.7,6,,,,,,,,,,0.5,0.6,0.1,38,85.1,47.1,55.7,30.3,-25.4,31.1,10.6,-20.5,274.4,266.9,-7.5,2.8,7,4.2,25.1,18,-7.1,7.9,30.1,22.2,340.2,0.5,-339.7,15.8,7.6,-8.2,263,240.1,-22.9,0.1,0,-0.1,0,0,0,42,27.2,-14.8,195.5,116,-79.5,,,,1476.3,424.6,-1051.7,19.8,49.1,29.3,82.1,215.7,133.6,0.5,32.1,31.6,20,18.6,-1.4,45.1,25.5,-19.6,0.2,2.6,2.4,888.6,416.1,-472.5,177.7,57.2,-120.5,16,2.3,-13.7,109.2,23,-86.2,134.2,10,-124.2,30,1.3,-28.7,1282.1,416.5,-865.6,304.9,49.9,-255,0.3,0.1,-0.2,97,2.6,-94.4,1912.1,727.6,-1184.5,1301.2,1014.8,-286.4,706.9,262.1,-444.8,0,0,0,15.8,3.9,-11.9,841.9,619.8,-222.1,98.1,4.8,-93.3,0.2,0,-0.2,11.7,0.2,-11.5,11625,2049.1,-9575.9,14.9,0.4,-14.5,0.1,1.1,1,3154.8,2044.2,-1110.6,725.4,1054.7,329.3,2745.2,1425,-1320.2,11143.4,4081.9,-7061.5,587.5,1290.9,703.4,0,0,0,0,0,0,0,0,0,0,0.000275,0.000275,3.6,2.5,-1.1,203.2,153.8,-49.4,0.1,0.1,0,0.2,0.9,0.7,0,0,0,0.4,0.7,0.3,0,0.2,0.2,0,0,0,0.0577,0.313941,0.256241,0.1,0.2,0.1,0.005621,0,-0.005621,0.6,3.7,3.1,0,0.000438,0.000438,2.7,5.2,2.5,0.5,1.8,1.3,1.5,2.5,1,0.7,1.6,0.9,0,0.1,0.1,12.8,1.2,-11.6,0.5,0.4,-0.1,35.1,24.7,-10.4,235.7,153.9,-81.8,12.1,13.8,1.7,142.693125,7.164489,-135.528636,93.1,273.2,180.1,0.6,0.5,-0.1,,,,0,0,0,11.9,11,-0.9,0.4,8.5,8.1,2.2,14.6,12.4,0.2,10,9.8,0.2,1.1,0.9,2.8,4.9,2.1,0.4,1.5,1.1,41.5,4.4,-37.1,12.1,14,1.9,0.1,2.4,2.3,0.1,3.3,3.2,0.3,1.6,1.3,574.1,65.1,-509,0.6,1.9,1.3,87.3,5.2,-82.1,0.3,4.9,4.6,0,0.5,0.5,0,3.2,3.2,0,5.5,5.5,221.8,22.6,-199.2,27,5.5,-21.5,0,0,0,0.2,0.7,0.5,0,0.1,0.1,0.7,2.2,1.5,29.3,0.9,-28.4,0.1,0,-0.1,0.5,1.3,0.8,0,0.6,0.6,2.5,14.3,11.8,0,7,7,0.1,7.6,7.5,1.2,5.3,4.1,16.3,67.4,51.1,3.4,0.5,-2.9,0,0.1,0.1,1.4,3.8,2.4,18,2.9,-15.1,6,11.2,5.2,11.7,4.5,-7.2,0,0,0,0,0.1,0.1,0,0.2,0.2,0,0,0,401,184,-217,3.8,3.1,-0.7,1.8,1.7,-0.1,0.7,11.5,10.8,9.9,0.3,-9.6,5.4,5.5,0.0999999999999996,7.2,5.4,-1.8,24.8,0,-24.8,0,38.1,38.1,0,0,0
2003-01-01,4827.229934,1126.036445,-3701.193489,18656,12073.1,-6582.9,102284,58068,-44216,6857.075506,0,-6857.075506,9456.080949,4434.2,-5021.880949,15409,13060,-2349,7820.95784,5064.267019,-2756.690821,5193.472035,4037.139774,-1156.332261,28565.706979,20669.859676,-7895.847303,20950.925109,13315.773679,-7635.15143,2476.765496,789.374007,-1687.391489,32757.785148,13617.558631,-19140.226517,97490.9813130001,54854.146362,-42636.8349510001,39551.074881,15043.400649,-24507.674232,,,,750.088933,998.377598,248.288665,1991.728402,453.687919,-1538.040483,2.486787,0.219594,-2.267193,17735.235108,12889.734167,-4845.50094099999,0.461093,0.001385,-0.459708,10830.471871,7780.125509,-3050.346362,246.888788,215.184805,-31.703983,5.352117,21.105171,15.753054,148.363986,138.378245,-9.98574100000005,215.308085,228.908573,13.600488,60.251651,36.69659,-23.555061,253.733186,357.943662,104.210476,22.795295,144.890907,122.095612,0.84752,25.71213,24.86461,34.292117,92.644155,58.352038,0.027547,15.261021,15.233474,38.177604,139.821777,101.644173,0.210662,5.874327,5.663665,1.101886,25.438648,24.336762,16.214502,56.479105,40.264603,225.669461,360.408334,134.738873,0.03152,1.762725,1.731205,2.197849,6.428763,4.230914,4.077702,4.437763,0.360061,0.263177,9.943052,9.679875,0.10477,0.321062,0.216292,0.136007,3.282211,3.146204,0.974064,9.590286,8.616222,1.400167,5.16278,3.762613,0.22078,4.795239,4.574459,1.901525,26.492885,24.59136,310.453917,73.857951,-236.595966,78.198724,54.893385,-23.305339,,,,,,,54.564681,42.301799,-12.262882,0.582286,4.691314,4.109028,0.067557,2.799784,2.732227,526.302499,312.88759,-213.414909,399.474686,120.835379,-278.639307,10.168571,8.823131,-1.34544,15.567007,20.526042,4.959035,3.043417,0.661159,-2.382258,198.877398,119.742547,-79.134851,175.04362,127.633051,-47.410569,15.030633,11.207242,-3.82339099999999,400.21646,195.6557,-204.56076,1434.333961,809.298446,-625.035515,3.651319,41.187005,37.535686,12.675157,12.658387,-0.0167700000000011,273.71432,140.452377,-133.261943,0.963854,0.063269,-0.900585,17.14837,8.483161,-8.665209,661.847779,233.357431,-428.490348,0,0.013202,0.013202,312.050214,108.538263,-203.511951,267.926392,104.058617,-163.867775,0.873942,0.768542,-0.1054,235.938476,110.472695,-125.465781,3002.737444,2670.188542,-332.548902,2112.000824,679.653353,-1432.347471,882.690561,1529.24688,646.556319,774.570524,1222.693762,448.123238,24.373975,17.843393,-6.53058200000001,0.005856,0.392273,0.386417,1.096962,3.788011,2.691049,2354.303713,1369.27554,-985.028173,4876.693261,2159.991818,-2716.701443,301.268677,122.997075,-178.271602,,,,96.659781,49.080646,-47.579135,19.186019,4.199743,-14.986276,133.498785,87.547907,-45.950878,14.928929,0.345377,-14.583552,754.892041,641.798999,-113.093042,9.21706,3.614947,-5.602113,21.940691,6.224018,-15.716673,24.283372,6.306461,-17.976911,101.373178,56.454115,-44.919063,,,,653.547468,157.08948,-496.457988,9.99169,2.217628,-7.774062,39.974216,11.551208,-28.423008,1.306405,5.610673,4.304268,0.177077,4.245471,4.068394,0.290656,6.356566,6.06591,20.76535,13.554791,-7.210559,0.291575,9.629051,9.337476,4.667235,0.558107,-4.109128,0.080745,6.469943,6.389198,6.441546,2.307326,-4.13422,3.870175,10.358254,6.488079,495.761684,471.68803,-24.0736539999999,141.842576,80.109109,-61.733467,0.002026,0.424517,0.422491,25.440891,21.232304,-4.208587,0.16049,0.817323,0.656833,0.07516,0.086538,0.011378,2002.99333,956.283935,-1046.709395,,,,15.466085,5.385164,-10.080921,30.775408,10.209272,-20.566136,0.725343,1.648477,0.923134,6.059195,1.050389,-5.008806,0.619624,5.425965,4.806341,,,,,,,,,,0.441764,0.708913,0.267149,56.858084,94.865117,38.007033,75.175302,13.538528,-61.636774,38.085792,16.09872,-21.987072,315.713837,203.423062,-112.290775,1.817554,5.495047,3.677493,20.67669,10.530006,-10.146684,8.714702,17.249636,8.534934,512.69254,0.696041,-511.996499,15.822829,4.648558,-11.174271,297.3,277.9,-19.4,0.020059,0,-0.020059,0,0.04593,0.04593,43.997483,35.124451,-8.873032,151.37498,67.375266,-83.999714,,,,1615.888089,335.717002,-1280.171087,37.835204,51.651904,13.8167,218.70383,202.545967,-16.1578630000001,0.738509,10.960664,10.222155,66.504281,18.898335,-47.605946,49.038382,24.589472,-24.44891,0.483885,3.061937,2.578052,1158.38374,424.760757,-733.622983,199.541497,75.496252,-124.045245,16.065836,0.766403,-15.299433,208.250176,15.475715,-192.774461,173.320192,19.435974,-153.884218,38.378083,0.201757,-38.176326,1195.973135,407.378706,-788.594429,388.325053,51.585679,-336.739374,0.186327,0.902752,0.716425,121.263828,27.310707,-93.953121,1890.837042,719.432737,-1171.404305,1420.845862,1069.152461,-351.693401,727.67884,237.999542,-489.679298,0.520559,0,-0.520559,49.302523,2.541636,-46.760887,897.313935,623.0529,-274.261035,127.349999,4.990475,-122.359524,0.001589,0.010306,0.008717,14.325066,1.0204,-13.304666,11403.497575,2069.831893,-9333.665682,12.385325,1.313058,-11.072267,0,0.019919,0.019919,2860.887093,1726.082787,-1134.804306,821.950431,946.864029,124.913598,2717.274454,1322.167742,-1395.106712,9109.497627,3919.365968,-5190.131659,567.736059,836.71885,268.982791,0.27216,0.029076,-0.243084,0.055739,0.102704,0.046965,0.015728,0.203307,0.187579,0,0.004027,0.004027,3.138717,3.265993,0.127276,160.474991,136.091618,-24.383373,0.049465,0.018638,-0.030827,0.617662,2.201522,1.58386,0,0.001947,0.001947,0.288576,0.61154,0.322964,0.064241,0.040021,-0.02422,0.053782,0.035082,-0.0187,0.008599,0.290442,0.281843,0.061887,0.05805,-0.00383700000000002,0,0,0,1.208881,3.794634,2.585753,0,0,0,3.91602,7.195418,3.279398,0.390752,2.066708,1.675956,0.937522,2.210741,1.273219,0.648017,1.410683,0.762666,0.00251,0.116955,0.114445,9.692622,1.534054,-8.158568,0.444197,0.340331,-0.103866,37.108922,74.716058,37.607136,292.358231,32.439498,-259.918733,8.896335,17.623196,8.726861,102.150963,14.711262,-87.439701,144.258729,210.670925,66.412196,0,4.186326,4.186326,,,,0,0,0,24.246798,29.223581,4.97678300000001,0.011395,1.944765,1.93337,13.28241,7.596123,-5.686287,0.073911,6.828036,6.754125,0.166251,2.228389,2.062138,3.862925,3.975672,0.112747,0.429079,2.39436,1.965281,105.739147,6.6421,-99.097047,11.706654,11.792848,0.0861939999999954,0.017808,0.640131,0.622323,0.21492,2.090495,1.875575,0.03489,1.459781,1.424891,855.400705,72.127288,-783.273417,0.068935,0.893551,0.824616,104.585368,4.555142,-100.030226,0.119749,9.5188,9.399051,2.302818,0.147627,-2.155191,0.110166,1.428951,1.318785,0,3.012153,3.012153,297.081482,41.297867,-255.783615,40.542955,5.716435,-34.82652,1.811683,0.086855,-1.724828,0.242962,0.196417,-0.0465449999999999,0.033537,0.013015,-0.020522,8.220096,1.757957,-6.462139,12.737051,1.51493,-11.222121,0.216245,0.003141,-0.213104,0.437018,0.562874,0.125856,0.024175,0.187651,0.163476,2.6,5.1,2.5,0.00285,5.619078,5.616228,0.171779,2.074029,1.90225,1.870031,2.00133,0.131299,20.163405,5.961252,-14.202153,0.850364,0.223121,-0.627243,0.032078,0.043693,0.011615,2.947499,3.214957,0.267457999999999,38.12942,0.960558,-37.168862,0.101731,4.978345,4.876614,13.287843,0.744716,-12.543127,0,0,0,2.62362,0.008947,-2.614673,0.013218,0.045091,0.031873,0.066763,0,-0.066763,368.357726,177.315586,-191.04214,7.412303,2.366447,-5.045856,2.89622,1.669446,-1.226774,1.291987,3.845694,2.553707,11.286795,0.384548,-10.902247,5.13299,1.52305,-3.60994,4.241566,2.076972,-2.164594,28.037272,0.149696,-27.887576,0,0,0,,,
2003-02-01,4744.725577,1358.238182,-3386.487395,18766.7,12338.4,-6428.3,101719,58846,-42873,7206.515667,0,-7206.515667,9481.561161,5061.4,-4420.161161,14323,13530,-793,6516.990491,5704.230604,-812.759887,5567.559638,3952.003826,-1615.555812,28141.20515,20385.380543,-7755.82460700001,21035.880189,13509.291923,-7526.588266,2101.172146,655.651312,-1445.520834,29426.675991,14576.019403,-14850.656588,93153.940279,55917.285577,-37236.654702,35741.025262,16262.613029,-19478.412233,,,,565.30508,1152.273701,586.968621,1770.15439,416.111835,-1354.042555,1.224879,0.071243,-1.153636,17183.4588,13292.563747,-3890.895053,0.567935,0,-0.567935,10957.74635,7092.816796,-3864.929554,238.146078,193.476996,-44.6690819999999,9.392373,14.676632,5.284259,153.365969,152.432712,-0.933257000000026,262.972936,233.290169,-29.682767,56.969858,40.259914,-16.709944,286.043059,307.194539,21.15148,19.430368,96.796914,77.366546,1.073643,27.296169,26.222526,38.723447,75.203528,36.480081,0,14.065347,14.065347,33.257723,110.935695,77.677972,0.497412,5.295502,4.79809,1.886976,20.681681,18.794705,25.077773,53.245385,28.167612,336.015177,347.211498,11.1963210000001,0.231358,1.81962,1.588262,0.974899,5.080784,4.105885,3.962189,4.630049,0.66786,0.067743,9.766671,9.698928,0.00924,0.500073,0.490833,0.084924,2.783442,2.698518,1.237178,7.288279,6.051101,0.168827,2.68456,2.515733,0.596744,4.891399,4.294655,2.814029,21.252516,18.438487,286.900467,72.973869,-213.926598,62.504183,65.40545,2.90126699999998,,,,,,,133.308335,24.891888,-108.416447,0.488485,5.361471,4.872986,0.165245,1.483514,1.318269,551.286051,294.898166,-256.387885,690.051481,187.492385,-502.559096,9.491011,7.421878,-2.069133,6.853788,10.073086,3.219298,0.041938,53.551292,53.509354,239.900671,111.505859,-128.394812,178.233449,143.041823,-35.191626,13.459542,17.390015,3.930473,319.286392,192.790917,-126.495475,1305.320522,811.927089,-493.393433,2.812211,35.791759,32.979548,11.548596,16.581408,5.032812,282.316372,146.644864,-135.671508,0.590976,0.017019,-0.573957,16.533266,9.396779,-7.136487,751.366227,255.181385,-496.184842,0,0.258006,0.258006,349.787736,127.542496,-222.24524,240.535274,104.917951,-135.617323,1.014097,1.313293,0.299196,228.178843,118.607678,-109.571165,3492.789142,2781.404611,-711.384531000001,1847.78632,612.121018,-1235.665302,849.403128,1549.984337,700.581209,789.194653,1328.570835,539.376182,19.820805,14.574745,-5.24606,0.030779,1.023951,0.993172,0.997473,0.461381,-0.536092,2215.150117,1313.799694,-901.350423000001,4860.335555,2426.404305,-2433.93125,323.402044,147.768451,-175.633593,,,,97.026888,48.035843,-48.991045,22.093765,6.360361,-15.733404,283.590244,90.404833,-193.185411,18.716185,2.016067,-16.700118,728.926045,579.819041,-149.107004,12.685564,4.297991,-8.387573,85.364018,6.128658,-79.23536,59.079565,8.539625,-50.53994,82.980621,54.901723,-28.078898,,,,715.085267,145.71609,-569.369177,16.511832,1.966074,-14.545758,25.096404,12.646801,-12.449603,1.854353,3.229033,1.37468,1.493711,7.391749,5.898038,1.335984,7.401245,6.065261,10.164729,8.508078,-1.656651,0.509288,0.704543,0.195255,3.740168,0.521834,-3.218334,0.14953,1.535813,1.386283,6.184663,1.76951,-4.415153,3.378476,6.205981,2.827505,465.487683,467.511073,2.02339000000006,124.119274,70.747321,-53.371953,0.037183,0.375072,0.337889,23.94094,16.059107,-7.881833,0.012454,0.977647,0.965193,0.163343,0.062435,-0.100908,1808.050946,752.139327,-1055.911619,,,,14.836493,6.432092,-8.40440099999999,40.348538,8.249075,-32.099463,0.781218,1.098988,0.31777,12.065672,0.772555,-11.293117,0.408335,3.917919,3.509584,,,,,,,,,,0.255602,0.405532,0.14993,41.630288,147.020565,105.390277,35.415244,17.143832,-18.271412,28.916197,11.753029,-17.163168,274.75699,208.521621,-66.235369,2.36103,4.672924,2.311894,79.169343,11.794618,-67.374725,8.031679,24.807455,16.775776,767.463624,0.03631,-767.427314,15.55062,17.907636,2.357016,259.5,243.7,-15.8,0,0,0,0.023585,0,-0.023585,40.89373,20.685763,-20.207967,208.343935,87.591283,-120.752652,,,,1382.693374,369.668343,-1013.025031,14.33878,20.842852,6.504072,58.749427,370.158739,311.409312,0.1517,28.135626,27.983926,64.645059,14.49465,-50.150409,59.068179,227.153123,168.084944,1.067538,3.361093,2.293555,993.822247,388.325962,-605.496285,184.797035,45.685612,-139.111423,16.208676,1.425931,-14.782745,182.72456,14.997629,-167.726931,145.018855,9.77154,-135.247315,30.788098,0.84793,-29.940168,1093.87493,540.935052,-552.939878,337.759008,42.779284,-294.979724,0.375003,0.343729,-0.0312739999999999,103.092268,2.60564,-100.486628,1650.759221,689.279124,-961.480097,1106.227733,1425.38967,319.161937,715.398716,206.504524,-508.894192,0.476196,0,-0.476196,27.76913,1.806255,-25.962875,796.074461,651.439075,-144.635386,98.853105,4.092312,-94.760793,0.004955,0.024074,0.019119,8.451399,0.915154,-7.536245,9629.62711,2048.670815,-7580.956295,10.412472,0.774347,-9.638125,0,0.020464,0.020464,2643.098611,2162.080948,-481.017663,563.726776,953.885268,390.158492,2203.937371,1162.874718,-1041.062653,9440.491473,4136.311511,-5304.179962,387.543765,1018.870778,631.327013,0.000335,0.033664,0.033329,0,0.033235,0.033235,0.065244,0.135943,0.070699,0,0.000228,0.000228,1.403933,0.823461,-0.580472,161.764586,113.990944,-47.773642,0.114124,0.082941,-0.031183,0.495376,1.591217,1.095841,0,0,0,0.222744,0.525164,0.30242,0.075046,0.014034,-0.061012,0.049239,0.054872,0.00563300000000001,0.064248,0.689102,0.624854,0.055632,0.052861,-0.00277100000000001,0,0.008487,0.008487,0.064056,1.876113,1.812057,0,0.125496,0.125496,1.88586,7.186081,5.300221,1.127208,1.54126,0.414052,2.038638,1.796566,-0.242072000000001,0.727444,1.834395,1.106951,0,0.053602,0.053602,7.061779,1.008783,-6.052996,0.607402,0.410171,-0.197231,28.287689,28.393791,0.106102,194.716338,32.568596,-162.147742,13.826165,11.485226,-2.340939,131.8536,9.363646,-122.489954,93.914106,166.45049,72.536384,0,0.486944,0.486944,,,,0,0,0,23.047682,18.88903,-4.15865199999999,0,1.667613,1.667613,18.491,2.683907,-15.807093,0.405588,3.551351,3.145763,0.093719,2.330415,2.236696,6.04093,1.931945,-4.108985,0.393821,1.96319,1.569369,32.022451,5.98419,-26.038261,5.461277,23.529569,18.068292,0,0.80471,0.80471,0.040077,1.872659,1.832582,0.062102,1.212601,1.150499,697.419282,65.467514,-631.951768,0.365259,0.224246,-0.141013,207.740642,3.844218,-203.896424,0.005934,2.158544,2.15261,0.262439,0.004491,-0.257948,0.040669,0.824679,0.78401,0.000265,1.647053,1.646788,300.356379,38.696958,-261.659421,49.275598,3.697116,-45.578482,0.013026,0.008074,-0.004952,0.147526,0.240326,0.0928,0.020927,0.155808,0.134881,0.0855,2.635662,2.550162,32.850201,1.883137,-30.967064,0.227827,0.024814,-0.203013,0.022482,2.482798,2.460316,0.0121,0.06208,0.04998,6.1,7.4,1.3,0.101992,0.620185,0.518193,0.132153,1.561398,1.429245,2.586188,2.850012,0.263824,16.432169,8.964628,-7.467541,0.208313,0.146214,-0.0620990000000001,0.011019,0.551574,0.540555,1.233805,4.048684,2.814879,22.38417,1.605906,-20.778264,0.347675,5.536033,5.188358,25.349065,2.05691,-23.292155,0,0,0,0.44155,0.000131,-0.441419,0,0.058513,0.058513,0,0.026796,0.026796,276.25072,178.926213,-97.324507,2.118019,2.708951,0.590932,1.409985,2.159069,0.749084,0.482223,1.322082,0.839859,8.582989,1.48509,-7.097899,7.805423,1.769662,-6.035761,3.933649,0.605767,-3.327882,23.388957,0.312724,-23.076233,0,0,0,,,
2003-03-01,6564.901763,1562.231913,-5002.66985,22053.6,14267.9,-7785.7,105340,59077,-46263,7579.174999,0,-7579.174999,10705.069317,5513.2,-5191.869317,16819,15982,-837,7185.108683,6265.251129,-919.857553999998,6777.326725,4522.379094,-2254.947631,31605.40216,23164.488985,-8440.913175,24875.722895,15835.824022,-9039.89887299999,3039.113222,777.760387,-2261.352835,32232.508321,16195.910902,-16036.597419,105842.309812,63524.2302,-42318.0796120001,38814.811759,18071.837441,-20742.974318,,,,728.288831,1151.276513,422.987682,2423.314927,542.231176,-1881.083751,1.077173,0.663758,-0.413415,19822.528576,15359.589875,-4462.938701,0.567047,0,-0.567047,11782.873584,7804.89911,-3977.974474,261.59989,241.355224,-20.244666,12.201235,23.82945,11.628215,189.049006,182.884458,-6.16454799999997,304.243123,250.655477,-53.5876460000001,73.110772,48.282136,-24.828636,307.536134,330.659636,23.1235019999999,20.40199,132.169404,111.767414,1.942056,30.559098,28.617042,57.454675,118.47805,61.023375,0.056012,18.237838,18.181826,39.118657,113.791469,74.672812,0.600113,5.034129,4.434016,0.206401,24.315267,24.108866,27.03651,60.158562,33.122052,388.276787,377.50335,-10.773437,0.157266,1.381985,1.224719,3.167007,5.472962,2.305955,4.258008,4.054949,-0.203059000000002,0.277994,13.808885,13.530891,0.0015,0.611258,0.609758,0.196663,3.977708,3.781045,1.484252,12.115451,10.631199,0.268177,3.526276,3.258099,0.800221,4.597456,3.797235,1.731087,22.037556,20.306469,351.013874,72.12598,-278.887894,71.522647,97.54412,26.021473,,,,,,,72.700455,35.27967,-37.420785,1.00209,6.47328,5.47119,0.056463,2.115317,2.058854,540.09537,310.921166,-229.174204,1458.043724,182.81759,-1275.226134,10.647976,11.562113,0.914137,8.323667,21.899753,13.576086,0,0.616349,0.616349,189.540786,125.567521,-63.973265,195.335,168.179777,-27.155223,13.687372,23.130659,9.44328700000001,389.666315,231.216814,-158.449501,1535.155292,936.9169,-598.238392,4.99942,39.235561,34.236141,16.325918,28.65245,12.326532,224.032927,198.567516,-25.465411,0.001893,0.058524,0.056631,20.64315,41.239362,20.596212,995.866728,359.685921,-636.180807,0,1.529812,1.529812,433.359567,117.804501,-315.555066,359.13703,149.276329,-209.860701,1.723122,1.980205,0.257083,346.872093,140.131484,-206.740609,3728.710272,3299.885233,-428.825039,1948.704362,569.389588,-1379.314774,958.591817,1861.334493,902.742676,853.817023,1295.471978,441.654955,23.214259,31.040324,7.826065,0.008026,0.914992,0.906966,1.456064,0.22636,-1.229704,2329.247385,1717.191861,-612.055524,6270.959356,2803.263752,-3467.695604,366.01973,172.425251,-193.594479,,,,129.250449,58.245395,-71.005054,25.138774,8.025358,-17.113416,291.50174,117.272525,-174.229215,16.972918,0.168041,-16.804877,934.23153,702.717564,-231.513966,17.061984,8.885279,-8.17670499999999,75.705065,5.140586,-70.564479,46.968738,12.378377,-34.590361,110.885972,67.457508,-43.428464,,,,804.288171,190.281684,-614.006487,58.023694,1.833738,-56.189956,26.274197,18.871956,-7.402241,2.086185,4.773839,2.687654,0.741455,6.588786,5.847331,10.474407,7.752194,-2.722213,24.929613,13.061708,-11.867905,0.347944,2.618053,2.270109,4.908581,1.313415,-3.595166,0.034387,2.24327,2.208883,4.673446,2.630383,-2.043063,3.640791,17.158082,13.517291,564.707321,480.076415,-84.630906,180.705184,66.997665,-113.707519,0.160402,9.204807,9.044405,33.477309,19.375835,-14.101474,0.030683,0.357153,0.32647,0.001954,0.69559,0.693636,2291.003418,848.91825,-1442.085168,,,,16.241612,6.713456,-9.528156,46.754756,17.803573,-28.951183,0.627453,1.55351,0.926057,4.061184,2.273857,-1.787327,1.074216,3.920667,2.846451,,,,,,,,,,0.602216,0.558518,-0.0436979999999999,57.254002,88.909473,31.655471,52.259358,25.743852,-26.515506,49.233487,26.65007,-22.583417,348.973696,354.558907,5.58521099999996,2.084619,69.303237,67.218618,22.321956,15.990322,-6.331634,14.418715,27.089182,12.670467,692.669718,0.431486,-692.238232,13.160626,17.711996,4.55137,293.7,244.4,-49.3,0.062712,0,-0.062712,0.047822,0.044259,-0.00356300000000001,48.635595,91.112471,42.476876,232.020053,155.92245,-76.097603,,,,1692.647811,408.696708,-1283.951103,36.919699,35.937013,-0.982686000000001,67.413226,432.692487,365.279261,0.890169,20.27156,19.381391,19.827557,28.032086,8.204529,60.787131,34.0408,-26.746331,3.895148,1.645295,-2.249853,1103.516142,374.661553,-728.854589,174.019301,53.266988,-120.752313,18.554938,0.567516,-17.987422,165.833364,18.367449,-147.465915,166.140945,10.352318,-155.788627,31.038557,0.92217,-30.116387,1204.350906,496.716991,-707.633915,321.028417,70.797776,-250.230641,0.098902,0.032116,-0.066786,99.803249,2.700284,-97.102965,1936.066782,848.093179,-1087.973603,1231.278625,1565.553639,334.275014,809.796761,232.892913,-576.903848,0.446151,0,-0.446151,48.944449,3.026065,-45.918384,936.213566,815.758673,-120.454893,76.64323,4.730594,-71.912636,0.00102,0.083179,0.082159,8.152885,0.325839,-7.827046,10110.044562,2423.104708,-7686.939854,10.330109,0.352093,-9.978016,0,0,0,2896.731631,2181.46925,-715.262381,562.702094,1183.425062,620.722968,2494.396333,1334.803178,-1159.593155,10434.623207,4470.377379,-5964.245828,470.480077,992.261611,521.781534,0.008894,0.057445,0.048551,0.0005,0.013737,0.013237,0.026711,0.007058,-0.019653,0,0.002815,0.002815,1.501796,1.714219,0.212423000000001,223.085208,138.700432,-84.384776,0.492039,0.017064,-0.474975,0.486113,0.838361,0.352248,0,0,0,0.226021,0.800228,0.574207,0.110187,0.155669,0.045482,0.071338,0.06003,-0.011308,0.073018,0.22433,0.151312,0.534335,0.028661,-0.505674,0,0.00048,0.00048,0.562128,1.591025,1.028897,0,0.007103,0.007103,3.865705,6.316838,2.451133,14.002755,3.527169,-10.475586,0.67429,1.584559,0.910269000000001,0.146647,1.13701,0.990363,0,0.077837,0.077837,11.294484,1.643598,-9.650886,0.650213,0.300499,-0.349714,26.495464,25.716675,-0.778789,463.70585,26.368522,-437.337328,10.454972,17.827036,7.372064,163.945429,19.966974,-143.978455,115.119573,164.492951,49.373378,0.052645,0.840961,0.788316,,,,0,0,0,79.360718,33.665463,-45.695255,0.107407,3.660629,3.553222,5.207425,5.765428,0.558003000000001,0.290159,5.235516,4.945357,0.356223,5.543015,5.186792,7.68272,4.19178,-3.49094,0.603508,2.117588,1.51408,72.035077,8.327389,-63.707688,4.935,22.404928,17.469928,0.00148,15.704649,15.703169,0.053738,4.088484,4.034746,4.24515,1.014754,-3.230396,1098.524295,68.760748,-1029.763547,0.182286,1.20469,1.022404,191.481933,9.064626,-182.417307,0.268966,11.410887,11.141921,0,0.879781,0.879781,0.073436,1.714061,1.640625,0.012026,3.029541,3.017515,421.859046,29.294157,-392.564889,41.293104,3.524923,-37.768181,0.0184,0.01971,0.00131000000000001,0.903963,0.053852,-0.850111,0.000761,0.076933,0.076172,12.198444,2.881859,-9.316585,10.544669,1.135422,-9.409247,0.786437,0.711346,-0.0750910000000001,0.137082,1.266045,1.128963,0.003716,0.100164,0.096448,5.7,13.3,7.6,0.000968,0.412505,0.411537,0.003469,0.884437,0.880968,1.912974,4.511452,2.598478,20.145376,14.520308,-5.625068,6.009572,0.372225,-5.637347,0,0.048845,0.048845,1.423874,4.277583,2.853709,20.656907,3.388039,-17.268868,0.461846,4.979772,4.517926,14.623869,2.025464,-12.598405,0,0,0,0.318806,0.015996,-0.30281,0.022436,0.194956,0.17252,0,0.000445,0.000445,342.651579,220.055638,-122.595941,7.706985,4.215583,-3.491402,0.253716,1.954471,1.700755,0.434382,1.622095,1.187713,11.918663,0.754723,-11.16394,4.384948,4.742055,0.357106999999999,4.521985,0.852103,-3.669882,30.677323,0.000253,-30.67707,0,0,0,,,
2003-04-01,6296.29247,1279.042985,-5017.249485,21144.4,13214.8,-7929.6,103175,58573,-44602,6906.947805,0,-6906.947805,10104.934396,5459.6,-4645.334396,16353,13946,-2407,7873.943554,5365.768257,-2508.175297,6854.338564,4071.26357,-2783.074994,29609.132429,22461.944801,-7147.18762799999,23749.556773,14619.633178,-9129.923595,2447.320445,791.134481,-1656.185964,34249.957134,14724.177548,-19525.779586,103869.208865,59162.211843,-44706.997022,40416.162829,16166.108613,-24250.054216,,,,792.355482,1039.80088,247.445398,1885.810937,556.387361,-1329.423576,0.221355,0.066728,-0.154627,18454.365079,14646.3945,-3807.970579,0.120988,0.022499,-0.098489,11154.76735,7815.550301,-3339.217049,263.486892,172.303733,-91.183159,6.471015,14.430303,7.959288,159.577569,161.464597,1.88702799999999,264.309859,236.828946,-27.480913,65.35913,42.913574,-22.445556,276.251537,276.671146,0.419609000000037,22.982538,138.027598,115.04506,1.084522,28.868545,27.784023,43.280452,100.961385,57.680933,0.124204,20.905184,20.78098,37.368146,114.821387,77.453241,0.303515,5.987367,5.683852,1.20212,23.332328,22.130208,28.128048,51.495352,23.367304,383.691232,355.789203,-27.902029,0.027791,1.202062,1.174271,12.04608,7.294242,-4.751838,3.400564,4.704018,1.303454,2.528073,12.223626,9.695553,0.304586,1.074249,0.769663,0.5191,2.62129,2.10219,0.992628,13.003133,12.010505,0.143415,4.145664,4.002249,0.746033,3.799861,3.053828,4.662217,28.889123,24.226906,359.896614,78.418204,-281.47841,127.987652,60.659945,-67.327707,,,,,,,65.629039,23.085428,-42.543611,0.262777,3.358199,3.095422,0.027733,1.40102,1.373287,558.135498,279.944642,-278.190856,1648.368854,178.763641,-1469.605213,9.811054,8.472777,-1.338277,14.146093,12.928798,-1.217295,0,0.439738,0.439738,210.909683,125.072825,-85.836858,169.25425,133.065802,-36.188448,14.847495,10.729469,-4.118026,401.605861,233.34018,-168.265681,1426.8636,847.168592,-579.695008,4.5274,38.707806,34.180406,15.977138,27.695589,11.718451,247.096557,183.689907,-63.40665,0,0.563092,0.563092,21.801187,11.510599,-10.290588,937.035099,272.53548,-664.499619,0,0.055062,0.055062,502.684877,115.392592,-387.292285,328.559511,123.942994,-204.616517,0.727685,1.111202,0.383517,321.941331,103.632492,-218.308839,3514.941737,2729.086091,-785.855646000001,2061.819718,714.99157,-1346.828148,951.354512,1816.125209,864.770697,763.3794,1198.294853,434.915453,17.78192,25.486254,7.704334,0.030317,0.358233,0.327916,0.815925,34.718461,33.902536,2423.690355,1567.514362,-856.175993,5942.560333,2476.511198,-3466.049135,351.323778,163.339053,-187.984725,,,,111.356223,52.457306,-58.898917,26.918808,6.157381,-20.761427,249.794913,50.394492,-199.400421,22.829542,0.90401,-21.925532,922.114584,659.822026,-262.292558,11.282926,9.494874,-1.788052,10.258805,6.442005,-3.8168,22.3343,10.328056,-12.006244,109.926149,53.431925,-56.494224,,,,567.082539,194.285825,-372.796714,15.853067,1.539385,-14.313682,14.279485,19.838657,5.559172,1.377908,2.189009,0.811101,1.815422,14.976806,13.161384,0.579025,6.78097,6.201945,80.250711,17.333062,-62.917649,0.112971,3.124186,3.011215,3.195539,1.049318,-2.146221,0.063927,1.084141,1.020214,4.369138,1.366972,-3.002166,4.630039,32.279755,27.649716,563.60353,604.600284,40.9967540000001,176.479865,82.218798,-94.261067,0.016893,0.558099,0.541206,23.748377,16.956153,-6.792224,0.056682,0.443156,0.386474,0,0.152629,0.152629,2118.195335,786.530748,-1331.664587,,,,18.850009,5.790578,-13.059431,46.128381,12.288276,-33.840105,0.853495,1.238759,0.385264,5.250872,2.25449,-2.996382,0.894168,4.481921,3.587753,,,,,,,,,,0.35206,1.354646,1.002586,58.179784,263.647761,205.467977,72.628157,20.738946,-51.889211,38.110872,14.398502,-23.71237,303.573405,233.708816,-69.864589,1.761182,68.38475,66.623568,6.262731,8.269357,2.006626,10.216062,18.948851,8.732789,466.245271,14.554804,-451.690467,11.530446,4.072906,-7.45754,226.7,235.5,8.80000000000001,0.160085,0.0184,-0.141685,0.106337,0,-0.106337,47.011672,18.508189,-28.503483,266.303655,148.018642,-118.285013,,,,1729.205469,378.245931,-1350.959538,27.658899,32.00043,4.341531,89.799755,203.146285,113.34653,28.492996,9.161295,-19.331701,52.021521,24.502882,-27.518639,42.996671,32.022725,-10.973946,0.993719,3.410695,2.416976,1076.425448,330.933091,-745.492357,209.318157,66.666308,-142.651849,20.555743,0.561768,-19.993975,154.420181,17.56428,-136.855901,150.459568,8.737352,-141.722216,28.581868,0.509085,-28.072783,1168.938277,404.314721,-764.623556,352.413722,212.620948,-139.792774,0.015686,0.048259,0.032573,80.712406,1.905763,-78.806643,2041.1977,917.353423,-1123.844277,1333.097107,1146.102591,-186.994516,854.746994,193.789491,-660.957503,0.123541,0,-0.123541,14.328753,3.124686,-11.204067,759.277661,620.98006,-138.297601,87.820831,4.240758,-83.580073,0.00069,0.013323,0.012633,8.613608,0.240442,-8.373166,11521.852382,2121.94668,-9399.905702,7.521343,1.477478,-6.043865,0,1.304332,1.304332,3342.224151,1919.400977,-1422.823174,624.519769,1060.746519,436.22675,2574.102527,1239.51817,-1334.584357,10332.661584,4475.001099,-5857.660485,517.94076,892.811543,374.870783,0.00272,0.167434,0.164714,0,0.029061,0.029061,0.020774,0.058751,0.037977,0,0.027625,0.027625,1.085932,1.007152,-0.0787800000000001,245.100983,128.154399,-116.946584,0.198173,0.066595,-0.131578,0.455911,0.736104,0.280193,0,0.009322,0.009322,0.291276,0.65154,0.360264,0.080321,0.107125,0.026804,0.081593,0.06435,-0.017243,0.059565,0.150363,0.090798,0.10158,0.023684,-0.077896,0.0078,0.00656,-0.00124,4.044281,1.828706,-2.215575,0.00082,0,-0.00082,3.972252,5.60064,1.628388,6.089651,2.881796,-3.207855,0.722783,2.019235,1.296452,0.002532,1.59162,1.589088,0,0.052337,0.052337,11.517714,1.26338,-10.254334,0.573576,0.392328,-0.181248,29.370062,33.130774,3.76071200000001,428.813958,21.490656,-407.323302,7.146807,15.824897,8.67809,190.223441,30.731723,-159.491718,95.753791,163.957545,68.2037539999999,0.4682,1.65456,1.18636,,,,0,0,0,19.712904,49.357467,29.644563,0.004864,6.125678,6.120814,2.582485,4.257569,1.675084,0.206522,7.875055,7.668533,0.27053,1.167674,0.897144,4.696309,2.731341,-1.964968,0.696125,2.646357,1.950232,30.344574,14.048117,-16.296457,8.691178,19.744467,11.053289,0.008788,0.781833,0.773045,0.426989,1.514575,1.087586,0.17312,0.828067,0.654947,773.619169,104.960199,-668.65897,0.003676,0.268845,0.265169,108.330866,3.763844,-104.567022,0.578369,4.995525,4.417156,0.179981,0.039671,-0.14031,0.118254,1.526884,1.40863,0.067312,1.893641,1.826329,433.254546,30.130214,-403.124332,13.121697,2.959323,-10.162374,0,0.016039,0.016039,0.321273,2.008308,1.687035,0,0.040782,0.040782,1.828688,1.053853,-0.774835,2.001967,5.332575,3.330608,1.115781,1.003231,-0.11255,0.285574,0.746141,0.460567,0.01832,0.156443,0.138123,9,4.1,-4.9,0.014259,35.758443,35.744184,0.010916,1.274341,1.263425,1.800122,7.726692,5.92657,23.176126,11.56724,-11.608886,1.743293,0.624578,-1.118715,0,0.042943,0.042943,2.265284,8.69502,6.429736,22.136257,1.576213,-20.560044,0.027288,3.518733,3.491445,40.347396,1.827176,-38.52022,0,0,0,0.05787,0.028644,-0.029226,0.244909,0.212134,-0.032775,0,0.0485,0.0485,337.683371,193.812023,-143.871348,1.763095,2.31833,0.555235,0.364177,1.136583,0.772406,1.433031,1.374377,-0.058654,10.347808,0.344381,-10.003427,6.375493,2.833128,-3.542365,3.889905,0.794383,-3.095522,25.680267,0.098482,-25.581785,0,12.237093,12.237093,,,
2003-05-01,5653.338053,1241.80407,-4411.533983,20815.2,12961.3,-7853.9,102613,58314,-44299,7362.683727,0,-7362.683727,10390.177521,6142.3,-4247.877521,15854,13969,-1885,7233.012531,5398.892721,-1834.11981,6506.534441,4138.128696,-2368.405745,30162.57802,23290.33093,-6872.24709000001,23646.174842,14365.559235,-9280.615607,2568.509676,817.182747,-1751.326929,32689.749078,14984.141919,-17705.607159,102068.405311,59983.496293,-42084.909018,38334.164643,16159.609429,-22174.555214,,,,849.690769,1209.800736,360.109967,2037.158031,550.568382,-1486.589649,0.752537,0.389853,-0.362684,18667.882854,15208.019056,-3459.863798,0.000383,0.018142,0.017759,11494.695166,8082.311874,-3412.383292,248.060515,188.534066,-59.5264490000001,5.343217,27.07754,21.734323,162.498405,165.076932,2.57852700000001,284.121604,229.232271,-54.889333,57.769136,35.984505,-21.784631,301.980698,253.459916,-48.5207820000001,24.239385,163.165453,138.926068,1.695165,30.056109,28.360944,41.525536,88.340155,46.814619,0.008476,22.038211,22.029735,33.090775,121.279202,88.188427,0.761881,7.263821,6.50194,0.185017,23.675877,23.49086,31.4078,45.634996,14.227196,403.905683,360.694019,-43.2116639999999,0.116542,1.598132,1.48159,3.324746,5.119046,1.7943,4.163419,5.864436,1.701017,0.488419,7.86307,7.374651,0.015,0.452308,0.437308,0.458481,3.73298,3.274499,1.120825,9.870977,8.750152,0.227272,3.97746,3.750188,0.947887,4.145197,3.19731,5.107152,25.456347,20.349195,330.102647,79.756674,-250.345973,58.204646,51.293057,-6.911589,,,,,,,107.658427,28.054423,-79.604004,0.007151,5.622347,5.615196,0.006774,0.706357,0.699583,464.945301,293.272071,-171.67323,1581.005763,182.267924,-1398.737839,11.778831,8.539209,-3.239622,8.881759,17.84702,8.965261,0.007392,43.732632,43.72524,202.776387,121.549752,-81.226635,157.093831,128.027344,-29.066487,14.783042,11.571279,-3.211763,276.42942,202.319304,-74.1101159999999,1397.852596,882.28638,-515.566216,2.639469,38.131086,35.491617,16.134603,26.088386,9.953783,262.298101,187.38905,-74.909051,1.365265,0.081375,-1.28389,20.323047,13.570596,-6.752451,1068.264218,267.959078,-800.30514,0,0.000387,0.000387,510.898576,118.706384,-392.192192,348.449416,144.524554,-203.924862,0.808654,1.714205,0.905551,329.116825,124.779476,-204.337349,3559.271875,2939.370561,-619.901314,1875.041909,541.790587,-1333.251322,824.741278,1590.004788,765.26351,925.826469,1318.4805,392.654031,23.255283,29.235479,5.98019600000001,0.02669,0.699048,0.672358,2.41961,0.24807,-2.17154,2236.646503,1457.704012,-778.942491,5883.183333,2489.896204,-3393.287129,373.612714,138.496603,-235.116111,,,,117.779997,57.542124,-60.237873,60.554957,8.146921,-52.408036,174.536955,57.942948,-116.594007,19.272282,0.400518,-18.871764,1002.672352,683.642154,-319.030198,9.514001,9.87492,0.360918999999999,29.492377,9.036518,-20.455859,14.898565,14.380716,-0.517848999999998,111.734636,58.398225,-53.336411,,,,781.531469,257.915267,-523.616202,7.333062,1.842204,-5.490858,14.946651,22.434531,7.48788,2.621519,5.603843,2.982324,0.157721,8.910893,8.753172,2.429633,9.631165,7.201532,22.081851,11.908896,-10.172955,0.034358,3.68936,3.655002,2.406607,0.843756,-1.562851,0.423954,0.897992,0.474038,5.542513,2.485131,-3.057382,13.555198,3.856859,-9.698339,515.200842,426.031425,-89.169417,164.738667,52.266569,-112.472098,0.009713,0.316641,0.306928,28.690595,18.251495,-10.4391,0.047744,0.272631,0.224887,0.021169,0.31547,0.294301,2054.419089,1070.864075,-983.555014,,,,13.230593,8.530292,-4.700301,31.963421,9.593942,-22.369479,1.381783,2.011817,0.630034,1.846554,1.657801,-0.188753000000001,0.985652,4.247959,3.262307,,,,,,,,,,0.406021,0.854383,0.448362,51.821107,117.84203,66.020923,55.717086,23.480046,-32.23704,31.34862,7.822195,-23.526425,316.512912,205.713534,-110.799378,2.426216,8.921457,6.495241,23.86731,18.768888,-5.098422,7.438188,19.31342,11.875232,77.058436,6.051247,-71.007189,13.249647,5.62787,-7.621777,255.4,238.8,-16.6,0.07254,0,-0.07254,0.000344,0.032962,0.032618,40.955644,37.30652,-3.64912399999999,141.878191,125.699076,-16.179115,,,,1661.497832,360.437716,-1301.060116,23.815959,23.422134,-0.393824999999996,72.697208,215.935414,143.238206,27.869196,9.31896,-18.550236,65.096727,19.668774,-45.427953,15.382775,24.424929,9.042154,0.146412,4.613364,4.466952,1040.473286,419.644834,-620.828452,202.413482,65.204896,-137.208586,13.202399,0.926801,-12.275598,151.562823,21.911705,-129.651118,113.282409,10.989579,-102.29283,27.894907,0.719304,-27.175603,1174.052458,389.264027,-784.788431,397.498175,67.581383,-329.916792,0.282844,0.3737,0.090856,81.163837,2.90652,-78.257317,1990.198282,983.102449,-1007.095833,1285.027844,1312.044887,27.0170430000001,793.13369,191.84994,-601.28375,0.0004,0,-0.0004,14.633681,4.864629,-9.769052,743.604901,667.003518,-76.6013830000002,98.163625,3.897744,-94.265881,0.111861,0.040213,-0.071648,3.022822,0.317065,-2.705757,11884.701493,1984.318683,-9900.38281,8.759242,2.094772,-6.66447,0,0,0,2750.907255,1824.79581,-926.111445,625.763023,1063.169888,437.406865,2571.314409,1198.882136,-1372.432273,9105.638216,4561.798586,-4543.83963,593.111869,1047.705674,454.593805,0.012409,0.01644,0.004031,0.04638,0.046018,-0.000361999999999987,0.047816,0.090409,0.042593,0,0.028555,0.028555,1.558173,3.803692,2.245519,231.992617,136.904283,-95.088334,0.143971,0.026325,-0.117646,0.333126,0.478481,0.145355,0,0.000528,0.000528,0.289612,1.027125,0.737513,0.074543,0.032462,-0.042081,0.049791,0.171366,0.121575,0.039728,0.427204,0.387476,0.057811,0.108982,0.051171,0,0.000371,0.000371,1.300288,3.180151,1.879863,0,0,0,3.924395,6.236213,2.311818,0.40419,3.687996,3.283806,1.446857,2.360208,0.913351,0.004672,1.503676,1.499004,0,0.038866,0.038866,14.344244,1.665413,-12.678831,0.537827,0.418556,-0.119271,36.947465,17.252218,-19.695247,361.41152,53.552373,-307.859147,9.046686,10.877064,1.830378,199.927274,21.732469,-178.194805,123.066291,184.200296,61.134005,0.449,1.853852,1.404852,,,,0,0,0,45.220975,25.088028,-20.132947,0.009877,1.563173,1.553296,10.989174,8.746475,-2.242699,0.354031,13.241777,12.887746,0.060492,5.064385,5.003893,4.67592,2.918053,-1.757867,0.641378,1.83628,1.194902,20.969549,8.629296,-12.340253,12.008764,13.376059,1.367295,0.00745,2.39889,2.39144,2.211449,2.442374,0.230925,0.212416,1.057588,0.845172,927.589807,76.934176,-850.655631,0.39719,0.226255,-0.170935,149.575677,2.56176,-147.013917,1.081423,3.168512,2.087089,0.846356,0.516051,-0.330305,0.015333,0.970648,0.955315,0.094064,2.41957,2.325506,295.017841,22.22945,-272.788391,49.520059,3.391977,-46.128082,0,0.028946,0.028946,0.282755,0.688815,0.40606,0.015607,0.054987,0.03938,7.400087,4.051987,-3.3481,6.082161,1.251637,-4.830524,0.816962,0.059193,-0.757769,0.296216,0.782887,0.486671,0.043745,2.397143,2.353398,6.2,10.7,4.5,0,4.648263,4.648263,0.008616,0.866016,0.8574,0.832199,1.769975,0.937776,20.516708,61.705073,41.188365,1.053557,0.766306,-0.287251,0.005456,0.152672,0.147216,2.671164,7.666339,4.995175,18.513095,2.843941,-15.669154,0.218165,0.954687,0.736522,51.396811,1.022501,-50.37431,0,0,0,0.217759,0.000471,-0.217288,0.027871,0.027686,-0.000185000000000001,0,0.009805,0.009805,355.315519,221.233388,-134.082131,2.59548,2.046584,-0.548896,0.962255,1.721916,0.759661,0.175948,1.566432,1.390484,10.872515,0.468098,-10.404417,4.099189,4.475932,0.376743000000001,1.721688,0.657112,-1.064576,25.056967,0.010917,-25.04605,0,2.476525,2.476525,,,
2003-06-01,5607.719153,1624.258457,-3983.460696,21285.9,12935.7,-8350.2,103398,60582,-42816,7236.721382,0,-7236.721382,10137.360227,5524.8,-4612.560227,17277,15421,-1856,7749.262875,6092.372672,-1656.890203,6513.031381,4180.902313,-2332.129068,29994.031027,23014.801394,-6979.22963300001,24021.201235,14794.982632,-9226.218603,2579.412838,812.826576,-1766.586262,34299.770481,15813.86132,-18485.909161,103957.668428,61570.19235,-42387.476078,40100.546376,17265.744294,-22834.802082,,,,748.911207,1494.488513,745.577306,1826.799508,548.718595,-1278.080913,0.534364,0.176662,-0.357702,18574.260774,15003.169455,-3571.091319,0,0.001636,0.001636,11419.770253,8011.631939,-3408.138314,233.130127,170.258811,-62.871316,8.126762,16.354594,8.227832,154.241232,137.328551,-16.912681,277.757886,236.450649,-41.307237,59.204208,33.069421,-26.134787,299.158263,250.999536,-48.1587270000001,22.281553,162.211086,139.929533,0.642157,33.470157,32.828,28.923776,88.959583,60.035807,0.019452,13.35261,13.333158,29.420278,135.61477,106.194492,0.654483,6.901983,6.2475,0.212436,21.675713,21.463277,27.667402,51.524173,23.856771,386.287721,325.147276,-61.1404449999999,0.068427,1.473167,1.40474,1.64361,5.207626,3.564016,3.359061,5.878479,2.519418,7.698192,8.917761,1.219569,0.007,0.291859,0.284859,0.561309,2.763133,2.201824,1.098399,8.335032,7.236633,0.135096,3.582178,3.447082,0.623273,4.471471,3.848198,11.429118,23.882127,12.453009,300.833958,89.117958,-211.716,60.333436,54.971809,-5.36162700000001,,,,,,,51.69894,32.933903,-18.765037,0.046501,3.191698,3.145197,0.046474,1.671372,1.624898,533.202766,300.174093,-233.028673,1533.034871,218.36722,-1314.667651,11.59813,7.337916,-4.260214,8.310793,15.87674,7.565947,0,0.777173,0.777173,228.369267,119.44674,-108.922527,179.32196,134.427921,-44.894039,15.073863,9.438525,-5.635338,252.393634,226.958437,-25.435197,1478.651876,942.207946,-536.44393,3.322539,40.94539,37.622851,15.593816,30.13945,14.545634,286.84294,204.793517,-82.049423,0.004396,0.002759,-0.001637,20.176309,47.722348,27.546039,995.39602,234.838476,-760.557544,0,0.768013,0.768013,516.467057,113.867608,-402.599449,340.109824,139.816581,-200.293243,0.422583,0.793677,0.371094,300.145006,135.362041,-164.782965,3525.060748,2948.685766,-576.374982000001,2167.31939,568.890827,-1598.428563,935.13827,1666.735782,731.597512,802.152768,1392.64366,590.490892,30.066857,19.693744,-10.373113,0.015575,1.259255,1.24368,1.619517,0.965214,-0.654303,2461.387587,1520.799816,-940.587771000001,5736.440853,2261.732622,-3474.708231,333.792363,134.626031,-199.166332,,,,121.535388,59.036803,-62.498585,137.940772,6.325521,-131.615251,277.024667,59.391487,-217.63318,18.399653,0.352024,-18.047629,823.163037,1104.890819,281.727782,17.446381,7.088209,-10.358172,18.263852,17.722865,-0.540987000000005,16.670204,14.557308,-2.11289599999999,113.90841,62.857336,-51.051074,,,,851.648529,183.617768,-668.030761,6.254881,2.362554,-3.892327,13.800143,15.272722,1.472579,1.736202,4.552023,2.815821,0.280425,6.344453,6.064028,20.079936,7.100582,-12.979354,27.42667,10.293394,-17.133276,0.174031,2.819749,2.645718,2.96146,1.890322,-1.071138,0.942159,2.726039,1.78388,6.357611,3.251272,-3.106339,8.292065,5.421958,-2.870107,566.948234,481.925149,-85.0230849999999,155.244756,60.248581,-94.996175,0.024,0.325995,0.301995,33.377768,15.262829,-18.114939,0.022992,1.337866,1.314874,0.005274,0.070662,0.065388,2108.612476,866.390464,-1242.222012,,,,12.62692,5.649525,-6.977395,35.722207,10.533916,-25.188291,1.249517,1.542446,0.292929,2.957186,7.748775,4.791589,1.008116,3.693827,2.685711,,,,,,,,,,0.231788,0.774271,0.542483,54.074892,245.681018,191.606126,56.358353,26.155596,-30.202757,29.891139,11.825122,-18.066017,310.750128,283.868109,-26.8820190000001,2.078286,4.871812,2.793526,12.749338,14.271885,1.522547,3.917935,19.7771,15.859165,0.514734,8.401604,7.88687,14.484394,7.432563,-7.051831,260.3,229.5,-30.8,0,0,0,0.019039,0.2961,0.277061,44.935537,25.856647,-19.07889,243.370018,156.640785,-86.729233,,,,1655.442115,441.776369,-1213.665746,9.35847,27.256565,17.898095,104.856047,445.868269,341.012222,0.677469,16.99741,16.319941,30.750564,21.773044,-8.97752000000001,20.07387,25.661141,5.587271,0.366513,4.035468,3.668955,1052.097661,391.82846,-660.269201,225.832406,66.955254,-158.877152,14.461096,1.860701,-12.600395,168.362224,18.416667,-149.945557,140.680599,13.396854,-127.283745,25.278834,0.521109,-24.757725,1234.544078,426.787786,-807.756292,445.20163,225.422309,-219.779321,1.290164,0.113034,-1.17713,108.369123,2.742044,-105.627079,2168.694392,896.277945,-1272.416447,1365.36207,1340.535391,-24.826679,761.124034,200.059716,-561.064318,0.332747,0,-0.332747,37.121692,4.743613,-32.378079,885.420807,622.208113,-263.212694,109.495589,4.452062,-105.043527,0.11063,0.024268,-0.086362,7.27419,0.154336,-7.119854,12127.301429,2119.621137,-10007.680292,18.954329,6.570777,-12.383552,0,1.868893,1.868893,3070.376913,2114.804488,-955.572425,691.608729,1078.354222,386.745493,2621.915163,1558.678571,-1063.236592,9738.488202,4402.596072,-5335.89213,488.299446,1316.197409,827.897963,0,0.009857,0.009857,0,0.061607,0.061607,0.014721,0.008754,-0.00596700000000001,0,0.001528,0.001528,2.496665,4.62693,2.130265,232.06535,150.705651,-81.359699,0.162795,0.075464,-0.087331,1.233885,2.291274,1.057389,0.088293,0,-0.088293,0.268382,1.296331,1.027949,0.068507,0.050143,-0.018364,0.054727,0.196291,0.141564,0.073174,0.037851,-0.035323,0.083817,0.055558,-0.028259,0,0,0,1.815507,3.424512,1.609005,0,0,0,3.177541,7.764786,4.587245,1.005539,1.942172,0.936633,1.180512,1.308604,0.128092,0.004404,1.189091,1.184687,0,0.059751,0.059751,16.086222,2.247611,-13.838611,0.795894,0.606399,-0.189495,38.433129,29.851512,-8.581617,607.796002,22.552107,-585.243895,11.408253,19.523855,8.115602,334.543069,22.189939,-312.35313,94.567115,191.502834,96.935719,0.1078,1.833709,1.725909,,,,0,0,0,114.552994,21.037412,-93.515582,0.530883,1.580684,1.049801,3.127647,5.399843,2.272196,0.427928,25.42803,25.000102,0.371982,1.925219,1.553237,7.598049,2.67363,-4.924419,0.446746,1.746818,1.300072,9.753397,7.554609,-2.198788,5.985604,16.126885,10.141281,0.026097,0.799567,0.77347,0.168039,1.988836,1.820797,0.667608,0.399092,-0.268516,677.738468,95.903259,-581.835209,0.108334,0.262849,0.154515,117.275667,9.353333,-107.922334,0.751686,3.340501,2.588815,0.304323,0.023769,-0.280554,0.069122,0.323675,0.254553,0.05672,1.477587,1.420867,322.301096,42.870801,-279.430295,19.327148,5.865406,-13.461742,0,0.028608,0.028608,0.084025,1.737551,1.653526,0.009323,0.125132,0.115809,4.220162,1.249784,-2.970378,19.1856,2.368358,-16.817242,0.289226,0.248942,-0.040284,0.076113,0.308398,0.232285,0.000314,0.737294,0.73698,3,10.7,7.7,0.04928,8.946209,8.896929,0,1.900446,1.900446,1.488106,5.898688,4.410582,20.088424,11.293506,-8.794918,0.845834,0.601453,-0.244381,0.055712,0.19175,0.136038,1.927516,3.81405,1.886534,28.471954,2.522859,-25.949095,0.478392,2.911369,2.432977,29.521887,0.920204,-28.601683,0,0,0,0.006723,0,-0.006723,0.048796,0.320172,0.271376,0,0.141982,0.141982,362.723115,230.802473,-131.920642,12.062557,1.735284,-10.327273,0.665406,1.84926,1.183854,0.54819,2.880472,2.332282,15.96104,0.329041,-15.631999,5.573951,2.210062,-3.363889,1.912804,1.334733,-0.578071,37.040573,0.199755,-36.840818,0,6.26833,6.26833,,,
2003-07-01,5821.090754,1387.443957,-4433.646797,22315.9,11834.3,-10481.6,105082,60696,-44386,7017.21014,0,-7017.21014,8656.163519,4285,-4371.163519,17493,14750,-2743,8070.596284,6225.918428,-1844.677856,7105.052908,4416.559733,-2688.493175,28204.012269,19933.768393,-8270.243876,25417.498794,13343.493661,-12074.005133,3041.817557,816.838006,-2224.979551,36679.950608,15978.136328,-20701.81428,107631.001329,57070.189918,-50560.811411,43047.967882,16964.812438,-26083.155444,,,,813.408349,1588.160325,774.751976,2387.114343,487.134252,-1899.980091,1.156659,0.170394,-0.986265,17079.352003,12029.506086,-5049.845917,0.086911,0.01708,-0.069831,11124.660266,7904.262307,-3220.397959,267.941752,190.288039,-77.653713,11.872437,16.650162,4.777725,187.623224,134.415822,-53.207402,300.046064,221.057192,-78.988872,68.151053,41.305203,-26.84585,304.67316,267.492768,-37.1803919999999,27.731478,119.037146,91.305668,1.085673,27.80848,26.722807,46.56176,84.28108,37.71932,0,23.211709,23.211709,43.514573,109.945413,66.43084,0.31623,5.82536,5.50913,0.575823,21.547517,20.971694,31.388771,51.49811,20.109339,411.659447,362.903126,-48.756321,0.097018,1.318963,1.221945,2.260097,5.652396,3.392299,3.569132,4.2778,0.708667999999999,0.370521,9.348321,8.9778,0,0.939611,0.939611,0.722309,2.175261,1.452952,1.160252,8.710989,7.550737,0.17748,3.130949,2.953469,0.258637,13.494906,13.236269,2.445399,31.404273,28.958874,459.05766,154.550593,-304.507067,13.227363,43.497731,30.270368,,,,,,,72.96206,31.454328,-41.507732,0.109289,2.881828,2.772539,0.011158,1.444751,1.433593,623.133058,317.72641,-305.406648,1539.299651,279.19928,-1260.100371,11.458201,16.214268,4.756067,13.841077,18.207703,4.366626,0.002861,0.649456,0.646595,241.027107,122.782714,-118.244393,191.045873,155.250781,-35.795092,14.905695,9.164811,-5.740884,262.316849,255.405961,-6.91088800000003,1647.269153,951.345692,-695.923461,3.423992,48.420352,44.99636,20.394643,26.577882,6.183239,277.364928,224.056796,-53.308132,0,0.0078,0.0078,13.552439,11.584892,-1.967547,976.547617,212.736424,-763.811193,0,0.098816,0.098816,465.173964,119.076006,-346.097958,289.33785,148.087739,-141.250111,2.12749,2.38908,0.26159,295.439703,120.619575,-174.820128,3711.084252,2655.362686,-1055.721566,2367.707256,633.273296,-1734.43396,955.33279,1523.610593,568.277803,982.020422,1184.184418,202.163996,29.435938,23.620183,-5.81575499999999,0.015819,0.711957,0.696138,3.147019,3.870314,0.723295,2524.293917,1192.841198,-1331.452719,5784.759572,2210.337047,-3574.422525,378.632646,174.03343,-204.599216,,,,128.33628,68.105666,-60.230614,119.984906,27.505689,-92.479217,191.143165,57.252221,-133.890944,27.601148,0.921303,-26.679845,907.273026,659.655245,-247.617781,13.295691,11.296844,-1.998847,10.227602,9.863061,-0.364540999999999,12.266447,15.997291,3.730844,112.232033,60.458067,-51.773966,,,,1092.533893,224.27276,-868.261133,6.210091,8.064329,1.854238,17.266791,21.083702,3.81691099999999,3.376328,51.781975,48.405647,1.625468,10.481662,8.856194,2.340023,4.40759,2.067567,51.469457,17.262552,-34.206905,0.696682,1.044295,0.347613,4.883777,2.993218,-1.890559,0.899007,1.30563,0.406623,6.304148,9.168459,2.864311,13.535703,9.790523,-3.74518,655.35952,416.520629,-238.838891,179.970751,45.16993,-134.800821,0.046313,0.310195,0.263882,28.982697,18.216317,-10.76638,0.128736,0.049738,-0.078998,0.010028,0.48893,0.478902,2487.164382,745.75597,-1741.408412,,,,18.131528,12.524559,-5.606969,32.705576,7.264288,-25.441288,0.969733,1.615813,0.64608,4.168018,1.353128,-2.81489,0.920987,4.07571,3.154723,,,,,,,,,,0.260491,0.290908,0.030417,47.937448,266.909416,218.971968,73.608223,24.205554,-49.402669,40.36761,9.036147,-31.331463,342.920563,295.307829,-47.612734,1.73583,5.248864,3.513034,18.738542,23.781104,5.042562,6.519463,26.560159,20.040696,45.70288,36.855813,-8.84706700000001,10.764382,5.953065,-4.811317,322.8,261.8,-61,0,0,0,0.156144,0,-0.156144,64.323727,36.623784,-27.699943,127.731008,104.512213,-23.218795,,,,1698.392947,348.305212,-1350.087735,47.435069,59.299693,11.864624,87.147465,263.148934,176.001469,5.058371,4.752653,-0.305718000000001,18.338901,82.564624,64.225723,30.310238,21.089935,-9.220303,0.541156,6.844932,6.303776,1112.456066,459.037954,-653.418112,239.436067,64.088886,-175.347181,13.116446,0.615469,-12.500977,226.693914,23.371865,-203.322049,188.118651,10.224126,-177.894525,39.271336,0.64699,-38.624346,1286.943201,395.065202,-891.877999,513.789748,44.281979,-469.507769,0.488877,0.043809,-0.445068,125.038969,2.589471,-122.449498,2330.571847,975.849664,-1354.722183,1238.684354,1598.598486,359.914132,868.066138,184.386189,-683.679949,0.15366,0,-0.15366,28.693431,2.206862,-26.486569,879.26187,718.104985,-161.156885,150.670181,3.736275,-146.933906,0.003292,0.064615,0.061323,9.313752,1.128347,-8.185405,13438.63509,2067.405578,-11371.229512,22.694477,1.313267,-21.38121,0,3.334057,3.334057,3241.029401,1949.047662,-1291.981739,871.23687,1074.450961,203.214091,2719.645659,1603.821319,-1115.82434,10128.624565,4238.007194,-5890.617371,564.284756,1388.482203,824.197447,0,0.003765,0.003765,0.011609,0.003345,-0.008264,0.008547,0.083765,0.075218,0.008101,0,-0.008101,3.831408,1.480692,-2.350716,216.715038,172.558258,-44.15678,0.173287,0.58,0.406713,0.569391,1.753277,1.183886,0,0,0,0.813657,0.70463,-0.109027,0.052412,0.453944,0.401532,0.05179,0.076943,0.025153,0.018546,0.073875,0.055329,0.099553,0.505705,0.406152,0,0,0,1.220975,4.8399,3.618925,0,0,0,4.551023,8.372664,3.821641,1.070744,2.421288,1.350544,0.814273,1.560376,0.746103,0.002693,1.288301,1.285608,0.003594,0.101501,0.097907,17.372999,1.799276,-15.573723,1.751822,0.754573,-0.997248999999999,33.487303,73.356916,39.869613,501.062413,23.958943,-477.10347,6.978045,8.382547,1.404502,266.769357,32.824767,-233.94459,111.794767,223.093997,111.29923,0.564175,1.309012,0.744837,,,,0,0,0,102.872759,14.533156,-88.339603,0.110612,2.037475,1.926863,55.685145,9.472628,-46.212517,0.175833,5.494439,5.318606,0.115925,1.342684,1.226759,7.110809,2.413086,-4.697723,0.629976,1.662863,1.032887,24.859198,6.491786,-18.367412,11.271448,13.16924,1.897792,0.002,0.574168,0.572168,0.1388,2.41088,2.27208,0.245107,0.795527,0.55042,895.488801,81.819575,-813.669226,0.161305,0.737747,0.576442,127.439757,6.023306,-121.416451,0.480523,1.850667,1.370144,0.001211,0.24285,0.241639,0.082816,0.325709,0.242893,0.098732,1.55701,1.458278,449.64653,38.13939,-411.50714,52.500406,4.810261,-47.690145,0,0.10178,0.10178,0.278142,1.059911,0.781769,0,0.068366,0.068366,4.419179,0.910587,-3.508592,8.663369,0.842156,-7.821213,1.220615,0.215796,-1.004819,0.064266,0.787294,0.723028,0.02548,0.568216,0.542736,4.6,4.8,0.2,0,3.545443,3.545443,0,0.495926,0.495926,6.955052,1.877491,-5.077561,27.477256,18.930023,-8.547233,0.145707,0.421231,0.275524,0.836306,0.141903,-0.694403,1.887979,6.888322,5.000343,35.724307,3.881355,-31.842952,0.228005,7.292939,7.064934,36.22419,0.64455,-35.57964,0,0,0,0.02925,0.015876,-0.013374,0.543169,0.519204,-0.0239650000000001,0,0.002354,0.002354,457.68911,210.88053,-246.80858,6.865998,2.722453,-4.143545,1.118763,1.601471,0.482708,1.680567,1.432515,-0.248051999999999,13.497965,0.851093,-12.646872,3.488486,2.181123,-1.307363,8.503147,2.534436,-5.968711,37.912323,0.616214,-37.296109,0,6.369888,6.369888,,,
2003-08-01,5568.321832,1449.037698,-4119.284134,19278.8,12200.9,-7077.9,101990,59170,-42820,7456.135672,0,-7456.135672,9581.431271,4607.4,-4974.031271,16237,14474,-1763,7389.536286,6391.182153,-998.354132999998,6941.147036,4452.396079,-2488.750957,28987.272465,20931.086381,-8056.186084,21751.839389,13749.540308,-8002.299081,3012.50678,950.987831,-2061.518949,35167.231257,15825.17469,-19342.056567,102307.011453,58611.141939,-43695.869514,40740.130783,17191.585062,-23548.545721,,,,872.686503,1328.89351,456.207007,2451.181617,573.72766,-1877.453957,1.353822,0.171622,-1.1822,17584.301252,12989.70612,-4594.595132,0.074675,0.006469,-0.068206,11402.971213,7941.380261,-3461.590952,258.875735,162.157706,-96.7180290000001,11.302368,18.661787,7.359419,164.989673,159.146565,-5.843108,270.720449,246.759865,-23.960584,66.158357,39.636651,-26.521706,257.766893,270.605298,12.838405,40.377199,141.452809,101.07561,2.255779,30.751552,28.495773,42.346914,69.726186,27.379272,0,13.101249,13.101249,28.78052,114.229206,85.448686,1.105282,5.782388,4.677106,0.424655,22.894332,22.469677,27.908003,56.92093,29.012927,361.63115,344.377241,-17.2539089999999,0.107372,3.886112,3.77874,3.09748,5.232581,2.135101,3.131438,5.360305,2.228867,0.10686,10.358074,10.251214,0.018776,0.699935,0.681159,0.500083,2.535977,2.035894,0.999061,8.524954,7.525893,0.127846,3.980789,3.852943,0.520209,5.406226,4.886017,2.174302,25.295623,23.121321,393.778414,74.677557,-319.100857,22.956831,34.929164,11.972333,,,,,,,34.639754,26.929509,-7.710245,0.085187,4.459127,4.37394,0.107298,1.16172,1.054422,545.306418,307.813198,-237.49322,1706.333081,288.420661,-1417.91242,10.250412,9.444633,-0.805779000000003,16.714099,14.913535,-1.800564,0.075324,52.86334,52.788016,243.929711,110.614222,-133.315489,217.840993,166.507714,-51.333279,15.74735,19.569065,3.82171499999999,253.075251,233.253334,-19.821917,1634.252989,1031.027992,-603.224997,4.517365,38.005311,33.487946,27.835797,38.214425,10.378628,268.274358,232.058695,-36.215663,0,0.048536,0.048536,42.523649,11.949589,-30.57406,631.105805,268.508547,-362.597258,0,0.155068,0.155068,417.275764,108.84929,-308.426474,251.9711,148.149355,-103.821745,2.74145,0.673331,-2.068119,294.010879,117.936017,-176.074862,3170.981907,2817.813686,-353.168221,2008.085551,622.136575,-1385.948976,877.977037,1610.351088,732.374051,649.375572,1201.664332,552.28876,19.541569,26.174881,6.633312,0.002177,0.645019,0.642842,2.44928,0.546498,-1.902782,2278.344695,1265.317788,-1013.026907,5134.964676,2314.784508,-2820.180168,325.226752,142.910474,-182.316278,,,,108.14921,48.742798,-59.406412,120.065002,8.347051,-111.717951,199.253357,48.418769,-150.834588,22.0792,1.028674,-21.050526,710.66671,845.068645,134.401935,20.746633,10.693608,-10.053025,5.937713,13.434022,7.496309,27.256834,15.504656,-11.752178,102.338994,66.467247,-35.871747,,,,725.131896,199.570696,-525.5612,29.802126,3.154257,-26.647869,29.992923,18.672444,-11.320479,3.706921,4.515995,0.809074000000001,0.099406,10.544606,10.4452,0.858898,9.479952,8.621054,33.481728,12.099776,-21.381952,1.005321,1.52413,0.518809,3.753837,1.589377,-2.16446,0.679388,19.454546,18.775158,15.690461,3.498876,-12.191585,7.740995,13.692897,5.951902,562.002573,436.671598,-125.330975,197.94608,50.089616,-147.856464,2.429013,0.221655,-2.207358,31.7369,14.001531,-17.735369,0.185436,0.054352,-0.131084,0.009498,0.059194,0.049696,2169.059719,735.729417,-1433.330302,,,,16.906239,21.266814,4.360575,42.802549,7.446071,-35.356478,1.283658,4.115079,2.831421,3.941993,1.220341,-2.721652,1.356185,5.373087,4.016902,,,,,,,,,,0.179907,0.406408,0.226501,48.843693,203.309081,154.465388,55.482744,18.741736,-36.741008,41.08023,6.730409,-34.349821,300.540633,223.759651,-76.7809820000001,1.036923,6.2752,5.238277,16.864658,23.095715,6.231057,7.117996,21.635525,14.517529,109.031828,36.490059,-72.541769,11.458551,1.924202,-9.534349,244.8,267.3,22.5,0,0,0,0.034738,0,-0.034738,69.245864,32.822624,-36.42324,143.538122,104.089978,-39.448144,,,,1258.357931,339.983159,-918.374772,18.400728,39.548506,21.147778,71.941903,292.275717,220.333814,0.40483,23.208778,22.803948,117.357141,15.266233,-102.090908,14.518484,20.218432,5.699948,2.455671,4.748582,2.292911,1172.308847,394.711553,-777.597294,224.598178,49.185594,-175.412584,13.367455,1.234014,-12.133441,209.466803,27.641008,-181.825795,160.597111,15.020023,-145.577088,53.111913,0.374195,-52.737718,1289.223987,441.228204,-847.995783,441.357676,229.49665,-211.861026,0.402178,0.433075,0.0308970000000001,111.959316,1.896785,-110.062531,2223.27333,912.827126,-1310.446204,1065.194017,1846.576521,781.382503999999,796.89841,195.193236,-601.705174,0,0,0,50.559347,2.201577,-48.35777,870.519745,689.560175,-180.95957,136.629276,3.819131,-132.810145,0.083006,0.052857,-0.030149,3.116082,0.583579,-2.532503,13764.867008,2034.428227,-11730.438781,20.464402,1.551702,-18.9127,0,1.193263,1.193263,2775.855335,1859.876454,-915.978881,839.217305,1146.784892,307.567587,2709.269629,1537.944286,-1171.325343,9089.140181,4297.843985,-4791.296196,636.924236,1134.198559,497.274323,0,0.01305,0.01305,0.030619,0.078896,0.048277,0.011083,0.116411,0.105328,0.032765,0,-0.032765,4.049987,3.215155,-0.834832,204.833451,160.705366,-44.128085,0.245771,0.310241,0.06447,0.949495,0.852482,-0.097013,0,0,0,0.609734,0.979444,0.36971,0.065177,0.212311,0.147134,0.062326,0.023546,-0.03878,0.00039,0.081808,0.081418,0.316603,0.279705,-0.036898,0.002453,0.003795,0.001342,0.058143,3.412511,3.354368,0,0,0,2.694922,14.338999,11.644077,0.575402,3.365218,2.789816,1.737821,2.505019,0.767198,0.004163,1.208136,1.203973,0.160446,0.071685,-0.088761,17.203003,2.246973,-14.95603,2.12547,0.442646,-1.682824,33.512962,39.294558,5.781596,453.859676,50.825831,-403.033845,6.018089,19.401707,13.383618,282.012719,31.859595,-250.153124,66.870868,267.517497,200.646629,0.223228,4.740255,4.517027,,,,0,0,0,161.384148,22.352326,-139.031822,0.003279,4.302035,4.298756,5.423187,7.094868,1.671681,0.574571,5.984461,5.40989,0.114481,3.610811,3.49633,5.661998,5.831166,0.169167999999999,0.321775,3.009509,2.687734,16.903235,10.118877,-6.784358,4.498942,17.547878,13.048936,0.00475,1.24536,1.24061,0.096408,2.451806,2.355398,0.024268,3.257041,3.232773,998.501602,100.286349,-898.215253,0.112506,1.864066,1.75156,237.457309,2.432911,-235.024398,0.824202,11.599821,10.775619,0.040875,0.005628,-0.035247,0.116922,0.170644,0.053722,0.047215,3.308302,3.261087,463.07169,55.754008,-407.317682,17.794114,7.136663,-10.657451,0,0.050642,0.050642,0.241322,0.663051,0.421729,0,0.054569,0.054569,0.406295,1.99671,1.590415,23.705533,3.138524,-20.567009,0.14108,0.199601,0.058521,0.265605,0.130482,-0.135123,0.0088,0.057774,0.048974,2.3,5.5,3.2,0.029775,4.950526,4.920751,0.039821,1.226295,1.186474,3.277767,1.730113,-1.547654,21.501914,11.113092,-10.388822,0.316706,0.368459,0.051753,0.0595,0.035439,-0.024061,1.299276,10.224721,8.925445,24.882834,3.619945,-21.262889,0.15219,3.4295,3.27731,30.606194,1.281544,-29.32465,0,0,0,0.00275,0.171957,0.169207,0.963193,0.126105,-0.837088,0,0.053406,0.053406,353.671586,216.774475,-136.897111,12.436709,1.984811,-10.451898,0.492607,2.225095,1.732488,1.051003,0.83367,-0.217333,16.188638,0.385815,-15.802823,3.229254,4.054489,0.825235000000001,4.557966,0.832694,-3.725272,36.403708,0.025129,-36.378579,0,6.474677,6.474677,,,
2003-09-01,5738.393249,1639.620109,-4098.77314,20451.9,12394.1,-8057.8,105721,61041,-44680,7392.289879,0,-7392.289879,10525.258034,5253.6,-5271.658034,18802,15233,-3569,8102.394895,5752.679249,-2349.715646,6569.834768,4236.96299,-2332.871778,31177.736207,23051.77065,-8125.96555700001,23310.718588,13768.071996,-9542.646592,2759.423716,1113.904642,-1645.519074,37192.789012,15118.946056,-22073.842956,108321.943723,60238.622539,-48083.321184,43749.6228,16724.137146,-27025.485654,,,,753.47166,1328.55651,575.08485,2263.301496,685.680427,-1577.621069,1.135984,0.723553,-0.412431,19360.81043,14518.124308,-4842.686122,0,0.000554,0.000554,11816.925777,8533.646342,-3283.279435,248.365938,171.550506,-76.815432,10.347498,13.339242,2.991744,184.303617,141.787748,-42.515869,279.977917,221.685992,-58.2919249999999,62.761654,42.130037,-20.631617,271.845813,291.759065,19.913252,26.952451,182.353192,155.400741,1.843879,24.702237,22.858358,27.1759,88.794683,61.618783,0.01145,22.579475,22.568025,35.07121,102.859942,67.788732,0.519242,4.941323,4.422081,0.418406,32.079603,31.661197,28.374283,54.548385,26.174102,385.607373,337.778407,-47.828966,0.146864,1.944574,1.79771,1.808029,4.441061,2.633032,3.818146,4.712539,0.894392999999999,0.23816,11.112359,10.874199,0.056205,0.519951,0.463746,0.548182,1.680424,1.132242,1.095029,15.574613,14.479584,0.093947,2.320995,2.227048,0.453859,7.524134,7.070275,2.31064,18.423317,16.112677,332.519384,86.673964,-245.84542,24.86615,51.414433,26.548283,,,,,,,58.834746,20.772251,-38.062495,0.008041,2.473338,2.465297,0.03536,1.764378,1.729018,521.719307,338.621891,-183.097416,1620.009348,241.131151,-1378.878197,8.074033,7.548559,-0.525474,9.955093,15.136039,5.180946,0,0.625722,0.625722,236.9421,105.848119,-131.093981,154.933296,130.393927,-24.539369,17.696818,13.582915,-4.113903,260.778262,213.67786,-47.1004020000001,1465.029595,923.85568,-541.173915,7.678933,46.92855,39.249617,25.297557,29.505345,4.20778799999999,251.311053,205.849051,-45.462002,0,0.016013,0.016013,14.969104,39.61311,24.644006,999.005053,259.694863,-739.31019,0,0.004069,0.004069,469.195637,111.283937,-357.9117,291.454631,192.231106,-99.223525,2.477979,0.846194,-1.631785,372.242528,132.233944,-240.008584,3646.457934,2577.329911,-1069.128023,2321.32899,854.461897,-1466.867093,916.803646,1585.789051,668.985405,924.002925,1223.919143,299.916218,15.432179,23.590634,8.15845499999999,0.053536,0.477098,0.423562,1.857718,3.063799,1.206081,2346.853276,1331.125269,-1015.728007,5015.483806,2190.670705,-2824.813101,441.542605,173.905098,-267.637507,,,,120.739188,49.366242,-71.372946,129.171008,6.650628,-122.52038,167.101429,48.077641,-119.023788,25.950413,5.660198,-20.290215,909.871931,651.841871,-258.03006,14.035473,12.906167,-1.129306,51.253096,12.463227,-38.789869,39.042113,13.288568,-25.753545,114.041581,60.970229,-53.071352,,,,833.777385,200.191407,-633.585978,16.883105,2.282029,-14.601076,31.58255,21.840875,-9.741675,5.231482,5.227553,-0.00392899999999941,2.228962,9.606434,7.377472,3.382379,14.724777,11.342398,35.684065,22.927734,-12.756331,0.800987,5.198587,4.3976,4.447455,4.566959,0.119504000000001,0.412871,0.775786,0.362915,5.620151,1.461599,-4.158552,3.778609,4.690113,0.911504,468.001638,425.478928,-42.52271,152.420287,39.551757,-112.86853,0.026228,0.438311,0.412083,33.216094,14.671336,-18.544758,0.029118,0.020792,-0.008326,0.108607,0.03634,-0.072267,1779.414225,748.385668,-1031.028557,,,,14.978892,32.230059,17.251167,34.136454,10.536837,-23.599617,0.756457,0.954193,0.197736,5.742624,1.931377,-3.811247,2.141192,2.940558,0.799366,,,,,,,,,,0.421461,0.830299,0.408838,55.677728,400.801888,345.12416,91.872063,17.112637,-74.759426,30.140926,14.87371,-15.267216,344.381653,196.307565,-148.074088,3.055161,6.011289,2.956128,21.303951,18.67012,-2.633831,6.781281,33.849839,27.068558,237.650392,152.54888,-85.101512,13.590318,2.791695,-10.798623,281,259.7,-21.3,0,0,0,0,0,0,82.818046,47.643864,-35.174182,215.494945,140.495515,-74.99943,,,,1512.23298,458.620866,-1053.612114,41.802402,27.382812,-14.41959,86.619759,282.100862,195.481103,0.681006,15.36762,14.686614,89.20825,20.252171,-68.956079,19.330136,23.046027,3.715891,1.448063,4.537103,3.08904,1237.755863,428.532447,-809.223416,244.446375,64.199969,-180.246406,12.450032,3.133484,-9.316548,197.371563,20.202516,-177.169047,170.9512,11.503457,-159.447743,1.251607,0.255697,-0.99591,1382.046997,397.996614,-984.050383,424.026847,218.014838,-206.012009,0.433959,0.205196,-0.228763,115.443191,3.603057,-111.840134,2297.243599,970.392615,-1326.850984,1345.523247,1258.428672,-87.0945750000001,799.156115,172.535374,-626.620741,0.535434,0,-0.535434,22.711593,3.439677,-19.271916,924.727908,658.067611,-266.660297,137.430642,3.687205,-133.743437,0.054187,0.077371,0.023184,9.031337,0.630887,-8.40045,14747.525418,2090.976796,-12656.548622,26.613077,1.210895,-25.402182,0,0.03313,0.03313,3022.534533,1885.387265,-1137.147268,919.536025,1217.527145,297.99112,2814.80109,1391.336167,-1423.464923,9442.253669,4162.903675,-5279.349994,500.738888,1156.745899,656.007011,0,0.040506,0.040506,0,0.013751,0.013751,0.009114,0.121652,0.112538,0.000294,0,-0.000294,26.776152,1.595498,-25.180654,191.830133,145.922457,-45.9076759999999,0.146484,0.063016,-0.083468,0.224789,1.418429,1.19364,0,0,0,0.525626,0.584236,0.0586099999999998,0.050543,0.194777,0.144234,0.043671,0.144586,0.100915,0.028605,0.192638,0.164033,0.123607,0.034203,-0.089404,0.003288,0.000215,-0.003073,1.059544,7.376434,6.31689,0,0,0,5.268808,7.058775,1.789967,0.79152,2.592849,1.801329,0.869965,1.196132,0.326167,0.006711,0.959999,0.953288,0,0.114418,0.114418,22.208392,1.581,-20.627392,2.590149,0.658721,-1.931428,31.340076,23.717517,-7.622559,387.196471,50.670932,-336.525539,5.909324,10.155094,4.24577,161.314943,27.260381,-134.054562,71.28386,342.93155,271.64769,0.5578,1.000866,0.443066,,,,0,0.02,0.02,131.024594,18.752948,-112.271646,0.026305,3.999872,3.973567,27.563395,5.746419,-21.816976,0.153631,5.114171,4.96054,0.223881,1.94078,1.716899,5.278403,2.306573,-2.97183,1.056158,2.14283,1.086672,23.6681,5.6511,-18.017,4.200734,18.209875,14.009141,0.011463,0.511883,0.50042,0.151265,2.995393,2.844128,0.032846,2.164457,2.131611,824.640519,111.303199,-713.33732,0.044743,0.333601,0.288858,141.5748,4.607075,-136.967725,0.026165,7.171132,7.144967,0,0.216731,0.216731,0.016953,1.120018,1.103065,0.065482,2.271963,2.206481,391.17188,61.533397,-329.638483,37.250759,27.537779,-9.71298000000001,0,0.518049,0.518049,2.104673,0.326195,-1.778478,0,0.444135,0.444135,4.312811,4.77171,0.458898999999999,13.796799,1.838396,-11.958403,0.860707,0.186053,-0.674654,0.352704,0.05546,-0.297244,0.011384,0.202734,0.19135,1.4,7.8,6.4,0,6.421189,6.421189,0.055002,8.063747,8.008745,5.905277,3.28494,-2.620337,22.229869,17.700141,-4.52972800000001,0.892893,0.62235,-0.270543,0.169993,0.264348,0.094355,1.373736,4.622819,3.249083,26.901576,2.954091,-23.947485,0.188426,8.998028,8.809602,34.40035,1.588264,-32.812086,0,0,0,0.233629,0.26211,0.0284810000000001,0.222496,0.208333,-0.014163,0,0.000887,0.000887,466.612811,295.225069,-171.387742,23.621622,2.295927,-21.325695,1.503242,3.664692,2.16145,1.963012,1.712882,-0.25013,14.786736,1.178185,-13.608551,2.967189,5.554609,2.58742,7.98879,0.670666,-7.318124,38.615432,1.349784,-37.265648,0,14.494498,14.494498,,,
2003-10-01,5956.114039,1513.710072,-4442.403967,23100.2,13911.5,-9188.7,107040,62203,-44837,8152.165888,0,-8152.165888,11306.828014,5891.6,-5415.228014,19964,16289,-3675,8732.18999,6481.12254,-2251.06745,7064.270789,4783.331699,-2280.93909,33103.465634,25074.327565,-8029.13806899999,25632.180741,15654.839785,-9977.34095599999,2910.053127,981.379786,-1928.673341,41197.908496,16817.428101,-24380.480395,117157.603484,66388.6426270001,-50768.960857,47668.175778,18457.102813,-29211.072965,,,,777.910029,1380.258518,602.348489,2504.951295,599.104911,-1905.846384,1.063784,0.098197,-0.965587,20137.743913,15554.627229,-4583.116684,0.483602,0.006693,-0.476909,12965.721721,9519.700336,-3446.021385,220.662864,180.467575,-40.195289,8.890553,11.812337,2.921784,186.464016,139.621211,-46.842805,297.697711,248.79461,-48.903101,67.278805,54.523424,-12.755381,278.266387,273.982694,-4.28369300000008,25.597448,238.775895,213.178447,1.533339,28.236643,26.703304,47.543211,88.504816,40.961605,0.0256,24.991817,24.966217,37.390531,160.115316,122.724785,0.403613,4.171003,3.76739,3.893241,29.416856,25.523615,34.084196,56.561035,22.476839,427.503172,394.591534,-32.9116379999998,0.154355,1.477744,1.323389,2.158728,6.093233,3.934505,4.134099,4.540772,0.406673,0.210855,13.86677,13.655915,0.478382,0.892908,0.414526,0.546696,3.096815,2.550119,0.901415,9.670103,8.768688,0.2921,4.630469,4.338369,0.604118,5.268132,4.664014,2.653312,29.080694,26.427382,396.053535,108.847125,-287.20641,28.633941,83.718522,55.084581,,,,,,,90.367841,30.856468,-59.511373,0.065975,1.965055,1.89908,0.026445,1.387511,1.361066,553.882386,338.057929,-215.824457,1648.220946,307.474315,-1340.746631,6.644352,9.416724,2.772372,12.256,13.85385,1.59785,0.222478,0.969503,0.747025,256.809898,136.346711,-120.463187,255.043383,124.026811,-131.016572,13.575801,19.734335,6.15853399999999,245.833508,255.36016,9.52665200000001,1634.709673,1034.004704,-600.704969,6.93876,47.083944,40.145184,33.202402,34.086854,0.884452000000003,230.78573,222.930701,-7.85502900000006,1.628988,0.026071,-1.602917,21.44159,12.387876,-9.053714,1051.391934,286.065331,-765.326603,0,0.016303,0.016303,488.995971,141.396748,-347.599223,345.608923,150.564971,-195.043952,2.327384,0.983823,-1.343561,347.06568,139.131416,-207.934264,4136.406,2820.900215,-1315.505785,2344.662547,618.83191,-1725.830637,1011.282201,2031.222185,1019.939984,951.964181,1360.873459,408.909278,26.108588,20.386042,-5.722546,0.003734,0.745616,0.741882,2.146647,1.174789,-0.971858,2617.324426,1438.914934,-1178.409492,6060.043764,2658.689897,-3401.353867,448.474843,134.772191,-313.702652,,,,136.879558,63.860379,-73.019179,127.170999,7.57294,-119.598059,305.598565,112.106526,-193.492039,26.822059,2.102484,-24.719575,1005.126132,757.793629,-247.332503,11.248308,11.674816,0.426508000000002,28.072668,17.138856,-10.933812,25.078199,17.104753,-7.973446,119.580555,66.49501,-53.085545,,,,421.729151,316.367034,-105.362117,14.977779,3.484964,-11.492815,23.789521,26.720004,2.930483,4.997832,3.874849,-1.122983,0.154517,14.974862,14.820345,2.850734,12.915739,10.065005,25.707707,16.753032,-8.95467499999999,2.848336,5.305888,2.457552,3.085771,3.140525,0.054754,1.196722,6.449532,5.25281,5.869307,0.653079,-5.216228,6.525293,139.339849,132.814556,574.15542,556.118171,-18.0372490000001,194.389456,129.429055,-64.960401,0.108372,0.711041,0.602669,43.732229,13.216899,-30.51533,0.073846,0.115171,0.041325,0.055786,0.052974,-0.002812,2104.764015,1109.888738,-994.875277,,,,11.624927,9.257839,-2.367088,45.421216,13.483888,-31.937328,1.145479,0.991247,-0.154232,6.097776,1.399423,-4.698353,2.114863,1.63388,-0.480983000000001,,,,,,,,,,0.437236,1.289819,0.852583,41.241164,119.011137,77.769973,61.467558,17.519971,-43.947587,45.071438,7.021079,-38.050359,343.215013,236.73575,-106.479263,2.506821,14.077247,11.570426,16.631151,30.162351,13.5312,5.090242,47.974148,42.883906,540.096763,20.446279,-519.650484,14.835098,8.215659,-6.619439,301.8,314.5,12.7,0,0,0,0.020458,0.029604,0.00914599999999999,66.691801,50.550661,-16.14114,147.000922,143.547863,-3.453059,,,,1271.543884,358.110225,-913.433659,21.382289,40.004474,18.622185,81.228083,300.174983,218.9469,0.302175,21.227896,20.925721,61.299545,21.387447,-39.912098,17.580601,24.280453,6.699852,43.666602,7.500288,-36.166314,1252.449466,493.229991,-759.219475,250.3637,96.626512,-153.737188,13.962037,1.158184,-12.803853,180.817967,15.360013,-165.457954,157.776943,14.932912,-142.844031,0.101686,0.359274,0.257588,1470.157413,728.204167,-741.953246,358.064228,54.362927,-303.701301,0.310222,0.520389,0.210167,125.049473,3.108178,-121.941295,2435.162254,997.977556,-1437.184698,1341.594993,1449.64287,108.047877,948.687987,192.854922,-755.833065,0.830843,0,-0.830843,68.616846,3.058313,-65.558533,888.732715,618.958632,-269.774083,132.055947,6.205613,-125.850334,0.071442,0.512494,0.441052,9.849331,0.372412,-9.476919,16458.317607,2778.336455,-13679.981152,21.617099,3.309255,-18.307844,0,0.203342,0.203342,3674.449386,2111.332531,-1563.116855,957.802129,1287.519446,329.717317,2758.343482,1632.627693,-1125.715789,10786.709731,4383.73736,-6402.972371,564.812451,1183.062374,618.249923,0.041149,0.01227,-0.028879,0.073082,0.03303,-0.040052,0.051019,0.132727,0.081708,0.00592,0,-0.00592,5.837873,3.843037,-1.994836,176.785095,168.271299,-8.51379600000001,0.141924,0.355656,0.213732,0.639615,0.741709,0.102094,0,0.018956,0.018956,0.342447,0.713231,0.370784,0.074363,0.10641,0.032047,0.106373,0.119257,0.012884,0.092205,0.133399,0.041194,0.116585,0.028607,-0.087978,0.034894,0,-0.034894,1.135055,5.409998,4.274943,0,0,0,6.217278,7.132083,0.914804999999999,0.701095,2.045561,1.344466,1.686339,2.556694,0.870355,0.051596,1.743625,1.692029,0,1.044057,1.044057,17.385585,1.497812,-15.887773,1.648194,0.846783,-0.801411,30.304761,33.604342,3.29958100000001,300.002486,60.461256,-239.54123,4.559301,12.769633,8.210332,263.113658,68.806879,-194.306779,70.111156,274.93137,204.820214,0,4.917473,4.917473,,,,0,0.007985,0.007985,87.560756,29.831527,-57.729229,0.053203,3.876318,3.823115,3.424084,15.998641,12.574557,1.116988,7.671896,6.554908,0.208823,2.928075,2.719252,7.103006,3.075154,-4.027852,0.499337,2.439215,1.939878,38.772581,11.507086,-27.265495,4.707295,22.168522,17.461227,0.004031,1.229473,1.225442,0.26068,2.840388,2.579708,0.026919,1.666023,1.639104,983.115581,82.420096,-900.695485,0.283508,0.60222,0.318712,204.551481,8.229547,-196.321934,0.3836,2.930586,2.546986,0.004519,0.02999,0.025471,0.07888,0.55843,0.47955,0.0399,2.004855,1.964955,366.223892,38.195268,-328.028624,39.073372,7.882722,-31.19065,0,0.269752,0.269752,0.403442,1.307719,0.904277,0.008894,0.168589,0.159695,2.335375,2.39016,0.0547850000000003,20.9673,2.168685,-18.798615,0.058059,0.248557,0.190498,0.115268,0.071281,-0.043987,0.017618,1.299758,1.28214,4.2,6.7,2.5,0.0235,10.982724,10.959224,0.171524,2.461464,2.28994,5.107872,2.396357,-2.711515,21.296226,14.408742,-6.887484,0.678915,1.384234,0.705319,0.104483,0.350608,0.246125,1.68933,3.469007,1.779677,22.634721,1.952982,-20.681739,0.265386,8.281277,8.015891,34.246467,3.813242,-30.433225,0,0,0,0.002922,0.004304,0.001382,0.015126,0.106817,0.091691,0,0.012874,0.012874,556.627482,246.30331,-310.324172,10.222091,2.896805,-7.325286,1.788042,3.519287,1.731245,0.526131,0.887341,0.36121,16.533818,0.683038,-15.85078,7.099266,1.958877,-5.140389,14.947732,3.078183,-11.869549,47.883298,0.041001,-47.842297,0,57.297571,57.297571,,,
2003-11-01,5413.740577,1514.213386,-3899.527191,21602.3,13975.7,-7626.6,107742,64665,-43077,7432.290451,0,-7432.290451,10371.717049,5468.6,-4903.117049,18633,16926,-1707,7818.790018,6154.61434,-1664.175678,6343.037214,4665.066079,-1677.971135,30332.94778,23219.560959,-7113.386821,23996.09866,15567.258889,-8428.839771,2244.652613,1083.816994,-1160.835619,36728.134062,17031.182387,-19696.951675,106066.254002,64491.72934,-41574.524662,42405.103189,18629.489266,-23775.613923,,,,743.025638,1262.763523,519.737885,1729.249511,759.708668,-969.540843,1.387351,0.192904,-1.194447,18640.493702,14598.222125,-4042.271577,0.001557,0.009286,0.007729,11692.454078,8621.338834,-3071.115244,202.495844,201.281607,-1.21423699999997,6.00519,11.758959,5.753769,144.128665,169.36652,25.237855,252.94766,244.430279,-8.517381,59.870904,50.189876,-9.681028,263.546838,259.202679,-4.34415899999999,20.70139,185.98322,165.28183,0.702802,40.282047,39.579245,24.300727,94.608989,70.308262,0.02104,37.072794,37.051754,32.022004,118.934944,86.91294,0.484541,5.827619,5.343078,1.081859,31.833052,30.751193,27.457495,53.769787,26.312292,333.033507,343.624653,10.5911460000001,0.086146,2.204813,2.118667,1.098987,5.521999,4.423012,3.257618,5.417045,2.159427,0.178738,10.03511,9.856372,0.222048,0.8481,0.626052,0.42317,2.081124,1.657954,0.870874,8.773328,7.902454,0.480614,5.746034,5.26542,0.798182,6.072512,5.27433,3.125507,24.55754,21.432033,370.921386,104.28231,-266.639076,36.032305,86.733359,50.701054,,,,,,,93.642187,29.659989,-63.982198,0.060593,1.979827,1.919234,0.007639,3.936262,3.928623,504.647795,313.730607,-190.917188,1539.357377,347.806927,-1191.55045,9.109834,13.74825,4.638416,16.351394,15.061648,-1.289746,0.000717,0.299895,0.299178,211.174232,131.256117,-79.918115,269.882114,154.351012,-115.531102,17.711846,15.200021,-2.51182500000001,252.526027,215.51776,-37.008267,1348.425987,1000.686724,-347.739263000001,5.288175,45.063699,39.775524,29.487886,31.802219,2.31433300000002,258.510413,234.485961,-24.024452,0.556957,0.038862,-0.518095,29.430744,12.161771,-17.268973,888.504767,268.055375,-620.449392,0,0.003444,0.003444,354.47897,157.805293,-196.673677,280.589366,147.631488,-132.957878,1.096785,0.551707,-0.545078,340.78342,173.984742,-166.798678,3430.399386,2806.060808,-624.338578,2277.539597,643.106387,-1634.43321,940.596747,2081.017375,1140.420628,780.63122,1246.804354,466.173134,16.614023,22.235566,5.621543,0,0.605509,0.605509,1.857871,0.141025,-1.716846,2551.247091,1418.181644,-1133.065447,6046.034317,2469.708875,-3576.325442,387.302411,135.101342,-252.201069,,,,108.642246,62.005338,-46.636908,109.009246,13.390488,-95.618758,234.498295,102.816064,-131.682231,24.516191,0.840622,-23.675569,1013.982568,713.572312,-300.410256,24.113152,21.050395,-3.06275699999999,8.662661,13.415785,4.753124,48.683048,19.413979,-29.269069,118.372656,70.700058,-47.672598,,,,502.336502,195.967485,-306.369017,22.272182,2.753358,-19.518824,14.882645,20.502141,5.61949600000001,4.929746,5.493443,0.563696999999999,0.306519,9.249622,8.943103,8.470529,26.352505,17.881976,16.314759,12.696103,-3.61865599999999,2.173998,2.42354,0.249541999999999,2.61037,1.950512,-0.659858,0.648248,2.566501,1.918253,4.201496,0.924543,-3.276953,4.910083,5.606573,0.69649,585.527222,660.979862,75.4526399999997,144.115964,133.020373,-11.095591,0.00117,0.675035,0.673865,34.802862,20.166061,-14.636801,8.368921,0.572795,-7.796126,0.033521,0.653215,0.619694,2157.000962,961.13271,-1195.868252,,,,16.289749,59.216645,42.926896,45.891793,14.67481,-31.216983,1.052702,2.715277,1.662575,3.865629,2.552815,-1.312814,1.089089,4.266436,3.177347,,,,,,,,,,0.277877,1.629285,1.351408,40.802511,459.729917,418.927406,45.051846,71.224715,26.172869,31.835661,9.211576,-22.624085,276.465989,266.660488,-9.80550099999999,1.981337,11.328802,9.347465,3.569887,17.13848,13.568593,6.704912,29.273061,22.568149,487.983059,13.450697,-474.532362,11.05762,17.608713,6.551093,301.2,327.6,26.4,0,0,0,0.021868,0.03047,0.00860200000000001,57.136499,39.921293,-17.215206,206.4038,119.73756,-86.66624,,,,1356.773904,352.427055,-1004.346849,21.02816,24.948035,3.919875,58.345893,247.726622,189.380729,0.012446,13.861609,13.849163,93.567337,26.321521,-67.245816,23.984296,28.906502,4.922206,0.43394,10.486282,10.052342,904.890689,402.120706,-502.769983,183.687024,87.595144,-96.09188,9.121065,2.122898,-6.998167,111.287609,14.457216,-96.830393,100.868124,13.358464,-87.50966,0.000497,0.44305,0.442553,1333.557372,717.211275,-616.346097,271.45193,54.338519,-217.113411,0.041854,0.123398,0.081544,96.497874,3.745936,-92.751938,2227.665381,945.82067,-1281.844711,1124.349927,1262.245404,137.895477,767.154856,248.263309,-518.891547,0.06045,0.053494,-0.00695599999999998,21.163748,1.989777,-19.173971,725.009128,632.157172,-92.8519560000001,106.976111,6.666027,-100.310084,0.009452,0.03301,0.023558,5.690528,0.462069,-5.228459,14156.947961,3319.692649,-10837.255312,11.573297,0.346078,-11.227219,0,0,0,3396.750641,2199.252209,-1197.498432,695.501267,1189.436564,493.935297,2602.188183,1503.680163,-1098.50802,10187.251104,4480.956447,-5706.294657,551.353943,1030.105748,478.751805,0.457605,0.000755,-0.45685,0.013171,0.068286,0.055115,0.060135,0.034206,-0.025929,0.019902,0,-0.019902,8.386977,1.445701,-6.941276,157.434835,209.470547,52.0357120000001,0.346445,0.149558,-0.196887,0.159998,1.713325,1.553327,0,0.029444,0.029444,0.264288,0.721586,0.457298,0.037408,0.161197,0.123789,0.046162,0.262682,0.21652,0.04673,0.007036,-0.039694,0.122083,0.071613,-0.05047,0.008433,0.0077,-0.000732999999999999,0.080786,3.192762,3.111976,0,0,0,4.070334,7.757593,3.687259,0.434205,1.158484,0.724279,0.979237,2.810879,1.831642,0.028428,1.231334,1.202906,0.035925,0.114245,0.07832,17.81932,1.571453,-16.247867,0.859828,0.361913,-0.497915,28.555685,40.572037,12.016352,381.399206,58.872409,-322.526797,13.538371,11.083914,-2.454457,236.956712,81.622477,-155.334235,91.871159,212.554096,120.682937,0.3313,0.213435,-0.117865,,,,0,0.000127,0.000127,95.644692,12.80248,-82.842212,0.003,1.77039,1.76739,43.554422,10.304127,-33.250295,0.547644,6.2948,5.747156,0.158466,1.732108,1.573642,5.37968,1.32412,-4.05556,0.051074,2.939566,2.888492,42.855214,7.598357,-35.256857,2.734428,14.905903,12.171475,0.046229,0.615002,0.568773,0.061714,6.219347,6.157633,0.054631,0.742667,0.688036,584.236702,83.332723,-500.903979,0.12025,0.41286,0.29261,233.19133,2.635765,-230.555565,14.503371,2.525195,-11.978176,0.03105,0.148445,0.117395,0.161968,1.171128,1.00916,0.086565,5.443402,5.356837,157.07418,52.577575,-104.496605,40.337718,3.103894,-37.233824,0.02,0.087498,0.067498,0.316751,0.778234,0.461483,0.00227,0.020075,0.017805,6.921926,3.496778,-3.425148,20.042633,2.976886,-17.065747,0.11328,0.06438,-0.0489,0.18379,0.095043,-0.088747,0,0.115824,0.115824,2.2,4.5,2.3,0.011915,0.760023,0.748108,0.022171,0.898807,0.876636,1.319106,2.941963,1.622857,13.857712,8.409093,-5.448619,0.146693,1.272503,1.12581,0.007631,0.61918,0.611549,3.659143,4.582461,0.923318000000002,16.790647,5.180425,-11.610222,0.022361,0.917647,0.895286,32.572984,2.32178,-30.251204,0,0,0,0.013663,0.060004,0.046341,0,0.192743,0.192743,0,0.026039,0.026039,326.072326,296.694817,-29.3775089999999,21.070152,1.615344,-19.454808,0.610508,2.322286,1.711778,0.960105,0.59312,-0.366985,17.545092,0.425074,-17.120018,3.405931,3.105188,-0.300743,10.788856,2.51097,-8.277886,30.594376,0.059083,-30.535293,0,63.57144,63.57144,,,
2003-12-01,6152.04194,1583.807539,-4568.234401,23570.8,13062.4,-10508.4,111017,63536,-47481,7254.859641,0,-7254.859641,9674.227973,4908.9,-4765.327973,19867,16628,-3239,8324.936827,6704.806622,-1620.130205,7393.463226,4490.092885,-2903.370341,29771.150855,22138.144815,-7633.00604,26209.126292,14538.331221,-11670.795071,2840.546689,1021.703465,-1818.843224,36343.493719,17766.209937,-18577.283782,109254.922651,62959.0936879999,-46295.8289630001,42238.734864,19455.452823,-22783.282041,,,,800.215662,1298.79279,498.577128,2362.504309,697.874372,-1664.629937,1.402078,0.053907,-1.348171,18354.217816,13834.015077,-4520.202739,0.282985,0.0008,-0.282185,11416.933039,8304.129738,-3112.803301,257.127784,176.535779,-80.592005,6.13785,9.112296,2.974446,185.226929,139.013336,-46.213593,302.579575,228.148819,-74.4307559999999,72.836911,36.663755,-36.173156,263.440335,273.570853,10.1305180000001,27.937183,143.870969,115.933786,0.538268,73.409308,72.87104,47.176696,84.191087,37.014391,0.007922,34.309808,34.301886,35.53678,127.195492,91.658712,0.233143,8.98692,8.753777,0.588228,32.292982,31.704754,27.595526,47.604763,20.009237,411.949638,295.42039,-116.529248,0.058868,1.420086,1.361218,1.241385,9.517225,8.27584,3.457098,4.889635,1.432537,0.338726,10.070066,9.73134,0.105952,0.793371,0.687419,0.555384,3.601144,3.04576,1.06471,8.087163,7.022453,0.627121,3.328134,2.701013,1.031904,3.953923,2.922019,3.073599,23.323182,20.249583,442.221242,68.015228,-374.206014,47.002062,61.796297,14.794235,,,,,,,118.485472,28.789474,-89.695998,0.077086,3.193496,3.11641,0.005344,1.81466,1.809316,462.409174,347.761247,-114.647927,1772.894312,296.39789,-1476.496422,9.657757,8.618732,-1.039025,8.862784,16.330398,7.467614,0,0.522524,0.522524,261.728179,116.955926,-144.772253,265.69549,133.62511,-132.07038,18.203288,22.031195,3.827907,391.310138,259.544349,-131.765789,1602.470755,1040.281914,-562.188841,3.477423,24.161541,20.684118,31.25727,24.491778,-6.76549199999999,307.236158,256.385529,-50.850629,0.001777,0.065111,0.063334,43.225541,22.461957,-20.763584,1162.853037,304.777455,-858.075582,0,0.007684,0.007684,411.575944,125.635175,-285.940769,258.616858,160.094048,-98.52281,0.910272,0.256895,-0.653377,296.663136,130.899948,-165.763188,3876.116756,2781.841532,-1094.275224,2414.533003,637.015649,-1777.517354,848.914109,1849.587517,1000.673408,943.885175,1262.452453,318.567278,19.447408,25.226599,5.779191,0.080818,0.357591,0.276773,1.722542,1.092763,-0.629779,2880.790657,1460.359432,-1420.431225,6501.233016,2369.875622,-4131.357394,461.655173,128.047221,-333.607952,,,,117.580357,55.670558,-61.909799,112.082866,12.52151,-99.561356,193.11072,101.637531,-91.473189,23.766255,1.204184,-22.562071,972.333673,655.75314,-316.580533,20.879044,9.68483,-11.194214,32.2235,6.729875,-25.493625,10.349287,14.519533,4.17024599999999,126.355724,79.542301,-46.813423,,,,669.256426,181.942715,-487.313711,11.209515,52.563717,41.354202,10.549722,21.123704,10.573982,4.33512,5.932056,1.596936,0.397529,16.466435,16.068906,0.875794,18.131995,17.256201,44.196049,11.842415,-32.353634,1.989096,0.973777,-1.015319,2.275929,4.707526,2.431597,1.79522,4.45054,2.65532,5.153434,4.68632,-0.467113999999999,9.701939,7.691068,-2.010871,659.908352,502.259473,-157.648879,155.042829,52.612604,-102.430225,0.00262,0.474778,0.472158,31.663934,14.842999,-16.820935,0.270231,0.953463,0.683232,0.11653,0.289815,0.173285,2333.555635,978.552842,-1355.002793,,,,11.444439,23.605091,12.160652,51.766442,17.407139,-34.359303,0.908007,1.679188,0.771181,4.7395,1.911488,-2.828012,2.19141,5.959074,3.767664,,,,,,,,,,0.490045,0.584891,0.094846,59.644725,98.751393,39.106668,55.172308,91.289321,36.117013,37.257271,20.262257,-16.995014,310.383714,191.651646,-118.732068,1.927656,7.478488,5.550832,3.932955,21.537176,17.604221,7.381722,27.607301,20.225579,647.436143,19.932187,-627.503956,15.749507,5.027814,-10.721693,268.9,302.3,33.4,0.637189,0,-0.637189,0.036203,0,-0.036203,66.836168,56.287763,-10.548405,193.468354,153.645546,-39.822808,,,,1233.938256,443.760556,-790.1777,31.388716,25.218143,-6.17057300000001,130.533282,252.49325,121.959968,0.87798,18.135932,17.257952,16.078369,29.2468,13.168431,25.177217,22.968892,-2.208325,0.607475,6.513848,5.906373,950.711178,471.905812,-478.805366,192.70402,108.247513,-84.456507,10.330448,1.930555,-8.399893,117.080717,18.118121,-98.962596,140.748884,16.93291,-123.815974,0,1.063888,1.063888,1344.829606,490.210194,-854.619412,303.921256,52.499262,-251.421994,0.231717,1.581969,1.350252,93.733017,2.78223,-90.950787,2248.533029,1057.655223,-1190.877806,1280.560965,1285.904331,5.34336600000006,673.228749,260.049336,-413.179413,0.000574,0.413082,0.412508,38.634974,4.508503,-34.126471,752.875082,670.007334,-82.8677479999998,93.751185,4.067322,-89.683863,0.052278,0.072412,0.020134,7.498911,0.429111,-7.0698,13192.779263,3309.609238,-9883.170025,11.956487,0.371175,-11.585312,0,0,0,3554.559205,2139.054533,-1415.504672,677.577141,1318.298416,640.721275,2812.239516,1961.549342,-850.690174,10241.265969,4475.377949,-5765.88802,570.436708,1090.441696,520.004988,0.782367,0,-0.782367,0.003902,0.092356,0.088454,0.027484,0.042013,0.014529,0.351005,0.120434,-0.230571,5.992856,3.454462,-2.538394,201.059077,186.232252,-14.826825,0.792002,0.356823,-0.435179,0.15789,0.555545,0.397655,0.029346,0.001606,-0.02774,0.298422,1.933635,1.635213,0.126247,0.306283,0.180036,0.056594,0.057989,0.001395,0.142388,0.061061,-0.081327,0.12517,0.085038,-0.040132,0,0.014852,0.014852,0.008188,3.304444,3.296256,0.000375,0.035967,0.035592,4.435664,6.517281,2.081617,0.515625,0.944311,0.428686,1.258295,1.701224,0.442929,0.006,0.736595,0.730595,0.081295,0.019785,-0.06151,13.406944,1.486736,-11.920208,0.557886,0.205375,-0.352511,31.30782,48.892963,17.585143,376.087986,53.620029,-322.467957,4.582582,15.55439,10.971808,139.392742,22.67436,-116.718382,64.430926,204.445553,140.014627,0.021113,3.162013,3.1409,,,,0.002909,0,-0.002909,18.893495,60.179661,41.286166,0.068225,2.351968,2.283743,24.649243,7.678169,-16.971074,0.145557,9.093669,8.948112,0.2535,1.633847,1.380347,4.083084,2.444681,-1.638403,0.768203,3.345784,2.577581,71.626384,10.08143,-61.544954,5.697956,16.256012,10.558056,0.004076,1.345694,1.341618,0.188981,2.703367,2.514386,0.040257,0.641373,0.601116,1077.316635,73.546641,-1003.769994,0.111202,0.39154,0.280338,146.318943,5.924344,-140.394599,3.470355,3.704255,0.2339,1.629851,0.030447,-1.599404,0.008009,0.81931,0.811301,0.034118,2.085886,2.051768,369.998402,39.890239,-330.108163,32.730521,2.981961,-29.74856,0.049389,0.022514,-0.026875,0.312826,0.058695,-0.254131,0,0.172117,0.172117,7.136841,6.116693,-1.020148,3.876465,6.171602,2.295137,0.038044,0.001003,-0.037041,0.349974,0.629936,0.279962,0.01753,1.135296,1.117766,4.9,8.3,3.4,0.016875,4.451402,4.434527,0,10.020408,10.020408,1.775059,4.703098,2.928039,22.410374,11.891971,-10.518403,0.061895,0.360321,0.298426,0,1.020951,1.020951,1.855835,3.236087,1.380252,20.706723,1.4913,-19.215423,5.881667,10.278404,4.396737,41.11769,28.005244,-13.112446,0,0,0,0.0635,0,-0.0635,0.000306,0.135337,0.135031,0,0.013276,0.013276,420.754739,331.24788,-89.506859,15.373635,1.090821,-14.282814,1.592866,2.043758,0.450892000000001,1.922223,1.389777,-0.532446,14.725456,0.933803,-13.791653,3.046534,7.267452,4.220918,9.494897,0.684111,-8.810786,31.822069,2.234638,-29.587431,0,16.520982,16.520982,,,
2004-01-01,5949.285059,1422.7,-4526.585059,19117.095,12703.9,-6413.195,110890,62693,-48197,7022.122455,0,-7022.122455,9112.30284,4316.9,-4795.40284,16751,15073,-1678,7932.936533,5654.815502,-2278.121031,6830.513628,4462.103898,-2368.40973,30126.450348,21399.828494,-8726.62185399999,21374.723865,14070.8739,-7303.849965,2671.838956,1075.864728,-1595.974228,35776.946319,15220.390548,-20556.555771,103993,58924.272142,-45068.727858,42139.083335,16650.043163,-25489.040172,,,,849.183518,1265.280313,416.096795,2182.989717,616.719973,-1566.269744,0.814792,0.277646,-0.537146,18925.752966,13315.847892,-5609.90507399999,0.010451,0,-0.010451,11200.697382,8083.980602,-3116.71678,217.039948,172.224517,-44.815431,5.554294,9.463011,3.908717,138.917541,134.91763,-3.999911,211.741161,228.849382,17.108221,61.760641,36.472092,-25.288549,213.829058,281.544814,67.715756,37.7729,102.982903,65.210003,0.780348,70.004585,69.224237,44.358419,74.897467,30.539048,0,34.930076,34.930076,23.080214,102.479413,79.399199,0.382743,10.413145,10.030402,0.619935,27.215714,26.595779,17.768909,58.440184,40.671275,238.556311,307.866127,69.309816,0.082309,1.225754,1.143445,1.416589,10.158729,8.74214,3.14773,5.583487,2.435757,0.292094,8.462363,8.170269,0.093415,0.658452,0.565037,0.424852,2.349691,1.924839,0.88452,6.791448,5.906928,0.195289,3.89089,3.695601,0.395518,4.438486,4.042968,1.542183,26.878862,25.336679,459.570515,100.932397,-358.638118,21.825377,58.585492,36.760115,,,,,,,134.848092,20.922462,-113.92563,0.280278,3.118577,2.838299,0.017626,2.515369,2.497743,600.670076,360.745917,-239.924159,1764.850051,280.529606,-1484.320445,8.076382,9.352258,1.275876,14.37015,15.93599,1.56584,0.000291,0.761937,0.761646,311.633636,116.257909,-195.375727,228.805894,145.052256,-83.753638,13.093784,15.898893,2.805109,358.582022,224.736426,-133.845596,1393.365326,1042.49573,-350.869596,3.778408,42.71321,38.934802,29.247456,19.73402,-9.513436,266.861343,278.477775,11.616432,0,0.198452,0.198452,16.887222,11.938881,-4.948341,895.782955,234.550317,-661.232638,0,0.000204,0.000204,441.693997,106.798527,-334.89547,402.753032,136.762697,-265.990335,0.468136,0.476278,0.00814199999999993,243.798658,143.13537,-100.663288,3203.083405,2802.919536,-400.163869,1520.7634,627.558962,-893.204438,853.430368,1634.91278,781.482412,897.442116,1236.383591,338.941475,17.452846,24.053213,6.600367,0.276921,0.626071,0.34915,1.312574,0.727445,-0.585129,2258.015912,1484.417538,-773.598374,5013.050661,2309.694514,-2703.356147,322.604889,122.069385,-200.535504,,,,103.883572,55.842389,-48.041183,81.417955,7.212867,-74.205088,290.56869,99.414649,-191.154041,18.211747,0.707495,-17.504252,788.044835,620.680548,-167.364287,28.677822,9.100998,-19.576824,54.64793,5.894541,-48.753389,22.140661,17.33834,-4.802321,112.691396,66.067899,-46.623497,,,,458.901805,158.718398,-300.183407,17.671663,4.092553,-13.57911,30.135911,15.745862,-14.390049,2.636492,5.333964,2.697472,1.69342,13.458343,11.764923,2.440852,17.28111,14.840258,29.371608,33.264155,3.89254700000001,1.000922,1.040206,0.0392839999999997,3.285485,5.490054,2.204569,1.00692,4.05634,3.04942,4.691112,1.137523,-3.553589,5.842515,5.807682,-0.0348329999999999,521.198088,562.171221,40.973133,145.276843,97.796912,-47.479931,0.169018,0.355758,0.18674,44.823808,12.230173,-32.593635,0.106841,0.081845,-0.024996,0.089213,0.287891,0.198678,2002.786447,761.299965,-1241.486482,,,,18.30002,7.361102,-10.938918,27.498203,12.1984,-15.299803,0.710555,2.107059,1.396504,7.61541,1.873696,-5.741714,2.009341,26.713176,24.703835,,,,,,,,,,1.572408,1.66062,0.0882119999999995,50.537393,234.038146,183.500753,56.118191,50.945635,-5.17255600000001,32.221658,8.26129,-23.960368,313.141445,259.995167,-53.146278,2.768578,6.784619,4.016041,15.705299,23.974301,8.269002,6.889581,29.167586,22.278005,607.826598,21.320782,-586.505816,11.529477,11.251499,-0.277977999999997,295.4,341.3,45.9,0.122071,0.00595,-0.116121,0,0,0,71.019644,46.530953,-24.488691,187.497749,92.530848,-94.966901,,,,1447.976827,378.143604,-1069.833223,29.138877,34.303481,5.164604,72.381451,248.212508,175.831057,0.543388,16.894811,16.351423,36.898937,17.793504,-19.105433,31.681623,19.053048,-12.628575,0.970807,13.022186,12.051379,1181.200818,341.530573,-839.670245,196.903768,226.035972,29.132204,13.7975,1.64925,-12.14825,173.881313,11.450631,-162.430682,171.978977,9.75677,-162.222207,0,0.48194,0.48194,1257.06312,490.022058,-767.041062,382.184247,55.112704,-327.071543,0.067493,0.075052,0.007559,126.278815,5.696007,-120.582808,2111.647202,928.75111,-1182.896092,1147.546653,1231.444194,83.8975409999998,773.826861,191.758841,-582.06802,0,1.023916,1.023916,19.873913,3.425536,-16.448377,712.919675,601.281481,-111.638194,135.122825,3.048883,-132.073942,0.071063,0.313368,0.242305,6.088173,0.461097,-5.627076,14089.015496,2620.489793,-11468.525703,15.454283,4.504631,-10.949652,0,0,0,3364.651334,1831.414533,-1533.236801,805.82858,1072.414616,266.586036,2614.909966,1519.542159,-1095.367807,9171.944935,3974.980231,-5196.964704,595.923137,1028.842254,432.919117,0.341586,0.013721,-0.327865,0.01723,0.354547,0.337317,0.090817,0.122666,0.031849,0.004396,0.006534,0.002138,3.332839,1.151065,-2.181774,230.402903,211.845852,-18.5570509999999,0.157912,0.268499,0.110587,0.27077,2.764372,2.493602,0.000263,0,-0.000263,0.213514,0.70096,0.487446,0.057129,0.05198,-0.00514899999999999,0.032847,0.527188,0.494341,0.10593,0.014328,-0.091602,0.081062,0.069457,-0.011605,0,0.000816,0.000816,0.195281,4.564392,4.369111,0,0.019417,0.019417,4.324822,6.438765,2.113943,0.475297,1.702611,1.227314,0.899232,1.832306,0.933074,0,1.011478,1.011478,0.003927,0.012156,0.008229,11.918069,1.788295,-10.129774,0.436282,0.72086,0.284578,45.162716,84.241335,39.078619,358.672699,48.849311,-309.823388,17.711987,37.566295,19.854308,157.163183,30.514336,-126.648847,66.03476,284.326924,218.292164,0,0.1775,0.1775,,,,0,0,0,98.440879,41.853827,-56.587052,2.759584,2.449312,-0.310272,30.189371,4.078101,-26.11127,0.144127,4.300742,4.156615,0.117588,1.462805,1.345217,4.595655,3.947209,-0.648445999999999,0.431029,3.239163,2.808134,73.624563,3.157728,-70.466835,4.746733,16.642445,11.895712,0.080778,0.668557,0.587779,0.036925,1.732989,1.696064,0.087627,0.751314,0.663687,882.167123,114.34285,-767.824273,0.042588,0.164901,0.122313,119.847789,22.176058,-97.671731,68.053968,2.647193,-65.406775,1.209888,2.552282,1.342394,0.019091,1.274615,1.255524,0.108736,2.072737,1.964001,275.610571,94.790203,-180.820368,9.036162,4.753276,-4.282886,0.048079,0.073768,0.025689,0.204103,0.049515,-0.154588,0,0.178384,0.178384,6.395326,10.674667,4.279341,11.324137,4.903267,-6.42087,0.078244,1.022655,0.944411,0.474206,0.995467,0.521261,0.016609,0.057848,0.041239,0.6,99.7,99.1,0.130782,2.476967,2.346185,0.168308,12.393364,12.225056,2.288514,2.784684,0.496169999999999,24.748273,9.128451,-15.619822,0.058808,0.522224,0.463416,0.045613,0.069221,0.023608,2.224273,5.09542,2.871147,22.867875,1.726626,-21.141249,0.446612,9.834085,9.387473,41.653776,1.469088,-40.184688,0,0,0,11.061327,0,-11.061327,0.006296,0.065835,0.059539,0.00528,0.035105,0.029825,413.407309,194.885136,-218.522173,4.847177,4.571111,-0.276066,3.769192,8.883842,5.11465,2.303096,1.619579,-0.683517,16.303229,0.535252,-15.767977,7.546347,5.316605,-2.229742,7.089453,0.792072,-6.297381,31.894316,1.321068,-30.573248,0,0,0,,,
2004-02-01,6021.755249,1400.5,-4621.255249,21879.6,13917.5,-7962.1,113977,65852.5,-48124.5,7376.530271,0,-7376.530271,9977.433127,5007,-4970.433127,16664,15973,-691,7051.418204,6528.049967,-523.368236999999,6827.453167,4816.047551,-2011.405616,31065.800338,22472.070439,-8593.72989900001,24464.16866,15333.162198,-9131.006462,3080.589,1103.147977,-1977.441023,32719.579817,16627.523546,-16092.056271,104864,63118.328934,-41745.671066,38739.801614,18086.21519,-20653.586424,,,,685.36676,1307.643284,622.276524,2460.914229,624.501901,-1836.412328,1.011666,0.036295,-0.975371,19356.616313,14398.639635,-4957.976678,0.03099,0.006,-0.02499,11709.184025,8073.430804,-3635.753221,223.636037,192.111929,-31.524108,8.280676,9.898862,1.618186,155.837311,158.610829,2.773518,281.232397,234.329166,-46.903231,75.850968,40.627519,-35.223449,287.539115,296.946957,9.40784200000002,32.38276,124.345064,91.962304,0.569293,25.028867,24.459574,48.886559,76.356356,27.469797,0.033329,24.57047,24.537141,22.437595,106.441888,84.004293,0.414141,7.309376,6.895235,0.322286,25.750796,25.42851,29.369847,38.60101,9.23116300000001,368.72802,335.166388,-33.5616319999999,0.042689,1.012256,0.969567,1.868286,7.094084,5.225798,3.113816,4.495658,1.381842,0.38415,10.356694,9.972544,0.019961,0.41452,0.394559,0.207922,3.114383,2.906461,1.239488,7.878814,6.639326,0.162028,4.003815,3.841787,0.304599,6.996164,6.691565,4.089978,25.531334,21.441356,487.175817,88.978291,-398.197526,66.204952,83.107579,16.902627,,,,,,,104.866245,24.261277,-80.604968,0.033316,5.668862,5.635546,0.425491,1.863718,1.438227,502.000764,345.306886,-156.693878,1705.65374,290.858655,-1414.795085,9.690697,9.771571,0.0808739999999979,3.817731,10.584505,6.766774,0.01674,1.458693,1.441953,294.222196,133.374138,-160.848058,262.08053,155.749841,-106.330689,22.115488,14.588405,-7.527083,346.296517,242.563641,-103.732876,1208.526471,1317.4445,108.918029,1.49927,53.024758,51.525488,31.402624,28.786339,-2.61628499999999,233.359006,241.566722,8.20771599999998,1.112321,0.095971,-1.01635,30.496507,11.72373,-18.772777,1067.808531,259.391617,-808.416914,0,0,0,479.44562,132.50112,-346.9445,289.484498,150.106321,-139.378177,0.693562,0.38389,-0.309672,306.565714,206.781244,-99.7844700000001,3494.846395,2872.759225,-622.08717,2665.613188,701.975267,-1963.637921,929.093761,2015.788275,1086.694514,935.866594,1271.981412,336.114818,18.363336,75.604905,57.241569,0.04814,1.268758,1.220618,3.153185,1.557203,-1.595982,2160.78964,1580.944109,-579.845531,5988.41995,2502.728532,-3485.691418,393.989498,145.168755,-248.820743,,,,136.749418,51.24152,-85.507898,76.571481,31.3815,-45.189981,296.346157,224.885296,-71.460861,22.48494,0.670864,-21.814076,866.068496,615.725908,-250.342588,20.03662,11.636394,-8.400226,56.895305,11.571034,-45.324271,42.050809,19.235848,-22.814961,117.836363,63.826641,-54.009722,,,,653.456802,200.599756,-452.857046,19.978792,1.374909,-18.603883,54.650444,24.919999,-29.730445,2.656066,8.832186,6.17612,2.077234,13.368767,11.291533,1.122769,17.025634,15.902865,25.609604,23.274142,-2.335462,0.930289,2.818535,1.888246,5.951268,3.675905,-2.275363,1.140434,17.078149,15.937715,2.917519,8.895523,5.978004,5.083802,4.994929,-0.0888730000000004,530.847151,600.799218,69.9520669999999,140.384673,55.357044,-85.027629,0.045157,0.341474,0.296317,37.152011,12.169201,-24.98281,0.126046,0.001513,-0.124533,0.003809,0.100924,0.097115,2092.241125,773.215255,-1319.02587,,,,24.736114,6.548289,-18.187825,42.354332,14.536395,-27.817937,0.615027,1.430974,0.815947,11.43217,1.270122,-10.162048,1.480251,6.423894,4.943643,,,,,,,,,,0.641586,0.84252,0.200934,37.25073,252.790096,215.539366,49.78435,46.829647,-2.95470300000001,23.508661,6.622755,-16.885906,294.261391,254.553405,-39.707986,2.011345,11.63167,9.620325,11.615581,34.624913,23.009332,5.079955,35.379828,30.299873,487.684522,28.331245,-459.353277,15.055176,6.208769,-8.846407,251.3,289.5,38.2,0,0.002802,0.002802,0.0568,0.014979,-0.041821,73.980365,39.162612,-34.817753,147.811645,111.575059,-36.236586,,,,1322.82342,317.294163,-1005.529257,22.510035,24.073585,1.56355000000001,66.718712,222.006628,155.287916,0.295357,19.368076,19.072719,15.776785,21.346199,5.56941399999999,25.419397,19.816969,-5.602428,3.88633,5.903871,2.017541,1136.023421,389.430644,-746.592777,217.437697,214.832231,-2.60546600000004,14.062069,1.168917,-12.893152,166.553078,21.803597,-144.749481,150.272877,9.585906,-140.686971,0,0.494687,0.494687,1249.730035,528.607303,-721.122732,356.498445,43.733248,-312.765197,0.418254,0.123087,-0.295167,110.321109,6.429008,-103.892101,1893.571885,907.69565,-985.876235,1140.386621,1389.16339,248.776769,762.584587,215.187458,-547.397129,0,1.057071,1.057071,41.249661,2.408782,-38.840879,723.984723,637.716154,-86.2685690000002,80.981887,3.854328,-77.127559,0.019955,0.263961,0.244006,6.535925,0.340713,-6.195212,11267.147675,2928.991616,-8338.156059,11.212504,0.750666,-10.461838,0,0,0,3085.627999,2228.957703,-856.670296,531.396516,1258.768712,727.372196,2294.007068,1651.160162,-642.846906,10238.373233,4116.699159,-6121.674074,446.698173,1067.490057,620.791884,0.404838,0.012244,-0.392594,0,0.246513,0.246513,0.01165,0.088689,0.077039,0,0,0,6.364986,0.958891,-5.406095,207.204803,218.471484,11.2666810000001,0.148295,0.039973,-0.108322,0.053432,2.153785,2.100353,0,0.269188,0.269188,0.118549,0.766237,0.647688,0.086381,0.101258,0.014877,0.321855,0.53363,0.211775,0.000398,0.038473,0.038075,0.099847,0.010931,-0.088916,0,0,0,2.567123,2.528116,-0.0390070000000007,0,0.069033,0.069033,3.007247,7.303795,4.296548,0.496349,1.08559,0.589241,1.549386,1.593973,0.0445870000000002,0.005222,1.320125,1.314903,0,0.052837,0.052837,15.741037,1.356912,-14.384125,0.423339,0.387846,-0.0354929999999999,37.868835,94.026871,56.158036,490.974062,89.501955,-401.472107,6.737987,19.331288,12.593301,255.846997,36.729189,-219.117808,83.001482,273.871436,190.869954,0,0.072847,0.072847,,,,0,0,0,87.943152,25.306285,-62.636867,0.010892,3.862184,3.851292,13.478693,14.701331,1.222638,0.153619,7.235124,7.081505,0.200031,1.479888,1.279857,3.674983,3.728335,0.053351999999999,1.001586,1.06975,0.0681639999999999,63.382764,14.96298,-48.419784,17.488774,28.208923,10.720149,0.009368,0.77187,0.762502,1.541087,2.235929,0.694842,0.056372,0.976595,0.920223,1177.620467,94.916219,-1082.704248,0.161914,0.299822,0.137908,228.442935,14.680783,-213.762152,51.312669,3.553664,-47.759005,0.981602,0.230926,-0.750676,0.11548,1.63142,1.51594,0.022587,2.657134,2.634547,290.681274,39.546751,-251.134523,13.617236,3.908778,-9.708458,0.000344,0.005719,0.005375,0.102038,0.020796,-0.081242,0.003033,0.037155,0.034122,4.815578,4.795458,-0.0201200000000012,10.99701,2.029719,-8.967291,0.043427,0.22767,0.184243,0.157076,0.516586,0.35951,0.080923,0.24399,0.163067,0.6,2.8,2.2,0.014492,5.236723,5.222231,0.079027,5.215615,5.136588,3.368331,2.107964,-1.260367,25.329452,16.298549,-9.030903,0.010679,0.246102,0.235423,0.104451,0.534969,0.430518,1.662481,4.687869,3.025388,24.462545,1.742512,-22.720033,0.418263,9.69668,9.278417,48.539874,1.523814,-47.01606,0,0.175284,0.175284,4.217206,0.030532,-4.186674,0.006352,0.387522,0.38117,0,0.00519,0.00519,317.24431,266.274294,-50.970016,11.980367,3.879388,-8.100979,3.147444,7.885413,4.737969,1.606161,1.581524,-0.0246369999999998,11.221699,0.580918,-10.640781,3.138384,12.146774,9.00839,7.818734,1.412878,-6.405856,28.190347,0.469669,-27.720678,0,0,0,,,
2004-03-01,6989.478656,1814.8,-5174.678656,25653.899,16052.7,-9601.199,118678,67871,-50807,8403.473678,0,-8403.473678,11789.328659,6001,-5788.328659,20398,19036,-1362,8528.242666,7658.086353,-870.156312999999,7829.441798,5355.512384,-2473.929414,36077.004437,26939.138979,-9137.865458,28761.483067,17821.458265,-10940.024802,3742.018219,1094.239328,-2647.778891,39125.326337,19472.207921,-19653.118416,123421,73889.7241160001,-49531.2758839999,46077.888849,21310.829883,-24767.058966,,,,929.943583,1367.742848,437.799265,2991.006829,652.030971,-2338.975858,2.891191,0.799213,-2.091978,22483.164173,17227.011761,-5256.152412,0.083219,0.003216,-0.080003,13593.840264,9712.127218,-3881.713046,308.638226,217.998003,-90.6402229999999,11.094504,14.00406,2.909556,179.581182,172.702397,-6.87878500000002,340.100185,272.531023,-67.569162,85.102945,61.07428,-24.028665,329.429762,338.324904,8.89514200000008,23.360765,147.515385,124.15462,0.803196,64.952341,64.149145,58.419905,103.531137,45.111232,0.004,62.463298,62.459298,26.106017,121.355719,95.249702,0.618702,7.458499,6.839797,0.627442,29.492959,28.865517,23.659779,35.729907,12.070128,403.599052,382.02197,-21.577082,0.039717,1.400963,1.361246,1.257293,14.746437,13.489144,3.633125,4.04671,0.413585,0.134542,12.162723,12.028181,0.004152,1.776912,1.77276,0.214522,3.907252,3.69273,1.383019,8.476148,7.093129,0.30457,3.592663,3.288093,0.495456,4.945549,4.450093,2.827589,29.776722,26.949133,444.397056,90.75218,-353.644876,33.424603,70.668802,37.244199,,,,,,,124.099155,39.106728,-84.992427,1.268708,3.79419,2.525482,0.047156,1.373555,1.326399,532.633236,388.087985,-144.545251,2058.040943,398.39866,-1659.642283,7.977402,11.799342,3.82194,13.574201,16.651948,3.07774700000001,0,1.047081,1.047081,254.95687,143.299335,-111.657535,245.670865,180.400711,-65.270154,19.195442,14.937189,-4.25825299999999,467.820857,280.141424,-187.679433,1513.331823,1270.024756,-243.307067,2.09571,52.344689,50.248979,39.779306,29.282414,-10.496892,269.685236,247.403195,-22.282041,0.003582,0.010239,0.006657,27.503921,15.402053,-12.101868,1247.84626,301.139724,-946.706536,0,0.027799,0.027799,471.692235,148.852893,-322.839342,367.270293,165.995658,-201.274635,0.940348,1.431073,0.490725,336.946856,308.680081,-28.2667750000001,4233.536043,3384.191631,-849.344411999999,2850.860007,698.410174,-2152.449833,1035.407426,2088.288109,1052.880683,1215.743687,1540.068338,324.324651,18.881937,68.286986,49.405049,0.034831,0.989321,0.95449,1.871529,5.274182,3.402653,2732.283734,2112.171749,-620.111985,6790.87094,2838.22635,-3952.64459,495.914722,161.745433,-334.169289,,,,166.886281,147.45684,-19.429441,127.363068,9.336817,-118.026251,233.577595,66.863138,-166.714457,27.38219,0.704424,-26.677766,1083.291728,755.271464,-328.020264,31.562524,22.23934,-9.32318400000001,67.127499,13.001025,-54.126474,66.817866,24.066933,-42.750933,139.744082,64.779715,-74.964367,,,,822.610468,258.455811,-564.154657,60.679189,3.159367,-57.519822,31.40774,33.962146,2.554406,3.027071,6.636486,3.609415,0.260427,12.356563,12.096136,8.181214,26.042602,17.861388,8.904045,17.329532,8.425487,0.578966,4.335495,3.756529,4.208033,1.081052,-3.126981,0.50055,1.858395,1.357845,6.314895,8.481871,2.166976,7.406032,4.092194,-3.313838,711.952096,602.885926,-109.06617,171.042449,114.869889,-56.17256,0.08195,8.524452,8.442502,31.544908,14.966615,-16.578293,0.298758,0.10722,-0.191538,0.060681,0.847241,0.78656,2484.441277,954.169391,-1530.271886,,,,21.334013,11.334504,-9.999509,50.964101,21.147051,-29.81705,0.962933,5.544933,4.582,5.863885,0.480994,-5.382891,2.195156,30.137534,27.942378,,,,,,,,,,0.767434,1.468699,0.701265,43.146009,321.358289,278.21228,64.338511,48.755545,-15.582966,30.493461,16.759371,-13.73409,414.392125,339.105358,-75.2867669999999,2.167088,8.302489,6.135401,19.744604,23.185645,3.441041,6.783086,28.802617,22.019531,716.895458,43.40487,-673.490588,14.199298,7.801903,-6.397395,296.3,341.1,44.8,0.11904,0,-0.11904,0.000323,0.015333,0.01501,84.582965,40.38116,-44.201805,189.671375,132.776712,-56.894663,,,,1401.221047,492.320023,-908.901024,26.277872,28.84222,2.56434800000001,69.804948,272.789846,202.984898,0.427884,21.936037,21.508153,30.697679,19.336331,-11.361348,32.395173,33.695678,1.300505,9.888802,6.76122,-3.127582,1459.496456,468.109897,-991.386559,226.242577,221.657186,-4.58539100000004,14.477721,1.065668,-13.412053,152.275075,23.376293,-128.898782,167.161328,15.298262,-151.863066,0,0.304781,0.304781,1435.481082,528.318527,-907.162555,406.510263,60.273497,-346.236766,0.277917,0.455766,0.177849,104.670555,3.956144,-100.714411,2223.75781,1019.803103,-1203.954707,1273.6526,1899.522147,625.869547,932.196466,261.173717,-671.022749,0,0.599058,0.599058,19.342616,4.695914,-14.646702,840.453583,718.585654,-121.867929,89.123858,15.636314,-73.487544,0.004488,0.08104,0.076552,9.65355,0.651523,-9.002027,13800.119971,3361.910701,-10438.20927,10.471551,3.854408,-6.617143,0,5.532069,5.532069,3741.914842,2350.353704,-1391.561138,692.419517,1384.796128,692.376611,2820.255707,2023.414374,-796.841333,11791.7402,5085.931016,-6705.809184,636.985713,1187.910221,550.924508,0.468854,0.099885,-0.368969,0.075641,0.046333,-0.029308,0.05855,0.142834,0.084284,0,0,0,2.084975,0.802868,-1.282107,261.278479,157.67206,-103.606419,0.093468,0.119186,0.025718,0.216213,3.302095,3.085882,0,0.000557,0.000557,0.209386,0.831089,0.621703,0.056451,0.293587,0.237136,0.524611,0.133405,-0.391206,0,0.076291,0.076291,0.100214,0.168456,0.068242,0.005325,0,-0.005325,2.311515,1.889894,-0.421621,0,0.018597,0.018597,4.675252,7.101168,2.425916,0.43664,1.612523,1.175883,1.188098,1.766425,0.578327,0.043465,1.117208,1.073743,0.027501,0.064281,0.03678,18.552867,1.943452,-16.609415,0.482672,0.48853,0.00585799999999992,49.589478,27.014056,-22.575422,585.592416,57.363116,-528.2293,13.535492,36.359365,22.823873,205.640559,39.914204,-165.726355,101.902467,320.771824,218.869357,0,3.364379,3.364379,,,,0,0,0,126.462323,17.423367,-109.038956,0.902142,7.033724,6.131582,19.539953,10.327348,-9.212605,0.234376,10.099941,9.865565,0.237259,9.785583,9.548324,5.729358,7.018607,1.289249,1.094603,4.115038,3.020435,75.575802,8.766533,-66.809269,5.017089,28.33838,23.321291,0.01235,0.90824,0.89589,10.867404,2.214718,-8.652686,0.047165,0.946041,0.898876,1334.343091,119.549326,-1214.793765,0.196602,0.181339,-0.015263,169.574277,5.957271,-163.617006,73.955545,2.541276,-71.414269,0.072393,0.158842,0.086449,0.004284,3.192321,3.188037,0.111133,4.68929,4.578157,338.475338,35.079233,-303.396105,51.920217,5.453425,-46.466792,0.049494,0.055777,0.00628299999999999,0.429766,0.125616,-0.30415,0.043558,0.046086,0.00252800000000002,8.557927,3.143551,-5.414376,12.616362,6.939079,-5.677283,0.023092,3.332047,3.308955,0.268333,0.128458,-0.139875,0.010167,0.130515,0.120348,1,8.5,7.5,0.070233,5.090541,5.020308,0.12033,1.039859,0.919529,2.000531,7.431586,5.431055,30.654435,19.598278,-11.056157,0.5838,0.495521,-0.0882790000000002,0.2781,0.018934,-0.259166,1.909556,7.697816,5.78826,20.886467,1.787157,-19.09931,0.678235,4.713757,4.035522,35.290518,3.41264,-31.877878,0,0.078291,0.078291,0.050154,0.533839,0.483685,0.038768,0.104675,0.065907,0.002276,0.005156,0.00288,560.064291,272.635081,-287.42921,27.909213,3.803568,-24.105645,6.902866,1.560408,-5.342458,1.603511,2.124849,0.521338,15.717269,1.470776,-14.246493,3.323923,4.721973,1.39805,4.258485,3.837337,-0.421148000000001,40.913641,0.037478,-40.876163,0,0,0,,,
2004-04-01,6743.254862,1558.6,-5184.654862,24408.431,14743.8,-9664.631,118542,67069.9,-51472.1,7656.640976,0,-7656.640976,11124.374276,5828.8,-5295.574276,19572,16497,-3075,8366.769919,6594.605232,-1772.164687,7492.097953,4941.083184,-2551.014769,34074.553623,25368.853027,-8705.70059599999,27754.016054,16472.685353,-11281.330701,3527.945755,842.088234,-2685.857521,39126.181131,16991.624608,-22134.556523,118885,67555.995912,-51329.004088,45212.801762,18671.572947,-26541.228815,,,,823.567277,1238.739697,415.17242,2740.113901,575.449354,-2164.664547,0.07627,0.225364,0.149094,21498.633661,16026.973551,-5471.66011,0.088333,0.000297,-0.088036,12575.919962,9341.879476,-3234.040486,255.455361,205.856685,-49.598676,7.869227,13.426224,5.556997,149.646418,177.707206,28.060788,269.948855,263.401127,-6.54772800000001,67.953672,47.803385,-20.150287,279.449593,296.756606,17.3070129999999,23.282511,164.364434,141.081923,0.707783,35.177835,34.470052,48.134104,94.238584,46.10448,0,56.273931,56.273931,22.838713,110.428133,87.58942,0.405185,8.878604,8.473419,0.559744,26.120246,25.560502,34.101221,55.217716,21.116495,356.691611,362.077558,5.38594699999999,0.033246,1.109263,1.076017,1.315201,12.093856,10.778655,3.941711,4.754409,0.812698,0.381904,8.986182,8.604278,0.042709,0.623711,0.581002,0.118838,3.821101,3.702263,1.373514,9.823189,8.449675,0.549485,4.054835,3.50535,0.451866,3.920945,3.469079,4.791282,28.697431,23.906149,422.642172,98.631077,-324.011095,45.935488,65.796601,19.861113,,,,,,,118.043356,29.05376,-88.989596,0.112343,2.269941,2.157598,0.009525,1.696661,1.687136,515.800774,364.036681,-151.764093,1956.179605,389.019419,-1567.160186,11.975512,11.624533,-0.350979000000004,11.050144,14.523242,3.473098,0,0.549691,0.549691,346.166973,121.949651,-224.217322,247.842738,142.344853,-105.497885,24.706815,15.940193,-8.766622,391.066972,264.682648,-126.384324,1553.501827,1104.274051,-449.227776,4.765584,46.030699,41.265115,35.399996,22.950819,-12.449177,276.184099,250.095189,-26.08891,0.670276,0.000279,-0.669997,24.50418,74.849273,50.345093,1259.563016,279.96544,-979.597576,0,0.009569,0.009569,537.614675,172.778784,-364.835891,304.494035,210.742438,-93.7515970000001,0.459615,1.515153,1.055538,317.098586,279.961906,-37.13668,4167.856732,3044.574516,-1123.282216,2771.256807,559.277866,-2211.978941,975.768894,2140.614173,1164.845279,1040.603643,1410.008883,369.40524,22.616562,206.681809,184.065247,0.012127,0.841005,0.828878,1.583623,0.651666,-0.931957,2541.938636,1740.713538,-801.225098,6621.267579,2557.665602,-4063.601977,490.036883,171.405068,-318.631815,,,,136.631792,61.494977,-75.136815,133.648199,8.302557,-125.345642,201.522027,149.22863,-52.293397,25.503343,1.143555,-24.359788,1129.884725,748.103096,-381.781629,49.468161,9.06744,-40.400721,20.391972,11.961517,-8.43045499999999,41.563915,26.471085,-15.09283,150.430294,86.420558,-64.009736,,,,954.757526,243.691125,-711.066401,16.157758,4.208455,-11.949303,60.713021,27.822234,-32.890787,4.932681,14.416907,9.484226,2.871577,7.921359,5.049782,7.482311,15.61139,8.129079,29.358541,22.354068,-7.00447299999999,0.794385,3.59791,2.803525,4.368949,2.245345,-2.123604,0.405148,5.070965,4.665817,6.737827,33.415548,26.677721,6.325945,14.759562,8.43361700000001,580.894291,490.811143,-90.0831479999999,162.513775,98.985836,-63.527939,0.182585,5.036387,4.853802,28.498112,14.846397,-13.651715,0.042823,0.174322,0.131499,0.039604,0.142362,0.102758,2294.911387,1006.598491,-1288.312896,,,,20.365203,5.337139,-15.028064,43.856382,14.290279,-29.566103,0.784761,0.718209,-0.0665519999999998,2.97551,1.00828,-1.96723,3.090938,7.36632,4.275382,,,,,,,,,,1.236102,2.369368,1.133266,49.488388,155.282962,105.794574,48.678318,28.46037,-20.217948,40.217433,12.756448,-27.460985,413.503374,270.491731,-143.011643,2.111378,8.444337,6.332959,19.151983,17.358616,-1.793367,8.36716,28.850325,20.483165,704.942948,45.557178,-659.38577,10.615594,4.367435,-6.248159,269.6,454.3,184.7,0,0,0,0.014518,0.164345,0.149827,64.060017,41.41806,-22.641957,233.940387,115.446639,-118.493748,,,,1072.038087,383.36011,-688.677977,38.892463,30.510503,-8.38195999999999,93.803419,252.959208,159.155789,0.687049,6.863112,6.176063,15.883573,30.69736,14.813787,24.345637,24.964538,0.618901000000005,3.452957,13.322055,9.869098,1247.414377,438.636363,-808.778014,229.138346,73.646418,-155.491928,13.691691,5.840442,-7.851249,157.046512,20.003982,-137.04253,130.409577,18.69292,-111.716657,0,1.332267,1.332267,1331.797131,476.029494,-855.767637,364.705561,61.209425,-303.496136,0.258941,0.579301,0.32036,90.622328,4.194609,-86.427719,2277.248756,917.943986,-1359.30477,1249.098288,1670.379666,421.281378,868.677183,190.87155,-677.805633,0,0.621489,0.621489,53.954418,8.806011,-45.148407,701.90919,668.244092,-33.6650979999999,89.133153,8.221693,-80.91146,0.00035,0.552188,0.551838,3.827538,0.659839,-3.167699,14744.78415,2734.55386,-12010.23029,8.635204,1.12516,-7.510044,0.07677,2.34665,2.26988,3651.88355,1970.948963,-1680.934587,655.542497,1267.370438,611.827941,2810.245584,1685.906165,-1124.339419,11230.066364,4653.308815,-6576.757549,523.063757,1064.82895,541.765193,0.58727,0.040791,-0.546479,0.020361,0.077335,0.056974,0.02451,0.262365,0.237855,0,0.021665,0.021665,1.864559,3.195168,1.330609,268.709682,147.045251,-121.664431,0.260122,0.085485,-0.174637,0.186594,1.80073,1.614136,0,0.004725,0.004725,0.356542,1.247073,0.890531,0.0871,0.131045,0.043945,0.15935,0.035096,-0.124254,0,0.042674,0.042674,0.100065,0.242196,0.142131,0.0035,0.0191,0.0156,2.140333,4.454439,2.314106,0,0.011353,0.011353,3.647451,6.942607,3.295156,0.461996,1.705574,1.243578,0.862172,2.857263,1.995091,0.017537,1.196761,1.179224,0.034772,0.0685,0.033728,20.546211,1.811562,-18.734649,0.372124,0.471033,0.098909,33.595782,21.477042,-12.11874,680.490672,42.965864,-637.524808,12.839822,7.115786,-5.724036,232.526515,33.906902,-198.619613,60.174109,192.08138,131.907271,0,3.002626,3.002626,,,,0,0,0,74.750143,22.52451,-52.225633,2.616371,1.612823,-1.003548,49.816769,13.598015,-36.218754,0.38437,8.534524,8.150154,0.276485,1.776297,1.499812,2.765041,1.683206,-1.081835,1.463514,3.054303,1.590789,64.693638,6.689623,-58.004015,5.539498,35.433815,29.894317,0.005359,2.113148,2.107789,0.704881,1.649359,0.944478,0.165955,1.143224,0.977269,1246.496505,103.509706,-1142.986799,0.190886,0.609505,0.418619,162.019962,4.991309,-157.028653,70.54209,2.808236,-67.733854,0.714357,0.012991,-0.701366,0.04145,0.586191,0.544741,0.022732,3.593755,3.571023,359.688209,35.238117,-324.450092,42.849979,3.466906,-39.383073,0.000356,0.191205,0.190849,0.130003,0.531915,0.401912,0.004216,0.393858,0.389642,6.823919,2.909772,-3.914147,0.761548,5.197515,4.435967,0.026578,4.303153,4.276575,0.031582,0.779887,0.748305,0.005735,0.327408,0.321673,3.4,2.2,-1.2,0.000687,5.936144,5.935457,0.100482,1.125951,1.025469,1.88016,4.837552,2.957392,27.670331,11.169182,-16.501149,0.321003,0.438101,0.117098,0.016833,0.259123,0.24229,2.568271,3.590416,1.022145,23.382605,1.840128,-21.542477,0.232412,3.564153,3.331741,29.698813,0.947011,-28.751802,0,0.001251,0.001251,0.108962,0.008853,-0.100109,0.000279,0.12028,0.120001,0,2.564643,2.564643,476.538317,233.835652,-242.702665,10.776115,7.462832,-3.313283,8.416458,0.811851,-7.604607,0.151256,3.07475,2.923494,15.692141,1.242212,-14.449929,8.818808,5.215366,-3.603442,4.20949,2.786983,-1.422507,33.24781,0.007281,-33.240529,0,20.747809,20.747809,,,
2004-05-01,7520.114768,1796.6,-5723.514768,23337.897,14825.5,-8512.397,120671,68677.4,-51993.6,8152.274495,0,-8152.274495,11009.948824,5933.9,-5076.048824,18631,17013,-1618,8796.36667,7414.109788,-1382.256882,7871.531153,5128.32702,-2743.204133,34299.756512,25527.724981,-8772.03153099999,26339.074457,16510.148678,-9828.925779,3771.466927,1269.143579,-2502.323348,38405.644363,17757.324111,-20648.320252,118271,69296.488583,-48974.511417,45052.719571,19457.465274,-25595.254297,,,,935.059922,1394.097903,459.037981,3011.332918,806.546939,-2204.785979,1.217564,0.17669,-1.040874,21250.073962,16311.389989,-4938.683973,0.234406,0.025048,-0.209358,13049.68255,9216.334992,-3833.347558,242.786521,202.654684,-40.131837,7.549831,14.86325,7.313419,155.227664,183.970962,28.743298,305.865811,262.890505,-42.975306,67.310252,56.656048,-10.654204,296.159173,293.35252,-2.80665299999998,25.296466,167.699975,142.403509,1.114737,34.934531,33.819794,56.512507,87.861217,31.34871,0,33.940488,33.940488,26.185569,98.099455,71.913886,0.492708,9.25184,8.759132,0.414815,29.093857,28.679042,32.664321,68.984619,36.320298,365.680749,352.951937,-12.7288120000001,0.1482,1.240439,1.092239,4.188364,8.056748,3.868384,2.98679,4.251549,1.264759,0.124295,9.047801,8.923506,0.012343,0.195235,0.182892,0.279992,3.216623,2.936631,1.162549,7.04301,5.880461,0.451621,4.938517,4.486896,0.369013,4.509141,4.140128,3.051762,24.439828,21.388066,433.726537,103.608299,-330.118238,28.764324,65.571583,36.807259,,,,,,,169.973791,33.933406,-136.040385,0.491408,2.022178,1.53077,0.148918,1.153157,1.004239,586.209146,374.993601,-211.215545,2116.826757,377.365425,-1739.461332,10.298405,10.034506,-0.263899,14.447988,16.870668,2.42268,0.021105,0.585696,0.564591,368.765358,115.494367,-253.270991,211.982882,196.525863,-15.457019,18.927152,13.956573,-4.970579,342.343261,328.332435,-14.0108260000001,1626.409625,1152.621375,-473.78825,4.925139,48.18029,43.255151,48.358741,35.261689,-13.097052,292.074892,287.67113,-4.40376199999997,0.799671,0,-0.799671,23.178245,57.135527,33.957282,1203.179371,294.303013,-908.876358,0,0.036001,0.036001,551.835399,143.264074,-408.571325,273.917677,205.817543,-68.100134,0.379661,1.739348,1.359687,302.20312,203.954739,-98.248381,3890.462913,3126.569839,-763.893074000001,2251.603131,625.242676,-1626.360455,959.424771,1988.579273,1029.154502,1121.59134,1469.132137,347.540797000001,27.925965,33.643697,5.717732,0.039882,1.125649,1.085767,1.775147,6.284637,4.50949,2407.082536,1826.480915,-580.601621,6615.669059,2723.494953,-3892.174106,482.910558,160.996697,-321.913861,,,,133.639439,60.23038,-73.409059,122.57789,8.999576,-113.578314,181.652693,139.521885,-42.130808,26.451568,0.849355,-25.602213,885.728065,723.192021,-162.536044,29.704013,13.024988,-16.679025,6.698953,10.673069,3.974116,12.361523,29.07541,16.713887,168.230085,73.0332,-95.196885,,,,771.413253,228.03527,-543.377983,42.378043,2.207368,-40.170675,95.333789,27.983849,-67.34994,2.664797,5.825105,3.160308,0.268547,9.316334,9.047787,4.371288,16.176008,11.80472,65.174285,30.343583,-34.830702,0.706519,5.110321,4.403802,4.665022,3.045743,-1.619279,0.87213,3.62884,2.75671,6.625739,23.932524,17.306785,4.084447,3.386274,-0.698173000000001,634.698317,482.21859,-152.479727,204.24466,67.852863,-136.391797,0.030177,2.986342,2.956165,34.53144,15.201737,-19.329703,0.011325,0.264468,0.253143,0.005355,0.388335,0.38298,2181.100056,1037.332734,-1143.767322,,,,21.84562,20.911554,-0.934066000000001,39.563925,14.89146,-24.672465,1.040295,1.418296,0.378001,2.370877,0.899879,-1.470998,2.168139,12.157172,9.989033,,,,,,,,,,0.686235,0.826711,0.140476,51.061349,208.157687,157.096338,55.799522,30.210085,-25.589437,48.720911,10.461907,-38.259004,380.553217,311.466297,-69.0869200000001,1.862174,7.11074,5.248566,20.836685,13.799305,-7.03737999999999,5.825184,68.976554,63.15137,700.630317,84.996672,-615.633645,12.606438,8.085122,-4.521316,272.4,319.5,47.1,0.056334,0,-0.056334,0.049691,0,-0.049691,68.573637,41.896914,-26.676723,243.881126,121.78643,-122.094696,,,,1524.627476,441.799179,-1082.828297,32.121751,32.488817,0.367065999999987,63.465647,337.136731,273.671084,0.603626,9.760518,9.156892,62.095805,23.486529,-38.609276,36.46649,21.750326,-14.716164,0.300254,8.650101,8.349847,1234.759332,453.861234,-780.898098,216.557817,76.878394,-139.679423,11.569859,3.77045,-7.799409,142.374813,28.080628,-114.294185,105.90385,10.441315,-95.462535,0,0.222161,0.222161,1320.163746,523.799623,-796.364123,372.634451,60.584129,-312.050322,0.410941,1.022253,0.611312,86.988842,4.513954,-82.474888,2133.20956,920.437591,-1212.771969,1289.01032,1856.54708,567.53676,853.268202,223.39836,-629.869842,0,0.408493,0.408493,15.091692,4.808569,-10.283123,696.983189,629.632515,-67.350674,93.809012,5.767392,-88.04162,0.002077,0.043219,0.041142,7.075394,0.26789,-6.807504,15067.110923,2835.052068,-12232.058855,10.855505,1.324893,-9.530612,0,3.099329,3.099329,4039.596189,2415.214906,-1624.381283,616.384781,1263.421978,647.037197,2851.37538,1878.925824,-972.449556,9840.889267,4352.709391,-5488.179876,632.071754,1216.266389,584.194635,0.14402,0.030242,-0.113778,0.270544,0.132887,-0.137657,0.030568,0.411283,0.380715,0,0.001226,0.001226,1.75681,2.229856,0.473045999999999,275.087284,152.912192,-122.175092,0.095562,0.048163,-0.047399,0.307626,1.171435,0.863809,0.010685,0.075267,0.064582,0.320769,1.010762,0.689993,0.053311,0.009502,-0.043809,0.048472,0.522473,0.474001,0,0.120771,0.120771,0.583526,0.17232,-0.411206,0,0.001081,0.001081,1.976131,4.701716,2.725585,0,0.000365,0.000365,8.565174,7.707977,-0.857196999999999,0.82664,1.089256,0.262616,0.845702,1.493455,0.647753,0.025116,1.594818,1.569702,0.005999,0.031008,0.025009,11.716631,1.608085,-10.108546,0.27787,0.419789,0.141919,34.472278,47.302189,12.829911,604.048858,65.315472,-538.733386,19.96473,32.835357,12.870627,235.903127,40.953606,-194.949521,101.072303,315.725939,214.653636,0.029,11.690676,11.661676,,,,0,0,0,58.617646,18.406045,-40.211601,0.002655,1.679018,1.676363,38.482881,8.24188,-30.241001,0.120626,5.460411,5.339785,0.230451,2.057438,1.826987,7.070093,6.120256,-0.949836999999997,0.766454,5.780859,5.014405,54.225479,8.199772,-46.025707,5.577709,37.54666,31.968951,0.01152,1.647295,1.635775,0.125343,3.251467,3.126124,0.109767,1.294892,1.185125,1328.119292,103.638198,-1224.481094,0.501962,5.575321,5.073359,166.829295,7.816193,-159.013102,46.27165,1.294501,-44.977149,0.138906,0.428581,0.289675,0.039174,1.874513,1.835339,0.127633,3.93745,3.809817,525.012786,42.437026,-482.57576,52.381973,4.649775,-47.732198,0,0.041769,0.041769,0.330589,45.238216,44.907627,0,0.045914,0.045914,7.409863,4.581542,-2.828321,4.602121,6.524368,1.922247,0.02108,2.730686,2.709606,0.12426,1.10901,0.98475,0.01437,0.959071,0.944701,4.2,3.6,-0.6,0.014707,3.069931,3.055224,0.038166,1.264792,1.226626,3.255339,6.725703,3.470364,22.520458,162.182114,139.661656,0.53098,0.752387,0.221407,0.020722,0.019195,-0.001527,1.933892,5.958233,4.024341,19.706879,2.955754,-16.751125,0.836039,5.229959,4.39392,62.417673,1.294732,-61.122941,0,0,0,0.098519,0.01211,-0.086409,0.348159,0.352671,0.00451200000000002,0.059091,0.042572,-0.016519,530.533423,231.659849,-298.873574,14.74064,6.512146,-8.228494,6.334853,1.626511,-4.708342,1.898581,1.683931,-0.21465,9.51516,0.712368,-8.802792,9.042723,2.153542,-6.889181,1.854512,2.611086,0.756574,25.093431,0.341546,-24.751885,0,9.37941,9.37941,,,
2004-06-01,7513.658609,2013.1,-5500.558609,24142.118,13827.1,-10315.018,124355,66378.4,-57976.6,8284.637573,0,-8284.637573,12160.735761,5868.540408,-6292.195353,21103,17346,-3757,9274.164908,7051.715953,-2222.448955,8416.489411,5113.165674,-3303.323737,37100.782033,25604.722029,-11496.060004,27658.152312,15697.744788,-11960.407524,3746.119176,988.948013,-2757.171163,42482.409644,17344.171002,-25138.238642,127657,68403.103399,-59253.896601,49781.07807,19706.241144,-30074.836926,,,,952.837704,1287.60344,334.765736,3023.262743,695.29659,-2327.966153,0.950605,0.269425,-0.68118,23250.824636,16433.054553,-6817.770083,0.478486,0.501712,0.023226,13849.957397,9171.667476,-4678.289921,286.880886,184.762721,-102.118165,7.097608,9.790194,2.692586,187.305552,165.701325,-21.604227,334.385535,232.028541,-102.356994,85.742175,52.157758,-33.584417,314.573976,280.208358,-34.365618,24.567418,191.202852,166.635434,1.006737,33.59594,32.589203,60.884734,101.806742,40.922008,0.002562,40.667567,40.665005,34.710678,110.404855,75.694177,0.545444,8.782061,8.236617,0.925378,30.577852,29.652474,29.738428,63.994729,34.256301,389.934798,364.944173,-24.990625,0.008257,1.400158,1.391901,0.71662,7.590248,6.873628,4.145574,4.340186,0.194612000000001,0.191109,12.127154,11.936045,0.002988,0.293437,0.290449,0.147329,2.372299,2.22497,0.996304,7.891011,6.894707,0.273934,2.981854,2.70792,0.454248,4.05155,3.597302,2.873736,24.382713,21.508977,416.584057,82.108524,-334.475533,9.363196,46.933704,37.570508,,,,,,,185.613042,37.443402,-148.16964,0.075814,1.895714,1.8199,0.018899,3.389299,3.3704,631.862335,336.688942,-295.173393,2186.84288,392.796682,-1794.046198,13.097395,9.860141,-3.237254,9.723786,10.247292,0.523505999999999,0.02,216.57309,216.55309,265.802249,123.76641,-142.035839,248.391502,143.82989,-104.561612,33.65133,13.170016,-20.481314,325.063957,341.584683,16.520726,2008.499737,1072.303333,-936.196404,3.766345,48.270299,44.503954,55.093443,24.161656,-30.931787,254.904868,270.062319,15.1574510000001,0.002568,0.024,0.021432,18.715995,24.523773,5.80777800000001,1093.75239,221.163779,-872.588611,0,0.012421,0.012421,519.623305,115.246046,-404.377259,340.169208,183.369087,-156.800121,1.144977,1.087904,-0.0570729999999997,358.14756,135.910675,-222.236885,3959.645932,2886.904367,-1072.741565,2654.172546,572.592368,-2081.580178,1034.098523,1927.620491,893.521968,1072.246129,1389.284016,317.037887,34.107048,26.209824,-7.89722399999999,0.024098,1.180986,1.156888,2.329474,0.634082,-1.695392,2679.726773,1771.646989,-908.079784,6064.470385,2492.467359,-3572.003026,479.485333,169.837808,-309.647525,,,,150.230585,50.243241,-99.987344,129.479218,9.276662,-120.202556,182.589613,55.712298,-126.877315,18.80982,0.325168,-18.484652,968.142646,983.518366,15.37572,29.707085,13.040474,-16.666611,45.769529,10.126543,-35.642986,67.136074,17.773364,-49.36271,164.200645,75.207766,-88.992879,,,,1195.807841,237.293702,-958.514139,19.176256,1.542428,-17.633828,49.827047,39.063042,-10.764005,3.66821,8.395032,4.726822,0.164876,8.306245,8.141369,25.683016,11.418904,-14.264112,34.465244,28.642969,-5.82227499999999,0.935095,1.095977,0.160882,3.667264,3.702722,0.0354580000000002,1.021462,2.42722,1.405758,6.132468,4.743737,-1.388731,20.210366,2.874371,-17.335995,671.620915,524.81327,-146.807645,219.48786,61.18382,-158.30404,0.415409,11.526702,11.111293,33.792344,16.203368,-17.588976,0.166224,0.220695,0.054471,0.015505,0.358253,0.342748,2558.536113,869.722693,-1688.81342,,,,23.297904,8.440112,-14.857792,42.95644,20.977045,-21.979395,0.70068,1.326442,0.625762,7.305255,1.144414,-6.160841,2.495888,7.15679,4.660902,,,,,,,,,,0.504553,4.201542,3.696989,73.96063,318.437485,244.476855,62.58439,37.762162,-24.822228,49.311493,13.701956,-35.609537,479.687553,308.747176,-170.940377,2.62912,7.398657,4.769537,17.161726,12.715396,-4.44633,4.729583,41.160002,36.430419,685.027271,199.172114,-485.855157,10.469745,7.359704,-3.110041,280.9,318.5,37.6,0,0,0,0.036514,0,-0.036514,83.855836,56.020864,-27.834972,275.208052,137.744369,-137.463683,,,,1728.201701,442.089049,-1286.112652,16.094817,31.328776,15.233959,95.52113,384.436292,288.915162,0.376627,16.789781,16.413154,21.284985,25.226796,3.941811,25.501555,25.897555,0.396000000000001,1.166171,8.649656,7.483485,1142.57437,533.787894,-608.786476,255.237594,205.71081,-49.526784,12.415655,1.607575,-10.80808,201.989978,24.827626,-177.162352,150.374777,14.089957,-136.28482,0,2.181691,2.181691,1487.678057,501.71975,-985.958307,503.768877,59.014031,-444.754846,0.518747,1.21979,0.701043,132.771804,3.549322,-129.222482,2386.795436,810.92503,-1575.870406,1328.713245,1741.594449,412.881204,992.426532,217.74443,-774.682102,0,0.455745,0.455745,39.32257,3.003975,-36.318595,798.574627,562.365838,-236.208789,138.854635,10.516077,-128.338558,0.009396,0.06633,0.056934,9.296284,1.141982,-8.154302,16887.762591,2764.217124,-14123.545467,18.824984,5.967885,-12.857099,0,0,0,4090.051954,2116.776893,-1973.275061,780.15334,1331.429912,551.276572,3075.246369,1861.914699,-1213.33167,11037.978874,4660.372208,-6377.606666,606.367125,1100.770766,494.403641,0.151201,0.032274,-0.118927,0.068952,0.158746,0.089794,0.018883,0.032112,0.013229,0,0,0,2.540033,2.881856,0.341823,317.622313,159.657745,-157.964568,1.038352,0.014407,-1.023945,0.33748,1.562416,1.224936,0.137059,0.004245,-0.132814,0.425679,0.99125,0.565571,0.061932,0.298807,0.236875,0.265177,1.097219,0.832042,0,0.035838,0.035838,0.095618,0.119839,0.024221,0,0,0,1.467937,2.133949,0.666012,0,0.011472,0.011472,3.742003,7.723686,3.981683,2.381649,2.162558,-0.219090999999999,0.857941,2.065886,1.207945,0.006601,1.945629,1.939028,0.032464,0.129102,0.096638,14.851372,2.987685,-11.863687,0.294759,0.793884,0.499125,50.290747,23.860217,-26.43053,567.302594,72.953556,-494.349038,9.037488,15.445862,6.408374,278.358346,28.236442,-250.121904,96.200601,171.205909,75.005308,0.497,3.299209,2.802209,,,,0,0,0,59.879558,10.905698,-48.97386,0.4178,1.202873,0.785073,6.443112,8.395767,1.952655,0.201352,8.67182,8.470468,0.25899,3.448619,3.189629,5.083502,7.324882,2.24138,1.066548,3.506049,2.439501,79.901495,13.419128,-66.482367,12.022814,20.879213,8.856399,0,0.81239,0.81239,0.120126,1.565611,1.445485,0.060249,1.061821,1.001572,1525.058965,117.974987,-1407.083978,0.371111,8.618394,8.247283,289.250454,7.384074,-281.86638,26.065194,3.331401,-22.733793,0.008511,0.212201,0.20369,0.078112,1.611808,1.533696,0.094846,4.761206,4.66636,158.129205,36.476491,-121.652714,10.527399,3.71949,-6.807909,0.052475,0.421188,0.368713,0.294942,0.301986,0.00704399999999994,0.002451,0.042277,0.039826,7.377883,3.582447,-3.795436,25.614185,2.948656,-22.665529,0.019685,0.220939,0.201254,0.068444,1.235634,1.16719,0.171814,0.179818,0.00800400000000004,3.2,2.4,-0.8,0.017776,7.011049,6.993273,0.182119,1.537522,1.355403,1.729226,3.949885,2.220659,33.050302,15.31537,-17.734932,0.675254,0.285413,-0.389841,0,0.042144,0.042144,1.640173,4.468311,2.828138,20.261074,3.379186,-16.881888,0.309438,1.005299,0.695861,40.168897,3.3282,-36.840697,0,0,0,0.011538,0.096451,0.084913,0.005902,0.397117,0.391215,0.01059,0.003659,-0.006931,604.647698,255.38367,-349.264028,24.082821,4.85477,-19.228051,5.192218,1.987051,-3.205167,3.54234,1.19215,-2.35019,14.886898,0.570912,-14.315986,6.917333,1.815059,-5.102274,4.206544,1.207371,-2.999173,46.740315,0.418194,-46.322121,0,3.907174,3.907174,,,
2004-07-01,7590.014789,1825.1,-5764.914789,23571.972,12988.84,-10583.132,122979,67645.8,-55333.2,7389.041681,0,-7389.041681,9205.116188,4904,-4301.116188,19554,16023,-3531,9100.69884,6950.663893,-2150.034947,8522.663197,5090.710065,-3431.953132,31989.575411,22608.233181,-9381.34223000001,27217.214233,14577.117579,-12640.096654,3804.679308,1007.027705,-2797.651603,43131.914128,17186.133652,-25945.780476,123224,63878.854112,-59345.145888,50662.337816,19120.074814,-31542.263002,,,,1026.659167,1467.825085,441.165918,2858.515389,661.05435,-2197.461039,0.578818,0.312724,-0.266094,19776.520224,13863.820937,-5912.699287,0.251532,0,-0.251532,12213.055187,8744.412244,-3468.642943,299.623326,214.328757,-85.294569,8.931793,13.066398,4.134605,205.731836,144.261028,-61.470808,327.136358,247.647309,-79.489049,85.330614,42.415931,-42.914683,271.073269,289.32681,18.2535410000001,23.718844,150.583351,126.864507,1.606466,36.742713,35.136247,60.993288,108.598294,47.605006,0,31.306613,31.306613,28.828207,128.414855,99.586648,0.641076,16.424133,15.783057,1.500913,27.652651,26.151738,32.555231,53.323295,20.768064,423.459841,370.510471,-52.9493699999999,0.114503,2.513283,2.39878,1.280245,7.611418,6.331173,3.270757,4.858242,1.587485,0.13036,8.44422,8.31386,0.096856,0.295765,0.198909,0.184408,3.536485,3.352077,1.293604,7.214242,5.920638,0.139788,3.062514,2.922726,0.567353,4.49124,3.923887,2.628843,25.399557,22.770714,479.134178,101.83948,-377.294698,21.942549,54.910039,32.96749,,,,,,,81.631346,29.076745,-52.554601,0.148164,2.965275,2.817111,0.44264,2.238571,1.795931,588.464179,352.3572,-236.106979,2021.926214,404.445841,-1617.480373,10.761451,12.81552,2.054069,19.984597,13.718464,-6.266133,0,1.399915,1.399915,358.255394,144.941176,-213.314218,304.205217,186.599774,-117.605443,17.042112,17.512617,0.470504999999996,399.701012,266.131439,-133.569573,2023.555196,1160.335783,-863.219413,3.968934,43.028319,39.059385,62.691233,25.640504,-37.050729,347.971002,328.721613,-19.249389,0,0.002215,0.002215,20.955354,16.145641,-4.809713,1005.993387,225.336055,-780.657332,0,0.08711,0.08711,649.825894,117.376312,-532.449582,316.248373,185.71399,-130.534383,0.264662,0.552928,0.288266,325.306963,141.970501,-183.336462,3759.707155,2856.310974,-903.396181,2125.924716,590.253368,-1535.671348,1019.718338,1768.190984,748.472646,1002.716265,1402.431399,399.715134,19.657736,22.620533,2.962797,0.026568,0.376283,0.349715,1.420328,0.367391,-1.052937,2558.208312,1407.324005,-1150.884307,6705.07479,2420.516842,-4284.557948,481.635479,122.01759,-359.617889,,,,141.332405,58.490464,-82.841941,157.068629,12.713781,-144.354848,199.915925,52.94365,-146.972275,27.143758,0.586009,-26.557749,1054.603999,713.635847,-340.968152,33.006844,8.09132,-24.915524,44.273448,8.96924,-35.304208,30.012456,26.043179,-3.969277,176.00496,88.131261,-87.873699,,,,1040.095183,235.339071,-804.756112,32.168483,2.015681,-30.152802,87.123749,28.694826,-58.428923,3.597952,6.505407,2.907455,1.761719,16.172754,14.411035,1.40446,40.845147,39.440687,44.499998,15.793249,-28.706749,0.76675,4.267429,3.500679,4.152799,4.639402,0.486603000000001,0.338999,3.128159,2.78916,8.343532,39.949383,31.605851,10.994021,3.793826,-7.200195,584.912856,575.393572,-9.5192840000002,206.276142,81.098566,-125.177576,0.15022,5.716314,5.566094,33.016823,14.225104,-18.791719,0.308209,0.059219,-0.24899,0.000847,0.249515,0.248668,2547.042041,781.495951,-1765.54609,,,,24.02486,6.72805,-17.29681,47.214367,20.002248,-27.212119,0.906622,2.622582,1.71596,4.939164,1.972389,-2.966775,16.911622,9.816803,-7.094819,,,,,,,,,,0.480112,0.739485,0.259373,49.711105,111.779094,62.067989,90.883567,33.466987,-57.41658,52.328825,24.174399,-28.154426,464.819888,252.455807,-212.364081,1.992574,6.780503,4.787929,20.367418,6.599082,-13.768336,4.898623,43.711344,38.812721,646.934262,73.82688,-573.107382,11.695018,9.980141,-1.714877,336.5,306.6,-29.9,0,0,0,0.048111,0.0409,-0.007211,91.528685,37.646668,-53.882017,307.023661,104.537897,-202.485764,,,,1654.245304,424.029646,-1230.215658,30.158811,32.901304,2.742493,89.023416,324.094259,235.070843,0.675279,19.20029,18.525011,37.192851,25.620349,-11.572502,21.532006,25.121547,3.589541,0.896208,5.66835,4.772142,1401.809225,585.626571,-816.182654,289.674749,167.176813,-122.497936,10.085329,2.116588,-7.968741,233.718764,29.669802,-204.048962,170.615159,13.159622,-157.455537,0,0.489566,0.489566,1526.16988,486.559385,-1039.610495,482.099338,207.333104,-274.766234,0.464084,0.3907,-0.073384,145.767537,4.083424,-141.684113,2393.260306,854.987178,-1538.273128,1409.513099,1743.881517,334.368418000001,1074.880921,245.406345,-829.474576,0,0.615465,0.615465,17.095848,3.614549,-13.481299,783.618202,578.2101,-205.408102,160.60286,4.846505,-155.756355,0.015686,0.071748,0.056062,6.444004,1.534249,-4.909755,17562.099879,2618.793915,-14943.305964,28.0647,1.325594,-26.739106,0,0,0,3828.806788,2170.850091,-1657.956697,887.813148,1337.468824,449.655676,2974.565805,1698.463461,-1276.102344,11044.881727,4489.641845,-6555.239882,715.002309,1253.206471,538.204162,0.107335,0.015272,-0.092063,0.028435,4.398781,4.370346,0.004967,0.670814,0.665847,0,0,0,2.853534,17.528815,14.675281,276.919702,169.234036,-107.685666,0.202002,0.032903,-0.169099,0.164159,1.493137,1.328978,0.03755,0.002656,-0.034894,0.534552,0.840084,0.305532,0.116601,0.27146,0.154859,0.024855,1.037517,1.012662,0.003212,0.005883,0.002671,0.083597,0.153284,0.069687,0.01369,0,-0.01369,1.519489,4.399113,2.879624,0,0.103028,0.103028,7.514498,7.309083,-0.205414999999999,1.918129,1.160935,-0.757194000000001,0.992752,1.916823,0.924071,0.0025,1.550031,1.547531,0.003634,0.032201,0.028567,18.207232,1.104366,-17.102866,0.394688,1.393428,0.99874,47.870274,23.264838,-24.605436,731.014682,91.819654,-639.195028,27.713555,24.451347,-3.262208,391.266572,30.041693,-361.224879,100.839859,202.101647,101.261788,0,8.738725,8.738725,,,,0,0,0,93.756126,12.076279,-81.679847,0.0572,2.034655,1.977455,16.632212,4.302606,-12.329606,0.428725,5.659755,5.23103,0.122051,2.42539,2.303339,7.494821,2.721208,-4.773613,1.493737,3.680532,2.186795,34.869557,5.640447,-29.22911,9.302339,21.137617,11.835278,0.146559,8.956752,8.810193,0.177751,2.331876,2.154125,0.016307,1.714792,1.698485,1284.13283,110.575777,-1173.557053,1.087896,1.720523,0.632627,176.392359,6.674554,-169.717805,27.830796,1.460207,-26.370589,0.162931,0.324705,0.161774,0.01254,1.91909,1.90655,0.09792,2.559571,2.461651,417.228778,47.968797,-369.259981,46.160931,4.201762,-41.959169,26.131537,0.020633,-26.110904,0.134787,0.063764,-0.071023,0.002208,0.815948,0.81374,6.553678,4.171734,-2.381944,18.258569,7.265914,-10.992655,0.002375,0.267488,0.265113,0.004477,2.654008,2.649531,0.004978,1.501014,1.496036,3,4.6,1.6,0,2.072023,2.072023,0.042174,7.344153,7.301979,1.953098,4.079153,2.126055,35.255077,16.087515,-19.167562,0.51288,0.668418,0.155538,0.028743,0.308134,0.279391,1.595506,6.286623,4.691117,21.350506,3.688984,-17.661522,0.21659,6.905064,6.688474,30.922087,10.688555,-20.233532,0,0,0,0.61994,0.005406,-0.614534,0.150176,0.164482,0.014306,0.00728,0.017191,0.009911,497.633831,254.862518,-242.771313,16.492266,2.655078,-13.837188,7.50741,2.774085,-4.733325,3.769944,1.450562,-2.319382,19.612946,0.545537,-19.067409,1.547783,1.105524,-0.442259,2.428192,0.655181,-1.773011,43.302863,0.054316,-43.248547,0,7.552959,7.552959,,,
2004-08-01,9082.095277,1810.43,-7271.665277,22823.221,13467,-9356.221,124224,68131.7,-56092.3,7953.732341,0,-7953.732341,11651.029693,5350.6,-6300.429693,20136,15917,-4219,9179.973055,7199.083576,-1980.889479,8818.230476,5116.86391,-3701.366566,35297.024454,25563.184444,-9733.84001,26206.984779,15018.505656,-11188.479123,4343.266038,1092.707109,-3250.558929,43420.821148,17069.76602,-26351.055128,127216,67170.455835,-60045.544165,51588.865745,18957.603811,-32631.261934,,,,958.828595,1407.272764,448.444169,3284.74039,676.53552,-2608.20487,3.059857,0.271667,-2.78819,22018.283965,16069.491613,-5948.792352,0.098728,0.094095,-0.004633,13278.740489,9493.692831,-3785.047658,275.657549,213.22848,-62.429069,10.406914,11.258134,0.851219999999998,170.270824,146.884756,-23.386068,329.946267,254.696506,-75.249761,103.459465,54.818651,-48.640814,267.560235,266.393348,-1.16688699999997,25.561686,98.050697,72.489011,1.420315,33.783627,32.363312,59.624184,115.996008,56.371824,0,27.648283,27.648283,27.310092,128.970708,101.660616,0.527622,15.733342,15.20572,3.704236,27.889448,24.185212,35.515906,51.067803,15.551897,387.242572,363.703351,-23.5392209999999,0.012296,2.616463,2.604167,0.493691,6.198413,5.704722,3.591353,5.147344,1.555991,0.402617,6.016057,5.61344,0.031041,0.263729,0.232688,0.197431,2.818795,2.621364,1.71402,9.016489,7.302469,0.116026,3.824666,3.70864,0.385541,4.846208,4.460667,2.87804,22.159119,19.281079,552.510227,113.874978,-438.635249,35.149226,49.106051,13.956825,,,,,,,176.734561,18.550403,-158.184158,0.124058,2.513561,2.389503,0.071471,3.23762,3.166149,664.393074,351.036665,-313.356409,2322.53551,413.761197,-1908.774313,10.636793,10.262204,-0.374588999999997,10.447104,11.905957,1.458853,0,0.978033,0.978033,427.709866,121.090062,-306.619804,343.228307,179.222186,-164.006121,18.904964,17.851151,-1.053813,341.428509,336.803288,-4.62522100000001,1807.14181,1230.464995,-576.676815,5.292894,55.975036,50.682142,59.498862,26.082172,-33.41669,334.393317,301.115329,-33.2779880000001,0,0.002597,0.002597,16.985224,13.382533,-3.602691,709.150226,287.721288,-421.428938,0,0.001822,0.001822,648.810664,120.174082,-528.636582,290.729821,155.209774,-135.520047,0.357827,0.131682,-0.226145,308.003805,137.66845,-170.335355,3455.804808,2925.468952,-530.335855999999,2477.196682,556.621683,-1920.574999,1109.761575,2027.502791,917.741216,869.833062,1406.274888,536.441826,33.016618,24.572378,-8.44424000000001,0.089975,0.983218,0.893243,1.875572,0.603163,-1.272409,2470.816654,1470.98305,-999.833604000001,6487.760081,2618.350453,-3869.409628,496.591255,175.909375,-320.68188,,,,135.522222,60.654224,-74.867998,101.887163,7.454083,-94.43308,200.040788,50.563991,-149.476797,22.634745,1.01302,-21.621725,869.678432,764.915594,-104.762838,41.538588,7.873991,-33.664597,20.083212,10.452771,-9.630441,17.737666,22.598111,4.860445,155.151694,92.604175,-62.547519,,,,995.226766,233.347634,-761.879132,25.667792,2.859879,-22.807913,115.15374,43.142178,-72.011562,3.924352,6.117347,2.192995,8.070782,9.870586,1.799804,8.792526,11.248332,2.455806,41.09344,27.832292,-13.261148,0.417788,0.941905,0.524117,5.111065,0.985935,-4.12513,0.493667,6.951515,6.457848,7.770573,3.107825,-4.662748,1.347952,5.105116,3.757164,639.685314,481.717349,-157.967965,200.146851,79.895566,-120.251285,0.058539,15.517661,15.459122,29.998653,13.324395,-16.674258,0.124197,1.781209,1.657012,0.084544,0.341261,0.256717,2441.898575,734.120557,-1707.778018,,,,29.517188,16.307226,-13.209962,42.382199,13.913261,-28.468938,0.941141,1.635193,0.694052,5.016434,1.633575,-3.382859,4.020106,7.700164,3.680058,,,,,,,,,,1.044014,2.579232,1.535218,86.935572,98.183451,11.247879,97.229202,35.738056,-61.491146,51.562973,8.634676,-42.928297,420.662242,206.899358,-213.762884,1.548233,7.38338,5.835147,15.792377,18.007421,2.215044,4.968082,36.690471,31.722389,754.201614,49.599917,-704.601697,11.824442,7.075442,-4.749,257.7,252,-5.69999999999999,0,0,0,0.000273,0,-0.000273,76.091825,37.257371,-38.834454,244.640709,127.756819,-116.88389,,,,2302.807691,417.499391,-1885.3083,19.107301,41.5193,22.411999,165.935394,362.102922,196.167528,0.156337,34.104931,33.948594,79.157931,28.291853,-50.866078,46.685442,24.512729,-22.172713,0.93243,10.802908,9.870478,1349.646813,579.973319,-769.673494,252.396916,88.87622,-163.520696,9.399413,0.966224,-8.433189,243.635636,25.476497,-218.159139,190.070939,15.102573,-174.968366,0,2.846476,2.846476,1553.22279,543.176837,-1010.045953,587.801722,64.622526,-523.179196,0.13019,0.472669,0.342479,145.834485,4.292531,-141.541954,2585.914494,845.764439,-1740.150055,1372.651458,1913.361295,540.709837,948.976925,188.298648,-760.678277,0.027985,0.44198,0.413995,51.590984,2.862013,-48.728971,851.663343,558.89529,-292.768053,157.095562,7.359391,-149.736171,0.060379,0.013047,-0.047332,6.095143,1.036773,-5.05837,18067.867052,2620.970808,-15446.896244,29.344391,1.627001,-27.71739,0,0,0,3802.805902,2312.384949,-1490.420953,895.490006,1338.802028,443.312022,3109.025689,1634.535304,-1474.490385,10651.383046,4266.813069,-6384.569977,658.690627,1197.724861,539.034234,0.082239,0.026372,-0.055867,0.002938,0.042218,0.03928,0.139092,0.065113,-0.073979,0,0.005818,0.005818,8.929771,2.240863,-6.688908,258.736289,179.753062,-78.983227,0.378422,0.084208,-0.294214,0.450095,2.895488,2.445393,0.001021,0.066125,0.065104,0.615293,1.277548,0.662255,1.664435,0.43898,-1.225455,0.080001,1.218373,1.138372,0,0.013361,0.013361,0.082367,0.058894,-0.023473,0,0.028752,0.028752,1.58175,6.634493,5.052743,0,0.033002,0.033002,3.060176,6.97674,3.916564,1.231701,1.413676,0.181975,1.653463,1.985925,0.332462,0.01333,1.041696,1.028366,0.008491,0.023646,0.015155,20.826211,2.676528,-18.149683,0.565653,0.546147,-0.0195059999999999,51.615118,25.044792,-26.570326,785.169119,67.289023,-717.880096,24.819179,20.776837,-4.042342,366.309704,29.224336,-337.085368,143.91816,297.735197,153.817037,0,3.687381,3.687381,,,,0,0,0,107.760546,17.777638,-89.982908,0.002783,2.380156,2.377373,11.866943,8.497764,-3.369179,0.170925,8.120402,7.949477,1.180652,1.173839,-0.00681299999999996,4.950128,5.572375,0.622247000000001,0.934323,5.270498,4.336175,17.270312,12.26687,-5.003442,14.403796,18.871135,4.467339,0.007175,0.945477,0.938302,0.307817,1.380582,1.072765,0.507378,6.543691,6.036313,1571.232314,133.299351,-1437.932963,1.222238,0.58131,-0.640928,183.712907,3.589102,-180.123805,85.976224,4.156204,-81.82002,0.005952,2.658286,2.652334,0.005882,2.326985,2.321103,0.217983,3.370843,3.15286,425.10389,41.789797,-383.314093,129.140735,6.544793,-122.595942,0.247886,0.063658,-0.184228,0.113594,1.687864,1.57427,0.01542,0.061482,0.046062,6.442762,6.598654,0.155891999999996,0.567183,2.731143,2.16396,3,1.506056,-1.493944,0.373834,0.481619,0.107785,0.012,1.93476,1.92276,4.2,8,3.8,0.012552,2.774122,2.76157,0.07228,2.109192,2.036912,0.958981,7.004449,6.045468,31.468514,14.102786,-17.365728,0.288622,0.75793,0.469308,0.002668,0.2061,0.203432,1.105165,5.793742,4.688577,20.18667,4.110583,-16.076087,0.129661,16.882746,16.753085,34.593321,5.076592,-29.516729,0,0,0,0.001916,0.007082,0.005166,1.168025,0.233241,-0.934784,0,0.000284,0.000284,503.012155,281.905346,-221.106809,34.355277,3.435819,-30.919458,8.332542,5.719045,-2.613497,0.57997,4.173482,3.593512,19.339467,1.156908,-18.182559,5.184156,3.412421,-1.771735,3.9102,0.397018,-3.513182,48.847258,0.004075,-48.843183,0,13.952379,13.952379,,,
2004-09-01,8295.523465,1960.2,-6335.323465,21877.954,14077.2,-7800.754,124400,69592.3,-54807.7,8236.128536,0,-8236.128536,11394.56994,5986.8,-5407.76994,20398,17217,-3181,9741.96743,7229.697165,-2512.270265,8653.34534,4917.96608,-3735.37926,35208.932886,26249.654298,-8959.27858799999,24945.135924,15752.019083,-9193.11684099999,3836.09313,1118.033113,-2718.060017,44078.402853,17422.536527,-26655.866326,126022,69226.139285,-56795.860715,52530.353287,19791.112944,-32739.240343,,,,846.606536,1368.184974,521.578438,2923.973031,728.705551,-2195.26748,1.035668,0.460972,-0.574696,21688.073685,16633.099082,-5054.974603,0.063511,0.008384,-0.055127,13520.859201,9616.555216,-3904.303985,254.354429,186.414586,-67.939843,8.378973,13.068074,4.689101,186.24277,132.177485,-54.065285,289.035112,258.812213,-30.222899,90.325021,47.388896,-42.936125,268.359567,237.276313,-31.0832540000001,21.837152,125.255466,103.418314,0.921288,23.450496,22.529208,19.147973,84.811909,65.663936,0,10.602872,10.602872,25.45932,88.21096,62.75164,0.826391,10.856345,10.029954,0.288047,26.335123,26.047076,34.252334,59.993466,25.741132,405.831629,361.276763,-44.5548659999999,0.004259,1.988781,1.984522,1.094554,5.844267,4.749713,3.627915,4.667309,1.039394,1.226943,9.179163,7.95222,0.102661,0.75122,0.648559,0.265764,2.341308,2.075544,1.10485,7.202553,6.097703,0.230527,3.075905,2.845378,0.231222,5.049895,4.818673,2.395129,27.843496,25.448367,486.166005,112.125827,-374.040178,39.531922,51.003069,11.471147,,,,,,,172.951239,20.495546,-152.455693,0.012986,2.655019,2.642033,0.252883,1.947834,1.694951,649.498995,363.746876,-285.752119,1929.013642,409.385594,-1519.628048,9.442622,9.263546,-0.179076000000002,9.576393,14.090903,4.51451,0.00245,3.059878,3.057428,431.331363,138.96671,-292.364653,368.104808,175.348632,-192.756176,24.95058,19.511158,-5.439422,395.580369,324.365014,-71.215355,2126.325143,1130.662096,-995.663047,9.225385,65.228068,56.002683,46.363821,24.247147,-22.116674,337.995805,317.981531,-20.0142740000001,1.475099,0.006768,-1.468331,21.885279,13.55897,-8.32630900000001,948.652124,289.801622,-658.850502,0,0.007076,0.007076,348.185002,140.595758,-207.589244,307.630494,181.479036,-126.151458,0.651949,1.106962,0.455013,351.572598,140.208391,-211.364207,3496.060575,2903.90205,-592.158524999999,1864.34698,638.886407,-1225.460573,1029.583836,2078.832983,1049.249147,1024.996728,1334.677075,309.680347,24.472757,29.930826,5.458069,0.090047,0.967991,0.877944,0.498647,0.983907,0.48526,2645.583512,1730.881262,-914.70225,5994.41381,2779.713443,-3214.700367,479.640453,196.909744,-282.730709,,,,156.372384,58.960752,-97.411632,118.307055,9.240198,-109.066857,178.974507,54.432281,-124.542226,23.489458,0.95834,-22.531118,855.728851,728.035412,-127.693439,26.534043,10.490441,-16.043602,15.386468,7.038254,-8.348214,38.621497,23.681391,-14.940106,160.67302,76.322315,-84.350705,,,,1030.17329,321.70019,-708.4731,7.324459,2.751569,-4.57289,54.062577,35.142832,-18.919745,6.129624,12.093364,5.96374,2.571066,11.007376,8.43631,8.219901,15.208342,6.988441,77.645758,19.059342,-58.586416,0.405179,1.261436,0.856257,4.670469,1.487327,-3.183142,0.187811,1.693548,1.505737,9.71587,12.17318,2.45731,2.016515,28.63176,26.615245,532.442957,480.219168,-52.223789,205.852296,67.442547,-138.409749,0.037459,20.660756,20.623297,28.117846,19.551696,-8.56615,0.18396,0.396208,0.212248,0.018646,0.253242,0.234596,2166.832205,869.137939,-1297.694266,,,,20.940273,9.087019,-11.853254,38.942889,13.435023,-25.507866,1.058804,2.07021,1.011406,5.768075,1.25106,-4.517015,5.619907,7.990497,2.37059,,,,,,,,,,1.249667,1.325388,0.0757210000000001,42.240392,76.377435,34.137043,74.567857,32.318164,-42.249693,57.050181,15.730154,-41.320027,447.035493,235.334924,-211.700569,1.702424,5.6245,3.922076,21.662545,20.706863,-0.955682000000003,5.510636,37.394895,31.884259,799.450362,124.303729,-675.146633,13.562082,6.654249,-6.907833,279,245.9,-33.1,0.128765,0.015652,-0.113113,0.099068,0.0028,-0.096268,141.816395,34.598851,-107.217544,368.727276,114.177095,-254.550181,,,,2091.238378,424.839995,-1666.398383,34.112933,51.225199,17.112266,106.044842,418.109076,312.064234,39.784364,14.518831,-25.265533,22.913005,53.423602,30.510597,32.787248,21.694495,-11.092753,0.898466,29.823379,28.924913,1386.317221,584.545644,-801.771577,267.596614,76.749153,-190.847461,12.79251,1.805225,-10.987285,249.771175,22.762898,-227.008277,192.306817,12.499548,-179.807269,0,0.29301,0.29301,1505.89304,567.953335,-937.939705,496.779738,256.020904,-240.758834,0.389288,0.428591,0.039303,154.634391,4.326386,-150.308005,2612.049205,872.138546,-1739.910659,1378.064269,1686.90245,308.838181,1009.181857,207.886492,-801.295365,0.000279,0.467401,0.467122,43.983659,4.618813,-39.364846,800.019138,571.566794,-228.452344,157.097893,6.04347,-151.054423,0.021396,0.095427,0.074031,5.912957,1.986784,-3.926173,18386.945745,2823.070552,-15563.875193,42.867165,0.552187,-42.314978,0,6.882685,6.882685,4392.583165,2253.56208,-2139.021085,956.887774,1430.506278,473.618504,3014.432222,1858.726357,-1155.705865,10509.987807,4373.12855,-6136.859257,605.170437,1164.94339,559.772953,0.098277,0.019309,-0.078968,0.051309,0.069861,0.018552,0.05172,2.049837,1.998117,0,0.118666,0.118666,6.234727,2.540845,-3.693882,205.764955,166.90191,-38.8630450000001,0.212624,0.035262,-0.177362,0.472691,4.331445,3.858754,0,0.008412,0.008412,0.471914,1.594926,1.123012,0.182128,0.321484,0.139356,0.065187,1.167998,1.102811,0.840244,0.016006,-0.824238,0.066682,0.024775,-0.041907,0,0,0,1.50179,6.658144,5.156354,0,0.00154,0.00154,5.120927,8.48772,3.366793,1.040465,1.667035,0.62657,0.948426,2.308858,1.360432,0.011077,1.074084,1.063007,0.000251,0.06609,0.065839,18.52216,3.328988,-15.193172,0.58989,0.391963,-0.197927,37.438009,43.745361,6.307352,631.963023,67.012551,-564.950472,21.665239,10.885689,-10.77955,264.573596,47.118284,-217.455312,138.724284,260.846282,122.121998,0.733537,4.068074,3.334537,,,,0,0,0,102.186994,14.760854,-87.42614,0.209295,1.873582,1.664287,24.972407,5.023019,-19.949388,0.507473,8.931832,8.424359,0.547114,2.492766,1.945652,5.510916,6.356815,0.845899000000003,0.625762,2.300002,1.67424,91.151725,8.062872,-83.088853,17.443633,26.190822,8.747189,0.167671,1.210679,1.043008,0.158391,3.304503,3.146112,0.04854,4.862668,4.814128,1328.329772,130.580175,-1197.749597,0.213322,7.20616,6.992838,89.970371,5.921229,-84.049142,25.44971,1.770322,-23.679388,0.074344,0.239591,0.165247,0.00403,2.463174,2.459144,0.026147,3.689499,3.663352,479.743295,66.761745,-412.98155,97.623748,4.675258,-92.94849,0.000431,0.117053,0.116622,0.286957,1.126465,0.839508,0.001865,1.12938,1.127515,5.567425,4.974549,-0.592876000000002,1.411716,4.422858,3.011142,0.015234,0.933457,0.918223,0.439705,0.304466,-0.135239,0,0.455267,0.455267,4.3,16.8,12.5,0,10.809776,10.809776,0.112428,5.49924,5.386812,2.325918,4.454716,2.128798,23.371915,17.644104,-5.727811,0.8113,0.832614,0.0213139999999998,0.003132,0.193383,0.190251,2.583602,65.404121,62.820519,32.152123,1.587808,-30.564315,0.117086,1.94182,1.824734,35.942306,1.798967,-34.143339,0,0.015358,0.015358,0.122665,0.000117,-0.122548,0.245571,0.315444,0.069873,0,0.012107,0.012107,439.212872,254.323345,-184.889527,21.522683,5.059933,-16.46275,5.09844,6.219878,1.121438,6.404561,1.314599,-5.089962,20.678181,1.089178,-19.589003,8.285488,2.698925,-5.586563,3.320989,1.191888,-2.129101,44.899058,0.000055,-44.899003,0,28.699437,28.699437,,,
2004-10-01,9120.886694,2279.8,-6841.086694,24537.226,15171.8,-9365.426,128810,70167.6,-58642.4,9005.254222,0,-9005.254222,11733.153897,6103.6,-5629.553897,22047,17581,-4466,9504.177369,6965.352153,-2538.825216,9292.101022,5636.39662,-3655.704402,36885.944273,27045.724384,-9840.219889,28417.058423,17120.422139,-11296.636284,4372.700555,1493.628449,-2879.072106,46188.672498,18029.336678,-28159.33582,134816,73091.090662,-61724.909338,54927.556769,20251.177316,-34676.379453,,,,919.332627,1478.671116,559.338489,3443.025873,993.072796,-2449.953077,0.950943,0.303003,-0.64794,22410.858565,16969.405049,-5441.453516,0.033862,0.003865,-0.029997,14475.085708,10076.319335,-4398.766373,251.06641,236.207608,-14.858802,8.463946,11.846993,3.383047,173.150208,163.576586,-9.573622,304.693275,294.111593,-10.5816819999999,91.191442,45.319349,-45.872093,285.650121,257.550423,-28.099698,27.206497,219.5151,192.308603,2.449843,46.451928,44.002085,46.996686,105.583834,58.587148,0,20.01307,20.01307,31.043135,159.517737,128.474602,0.220852,13.056593,12.835741,2.392609,40.053342,37.660733,30.772502,60.825216,30.052714,407.269437,412.800458,5.53102100000007,0.233445,2.352127,2.118682,1.232372,5.264731,4.032359,3.33189,6.831509,3.499619,0.170276,8.321157,8.150881,0.024891,0.314561,0.28967,0.139864,3.615944,3.47608,1.121451,10.074468,8.953017,0.576748,4.368641,3.791893,0.173889,7.84193,7.668041,2.438353,32.955396,30.517043,447.64208,116.594913,-331.047167,38.714903,71.823532,33.108629,,,,,,,194.862455,49.127523,-145.734932,0.007003,3.179333,3.17233,0.034214,2.643255,2.609041,692.939229,413.696279,-279.24295,2519.062404,485.983223,-2033.079181,10.755873,16.44769,5.691817,7.8803,18.787308,10.907008,0,0.855635,0.855635,445.510879,169.337991,-276.172888,403.190863,190.056169,-213.134694,18.490955,14.986307,-3.504648,385.612947,331.072164,-54.540783,2013.699611,1181.246407,-832.453204,7.191937,66.711001,59.519064,58.924979,34.734902,-24.190077,375.565498,300.732456,-74.8330420000001,0.00475,0.010238,0.005488,20.243332,23.484669,3.24133700000001,1025.000156,315.554944,-709.445212,0,0.046433,0.046433,636.56173,135.510323,-501.051407,349.539425,182.581319,-166.958106,0.562025,0.674287,0.112262,319.591754,150.74937,-168.842384,4062.028557,3051.183986,-1010.844571,1858.498126,631.279346,-1227.21878,1256.133925,2243.937524,987.803599,1040.979532,1456.14125,415.161718,29.061825,40.101269,11.039444,0.187413,1.61582,1.428407,4.063552,0.505987,-3.557565,3151.835534,1998.199996,-1153.635538,7033.890877,2862.241139,-4171.649738,505.928841,218.658277,-287.270564,,,,167.476773,59.324228,-108.152545,70.992927,8.273421,-62.719506,182.629078,93.97689,-88.652188,22.901417,1.298739,-21.602678,1009.511925,813.306261,-196.205664,19.962428,6.775169,-13.187259,5.41316,10.587043,5.173883,45.377584,31.455497,-13.922087,154.657818,76.490856,-78.166962,,,,1226.155233,285.362068,-940.793165,32.746452,2.639859,-30.106593,105.354354,44.490555,-60.863799,5.103905,5.577408,0.473503,3.908493,17.710762,13.802269,1.468297,20.064029,18.595732,106.134172,21.662084,-84.472088,0.638881,2.500075,1.861194,3.320364,3.147224,-0.17314,0.691191,3.655514,2.964323,7.554027,123.65346,116.099433,7.582227,6.692283,-0.889944000000003,628.780665,572.163424,-56.617241,186.907883,68.163236,-118.744647,0.090484,5.757443,5.666959,27.167542,15.286735,-11.880807,0.228123,0.03341,-0.194713,0.007267,0.368061,0.360794,2291.492428,962.453373,-1329.039055,,,,28.938983,12.571929,-16.367054,37.108533,12.831849,-24.276684,1.12619,7.021103,5.894913,5.784182,3.475263,-2.308919,22.993064,9.166497,-13.826567,,,,,,,,,,0.644097,1.832957,1.18886,83.039725,94.067769,11.028044,102.766014,71.544967,-31.221047,42.314304,20.316816,-21.997488,480.250687,302.970212,-177.280475,3.730942,9.287731,5.556789,23.908262,17.099141,-6.809121,9.381911,38.777328,29.395417,833.296355,53.313075,-779.98328,15.427724,6.135056,-9.292668,331.1,360.3,29.2,0.007318,0,-0.007318,0.000563,0,-0.000563,119.748041,57.017727,-62.730314,272.948632,162.261986,-110.686646,,,,2327.397432,459.597547,-1867.799885,35.230765,47.284872,12.054107,139.197497,399.568994,260.371497,0.604048,20.376425,19.772377,32.041719,26.66952,-5.372199,57.381883,28.330221,-29.051662,0.299875,19.489777,19.189902,1552.112675,604.867486,-947.245189,273.843308,112.952316,-160.890992,10.296927,2.708718,-7.588209,235.844485,22.758134,-213.086351,192.242806,15.4454,-176.797406,0,1.648868,1.648868,1623.628302,571.711011,-1051.917291,470.660861,94.454464,-376.206397,0.20902,0.203571,-0.00544900000000004,137.517776,5.377259,-132.140517,2685.355758,898.075957,-1787.279801,1405.336314,1541.050232,135.713918,949.645898,254.400422,-695.245476,0,0.756516,0.756516,62.225311,2.201831,-60.02348,803.361376,565.621745,-237.739631,136.637696,5.709291,-130.928405,0.008655,0.178899,0.170244,9.601555,0.692464,-8.909091,19718.157481,2946.743822,-16771.413659,30.992876,4.489059,-26.503817,0,0,0,4095.815786,2090.468199,-2005.347587,962.999035,1402.641452,439.642417,3040.026234,1931.19227,-1108.833964,11439.798757,4939.746265,-6500.052492,666.92843,1268.175571,601.247141,0.14219,0.015003,-0.127187,0.00956,0.0608,0.05124,0.022771,0.425357,0.402586,0,0.006698,0.006698,6.13498,2.164766,-3.970214,216.249442,181.144855,-35.104587,0.122241,0.060362,-0.061879,0.492918,1.894146,1.401228,0.008542,0.000265,-0.008277,0.429368,1.07694,0.647572,0.107719,0.371241,0.263522,0.112079,1.182202,1.070123,0.006319,0.044055,0.037736,0.103183,0.027696,-0.075487,0,0,0,1.416367,3.23345,1.817083,0,0.133381,0.133381,4.598357,9.211362,4.613005,0.972157,1.784665,0.812508,0.621349,2.516417,1.895068,0.010887,2.369574,2.358687,0,0.01392,0.01392,20.210871,2.215971,-17.9949,0.54061,0.593154,0.0525439999999999,50.849388,31.27887,-19.570518,613.769934,122.004608,-491.765326,21.010269,18.353713,-2.65655600000001,240.749337,44.775278,-195.974059,141.671787,325.439048,183.767261,0.4,11.592294,11.192294,,,,0,0.022234,0.022234,129.040929,10.797227,-118.243702,0.000433,5.681174,5.680741,66.508499,4.235102,-62.273397,0.2661,7.893532,7.627432,0.32407,9.457789,9.133719,5.899757,3.479663,-2.420094,0.825298,4.039314,3.214016,15.405645,14.187276,-1.218369,23.837447,21.419499,-2.417948,0.007563,1.940366,1.932803,0.251034,4.66905,4.418016,0.069195,1.757161,1.687966,1595.458448,286.637826,-1308.820622,2.274866,1.270298,-1.004568,362.365405,3.388422,-358.976983,118.203723,12.254072,-105.949651,0.0293,0.034791,0.00549100000000001,0.1155,2.216833,2.101333,0.4035,6.966289,6.562789,221.279816,75.102287,-146.177529,174.871398,8.808597,-166.062801,0.04,0.068527,0.028527,0.409364,1.315849,0.906485,0,0.082778,0.082778,6.648112,5.525876,-1.122236,18.771222,11.965393,-6.805829,0.002259,1.885933,1.883674,1.625601,0.552667,-1.072934,0.158772,1.094528,0.935756,2.9,4.2,1.3,0.004696,4.103438,4.098742,0.06523,1.853446,1.788216,3.036442,3.465982,0.42954,34.197448,25.081171,-9.116277,0.719708,0.765191,0.0454829999999998,0.03488,0.615537,0.580657,2.762767,6.836134,4.073367,25.79344,2.080835,-23.712605,0.19233,5.652437,5.460107,35.176923,1.342899,-33.834024,0,0.000255,0.000255,0.026337,0,-0.026337,0.002316,0.160667,0.158351,0,0.011073,0.011073,475.156321,394.770093,-80.386228,34.096839,7.125487,-26.971352,5.518814,5.618446,0.0996319999999997,2.474902,2.6835,0.208598,14.305615,1.113957,-13.191658,11.124586,2.170195,-8.954391,2.903335,1.796507,-1.106828,45.87217,0.79273,-45.07944,0,64.76377,64.76377,,,
2004-11-01,9071.300774,2024.6,-7046.700774,25162.004,14301.2,-10860.804,131867,69283.5,-62583.5,8554.006943,0,-8554.006943,11851.320513,5854.1,-5997.220513,21973,16100,-5873,9430.373319,6270.578815,-3159.794504,8960.293976,5336.979083,-3623.314893,36784.346386,26652.679095,-10131.667291,29302.774083,16201.587263,-13101.18682,4411.894405,1004.130475,-3407.76393,45773.802429,16435.298489,-29338.50394,134719,69209.421299,-65509.578701,54343.083606,18579.476065,-35763.607541,,,,914.780959,1380.741447,465.960488,3498.325981,631.795749,-2866.530232,1.787863,0.27513,-1.512733,22875.484668,16675.502553,-6199.982115,0.082009,0.000323,-0.081686,13908.861718,9977.176542,-3931.685176,259.03031,255.898214,-3.13209599999993,9.746014,12.602941,2.856927,174.713229,146.794867,-27.918362,323.858902,269.355112,-54.50379,91.704933,50.367788,-41.337145,265.536853,242.635407,-22.9014460000001,22.251184,131.728102,109.476918,11.357263,31.408518,20.051255,79.127126,106.209081,27.081955,0,29.337974,29.337974,23.465439,140.859829,117.39439,1.361933,15.069049,13.707116,0.405697,53.175951,52.770254,34.884998,70.536796,35.651798,397.716124,367.792954,-29.9231699999999,0.07986,1.832732,1.752872,1.084235,5.321217,4.236982,3.851632,4.604763,0.753131,0.236765,12.463326,12.226561,0.027541,0.116188,0.088647,0.411277,2.836796,2.425519,0.967023,13.038367,12.071344,0.721115,3.174895,2.45378,0.177026,8.023916,7.84689,4.282296,44.613112,40.330816,556.908438,95.524739,-461.383699,58.6961,116.161826,57.465726,,,,,,,177.749473,45.938217,-131.811256,0.012792,2.959693,2.946901,0.147368,3.700404,3.553036,620.141426,396.840795,-223.300631,2274.941225,460.5563,-1814.384925,9.753756,12.044458,2.290702,16.008253,18.29264,2.284387,0.130394,0.259924,0.12953,383.348106,158.11937,-225.228736,405.883579,211.110873,-194.772706,25.666784,18.297119,-7.369665,411.404973,303.240257,-108.164716,1880.447989,1109.536097,-770.911892,7.218996,46.994769,39.775773,64.183188,26.719971,-37.463217,360.314325,290.85671,-69.457615,0.338036,0.027026,-0.31101,19.161133,24.04359,4.882457,1111.452909,264.089969,-847.36294,0.002272,0.246126,0.243854,643.181122,131.206543,-511.974579,326.785439,155.148608,-171.636831,0.398598,0.139814,-0.258784,377.527886,137.784702,-239.743184,4195.664242,3016.970224,-1178.694018,2341.26408,618.036552,-1723.227528,1155.713625,1924.830958,769.117333,1058.772709,1448.800636,390.027927,22.335709,24.809281,2.47357199999999,0.007569,0.76157,0.754001,1.779719,0.318687,-1.461032,2959.535201,1876.342894,-1083.192307,6958.679918,2572.927966,-4385.751952,581.153157,172.911033,-408.242124,,,,155.328535,69.426278,-85.902257,51.690302,6.601248,-45.089054,212.268003,97.997538,-114.270465,26.598181,1.166281,-25.4319,1068.19588,932.011556,-136.184324,62.000762,12.450146,-49.550616,18.666447,9.91394,-8.752507,55.479464,25.929874,-29.54959,159.900747,83.607506,-76.293241,,,,1601.876217,280.070322,-1321.805895,44.425306,2.800574,-41.624732,52.043887,44.333248,-7.710639,4.886323,3.991688,-0.894635,4.52588,28.777638,24.251758,1.425328,8.193036,6.767708,27.027392,28.4693,1.44190800000001,0.388892,0.265656,-0.123236,2.363264,2.631282,0.268018,0.321182,2.198467,1.877285,9.297045,0.905522,-8.391523,13.95591,5.763475,-8.192435,622.810876,603.322689,-19.488187,201.035585,99.737432,-101.298153,0.126561,34.101996,33.975435,27.834915,17.523778,-10.311137,0.025883,0.355686,0.329803,0.000355,0.730245,0.72989,2379.82622,962.155412,-1417.670808,,,,21.732474,9.961988,-11.770486,45.292756,18.302092,-26.990664,1.190535,0.737024,-0.453511,10.467386,2.269228,-8.198158,23.584586,8.935362,-14.649224,,,,,,,,,,1.388488,1.116871,-0.271617,79.417538,74.757545,-4.659993,85.086745,41.264455,-43.82229,48.887906,13.096303,-35.791603,426.418162,289.509764,-136.908398,1.566877,6.835665,5.268788,63.554903,14.286811,-49.268092,6.698854,46.249032,39.550178,771.846994,65.256237,-706.590757,9.720359,4.659364,-5.060995,319.9,311.8,-8.09999999999997,0.012758,0.00435,-0.008408,0.07366,0,-0.07366,118.83814,63.129824,-55.708316,502.935511,134.453375,-368.482136,,,,2226.179871,472.686845,-1753.493026,22.01707,46.706395,24.689325,79.470782,398.881031,319.410249,16.53011,20.478584,3.948474,48.624758,29.930269,-18.694489,42.145741,27.435613,-14.710128,0.964346,15.216432,14.252086,1240.475541,558.294784,-682.180757,242.673209,106.711997,-135.961212,10.572969,1.452956,-9.120013,185.97942,22.545359,-163.434061,159.178793,13.682916,-145.495877,0,0.768579,0.768579,1670.730398,568.092867,-1102.637531,424.434513,68.942498,-355.492015,0.061474,0.655087,0.593613,131.772276,7.941625,-123.830651,2391.045782,878.825825,-1512.219957,1218.539175,1308.799766,90.2605910000002,891.668194,222.745672,-668.922522,0,2.588687,2.588687,21.852197,1.651859,-20.200338,724.374153,552.676773,-171.69738,128.443134,6.700564,-121.74257,0,0.005994,0.005994,7.747597,0.71604,-7.031557,19678.992143,2938.175371,-16740.816772,15.183254,1.591423,-13.591831,0,3.135373,3.135373,4316.950348,2025.143929,-2291.806419,828.502271,1300.195547,471.693276,3066.381525,1636.439573,-1429.941952,11636.169881,4206.93096,-7429.238921,664.792661,1188.757522,523.964861,0.337441,0.016316,-0.321125,0.025451,0.012762,-0.012689,0.055124,0.097682,0.042558,0.012,0,-0.012,6.602943,3.369668,-3.233275,199.488022,164.88546,-34.602562,0.600778,0.074404,-0.526374,0.472558,0.918432,0.445874,0,0.03828,0.03828,0.447129,1.006933,0.559804,0.133235,0.240246,0.107011,0.067972,1.262286,1.194314,0.0485,0.042236,-0.006264,0.06243,0.113521,0.051091,0,0.01,0.01,1.574448,1.982111,0.407663,0.00288,0.007549,0.004669,14.780029,9.635587,-5.14444200000001,0.824892,1.490527,0.665635,0.583712,2.382363,1.798651,0.00982,1.61066,1.60084,0,0.190294,0.190294,23.343961,2.144212,-21.199749,0.479846,0.505145,0.025299,38.28108,33.142981,-5.13809900000001,665.204499,102.417021,-562.787478,16.737553,18.028912,1.291359,334.872591,62.341884,-272.530707,142.415114,214.352192,71.937078,1.2,6.493563,5.293563,,,,0,0.000369,0.000369,116.697925,11.526072,-105.171853,0.211052,1.575943,1.364891,5.688978,9.607273,3.918295,0.173497,6.933065,6.759568,0.111234,4.230375,4.119141,5.425692,5.018355,-0.407337000000001,0.875191,2.311954,1.436763,68.90347,12.706543,-56.196927,12.719989,31.404524,18.684535,0.022391,2.088817,2.066426,12.436687,4.636079,-7.800608,0.389773,1.160455,0.770682,1570.322229,113.60676,-1456.715469,0.837578,0.535985,-0.301593,236.713639,5.894604,-230.819035,86.116197,3.614154,-82.502043,1.464242,0.25784,-1.206402,0.119534,2.226554,2.10702,0.240931,5.553635,5.312704,515.909392,33.064693,-482.844699,101.674424,7.781091,-93.893333,0.042067,0.074779,0.032712,0.725717,0.439091,-0.286626,0.010345,0.223569,0.213224,8.1945,4.997173,-3.197327,9.256861,8.605708,-0.651153000000003,0,0.572856,0.572856,0.679141,1.283272,0.604131,0.060016,1.784248,1.724232,1.8,6.2,4.4,0,1.226924,1.226924,0.002617,1.516743,1.514126,1.44403,4.439322,2.995292,29.037006,20.543866,-8.49314,1.082942,0.610563,-0.472379,0.00831,1.350955,1.342645,1.784809,5.840471,4.055662,19.175916,1.964894,-17.211022,6.445717,6.635151,0.189433999999997,37.58202,1.143512,-36.438508,0,0,0,0.070794,0.009087,-0.061707,0.05289,0.150987,0.098097,0,0.00018,0.00018,529.113248,260.738748,-268.3745,27.948561,14.425517,-13.523044,7.636327,4.503679,-3.132648,2.745657,1.171044,-1.574613,22.261034,0.937308,-21.323726,3.10668,3.143103,0.0364230000000001,9.411421,2.470644,-6.940777,41.084942,0.089144,-40.995798,0,53.552418,53.552418,,,
2004-12-01,8202.087849,2349.9,-5852.187849,25447.207,15153.1,-10294.107,130310,71511.4,-58798.6,7993.472507,0,-7993.472507,10699.742894,5576.3,-5123.442894,21049,17785,-3264,8568.708123,7479.89709,-1088.811033,9133.65116,5464.504094,-3669.147066,33351.186102,25179.337857,-8171.848245,28990.148824,17214.053959,-11776.094865,4327.78071,1113.179305,-3214.601405,42319.623994,18252.165969,-24067.458025,126617,71110.7793759999,-55506.2206240001,49735.967037,20709.868919,-29026.098118,,,,1078.151381,1408.193297,330.041916,3461.314208,678.3114,-2783.002808,0.215661,0.191574,-0.0240870000000001,20825.549106,15955.629723,-4869.91938299999,0.000264,0.009167,0.008903,12525.636996,9223.708134,-3301.928862,279.8095,269.618501,-10.190999,13.646342,18.543895,4.89755299999999,175.622604,140.397377,-35.225227,322.0453,259.769767,-62.275533,84.602045,57.329014,-27.273031,254.115522,225.542488,-28.5730340000001,28.61761,149.22679,120.60918,2.290905,25.721481,23.430576,54.602006,125.86078,71.258774,0,32.3863,32.3863,28.272151,135.596231,107.32408,0.838563,14.190511,13.351948,1.369983,56.571082,55.201099,35.397244,56.263415,20.866171,382.389764,377.167326,-5.22243800000007,0.089327,2.091472,2.002145,1.461954,6.745683,5.283729,3.06696,6.745411,3.678451,0.691386,20.178447,19.487061,0.000436,0.353274,0.352838,0.290355,2.058491,1.768136,1.040637,10.847527,9.80689,0.403385,4.493144,4.089759,1.095322,10.98835,9.893028,3.083142,35.754324,32.671182,655.617659,102.607533,-553.010126,35.026967,90.532078,55.505111,,,,,,,135.000707,36.490082,-98.510625,0.580938,5.164542,4.583604,0.109924,2.334853,2.224929,671.4984,457.456739,-214.041661,2064.690872,464.31548,-1600.375392,9.932056,15.135449,5.203393,9.939578,17.579699,7.64012100000001,0.025415,0.809131,0.783716,395.696669,182.015998,-213.680671,432.166261,194.783843,-237.382418,23.678912,17.205203,-6.473709,567.386558,362.330871,-205.055687,2005.116366,1115.014229,-890.102137,4.854344,54.371187,49.516843,49.049905,28.461608,-20.588297,396.196685,273.403595,-122.79309,2.240501,0.050893,-2.189608,33.233636,22.362527,-10.871109,1114.86172,271.153253,-843.708467,0.004628,0.503271,0.498643,580.242341,140.020575,-440.221766,317.905198,156.077305,-161.827893,0.783885,0.046236,-0.737649,329.525705,159.778708,-169.746997,4355.126615,3029.902938,-1325.223677,2066.379355,731.485286,-1334.894069,1092.394415,2300.602678,1208.208263,1165.437355,1505.949824,340.512469,22.312292,63.336907,41.024615,0.076332,0.888704,0.812372,1.372507,0.255481,-1.117026,3039.922141,1917.641057,-1122.281084,6992.006274,2737.854404,-4254.15187,588.491722,128.034776,-460.456946,,,,171.865757,93.25262,-78.613137,40.33576,12.88682,-27.44894,212.522149,57.022535,-155.499614,24.771738,1.408507,-23.363231,1048.84988,881.532502,-167.317378,20.904523,10.476597,-10.427926,9.286091,10.912144,1.626053,42.668601,31.434795,-11.233806,161.963576,82.75155,-79.212026,,,,1140.849596,278.383262,-862.466334,17.557744,2.912753,-14.644991,63.80337,34.100052,-29.703318,2.873827,6.930372,4.056545,9.895845,10.525297,0.629452000000001,7.097087,27.938995,20.841908,49.357103,52.374192,3.017089,3.240257,2.205436,-1.034821,3.657227,7.331838,3.674611,0.311754,3.957613,3.645859,4.619422,1.863373,-2.756049,3.152752,106.089957,102.937205,690.315403,566.102999,-124.212404,200.087854,153.694918,-46.392936,0.064591,27.365615,27.301024,26.486099,15.771528,-10.714571,0.048414,0.478379,0.429965,0.011344,0.087694,0.07635,2656.167117,973.037764,-1683.129353,,,,35.890984,15.640499,-20.250485,51.705639,15.473798,-36.231841,1.158474,1.131575,-0.026899,8.654608,3.955399,-4.699209,5.224765,9.369252,4.144487,,,,,,,,,,1.197926,1.130682,-0.0672439999999999,76.806354,117.995715,41.189361,65.160029,68.079125,2.91909600000002,30.696891,21.358699,-9.33819199999999,399.08259,330.734778,-68.3478119999999,1.729562,10.4604,8.730838,18.312139,10.620572,-7.691567,5.403824,28.825263,23.421439,804.775865,67.369149,-737.406716,14.881623,5.540653,-9.34097,293.7,370.5,76.8,0.053465,0,-0.053465,0.063709,0,-0.063709,99.302806,56.480472,-42.822334,256.530355,164.239446,-92.290909,,,,1859.919385,603.088588,-1256.830797,81.698193,53.67309,-28.025103,101.355149,459.740317,358.385168,0.793918,32.044263,31.250345,15.471709,28.290872,12.819163,28.911145,29.512101,0.600956000000011,1.225403,13.081581,11.856178,1240.206191,570.692616,-669.513575,207.285375,108.855806,-98.429569,9.404303,0.867018,-8.537285,159.51947,36.547129,-122.972341,176.210068,16.305,-159.905068,0,0.635623,0.635623,1617.387088,582.446349,-1034.940739,427.2154,74.170281,-353.045119,0.149858,0.252569,0.102711,130.254723,4.577488,-125.677235,2485.009981,994.828497,-1490.181484,1157.867398,1414.72696,256.859562,753.182581,252.539815,-500.642766,0,0.712951,0.712951,20.250178,5.762521,-14.487657,698.808307,442.178173,-256.630134,119.785197,7.812212,-111.972985,0.002752,0.238129,0.235377,4.401478,0.383511,-4.017967,17412.030829,3234.802826,-14177.228003,17.18602,1.014687,-16.171333,1.417988,2.754089,1.336101,3757.249217,2420.660055,-1336.589162,700.480179,1439.53454,739.054361,2953.111329,2204.975535,-748.135794,11211.984567,4448.432157,-6763.55241,793.806312,1218.983998,425.177686,0.0089,0.076203,0.067303,0,0.026378,0.026378,0.017564,0.117955,0.100391,0,0,0,5.607182,3.570789,-2.036393,250.450737,163.357891,-87.092846,0.240045,0.071888,-0.168157,0.772428,1.10835,0.335922,0,0.143565,0.143565,0.568169,1.063781,0.495612,0.087002,0.22398,0.136978,0.098031,0.749816,0.651785,0.035909,0.006374,-0.029535,0.050178,0.181097,0.130919,0,0.004541,0.004541,1.18458,1.886315,0.701735,0.019589,0,-0.019589,3.964164,8.243594,4.27943,0.993834,1.885016,0.891182,0.413213,1.884845,1.471632,0,1.334372,1.334372,0.007209,0.042854,0.035645,19.029199,2.441191,-16.588008,0.353245,0.581957,0.228712,38.160449,43.909018,5.74856900000001,695.330985,144.089574,-551.241411,17.375073,17.015734,-0.359339000000006,422.017011,87.078095,-334.938916,107.883777,219.296904,111.413127,0.854412,12.170843,11.316431,,,,0,0,0,114.757546,12.0278,-102.729746,0.157208,3.017688,2.86048,24.626469,8.57902,-16.047449,0.212687,7.578993,7.366306,0.096497,3.150145,3.053648,6.035181,5.874473,-0.160708000000003,0.278604,2.257162,1.978558,75.701073,10.072784,-65.628289,17.315771,23.574562,6.258791,0.014828,0.99415,0.979322,0.190673,5.054551,4.863878,0.023457,1.496837,1.47338,1405.243849,125.683731,-1279.560118,1.659537,3.248327,1.58879,281.584641,4.572203,-277.012438,76.446474,2.001745,-74.444729,0.045524,0.020981,-0.024543,0.028024,0.659806,0.631782,0.050386,1.988948,1.938562,514.307241,45.641603,-468.665638,127.739615,7.753453,-119.986162,0.000301,0.095124,0.094823,0.52407,0.068128,-0.455942,0.002461,0.650683,0.648222,9.54391,4.959179,-4.584731,10.051345,3.312169,-6.739176,0.025355,0.360781,0.335426,1.163955,1.158034,-0.00592100000000029,0.139151,0.465169,0.326018,1,4.5,3.5,0.20105,4.165099,3.964049,0.016586,2.750177,2.733591,1.631736,12.079687,10.447951,34.917293,20.37129,-14.546003,0.403049,7.438947,7.035898,0.003552,0.133253,0.129701,2.418456,5.985666,3.56721,20.201665,1.572686,-18.628979,0.749904,4.389348,3.639444,37.578038,3.622983,-33.955055,0,0,0,0.154196,0.041336,-0.11286,0.009479,0.166844,0.157365,0,0.611831,0.611831,598.213059,277.232262,-320.980797,9.518559,10.727651,1.209092,5.646744,6.536,0.889256,5.386976,4.329434,-1.057542,19.257775,2.428524,-16.829251,8.122105,3.397644,-4.724461,9.218218,2.494979,-6.723239,36.78482,1.948127,-34.836693,0,21.441204,21.441204,,,
2005-01-01,8149.278487,1991.8,-6157.478487,21997.6,13982.1,-8015.5,132065,71669,-60396,7228.094795,0,-7228.094795,10500.796108,5223.1,-5277.696108,18953,15536,-3417,9074.297044,6646.953433,-2427.343611,9201.908356,5171.979963,-4029.928393,33913.372772,24785.482267,-9127.89050500001,25344.956317,15821.894483,-9523.061834,4167.790844,1176.198835,-2991.592009,41914.030384,16002.201589,-25911.828795,122900,66149.062869,-56750.937131,49459.113299,17855.888663,-31603.224636,1177.693003,1263.196467,85.5034639999999,812.108943,1336.742837,524.633894,3410.613155,735.764124,-2674.849031,0.415288,0.253375,-0.161913,21839.495234,15568.411786,-6271.083448,0.047388,0.622446,0.575058,12073.877538,9217.070481,-2856.807057,244.009334,194.938125,-49.071209,5.172393,12.739605,7.567212,133.892204,151.278554,17.38635,246.823508,253.711108,6.88759999999999,89.291456,46.662458,-42.628998,228.242767,278.065957,49.82319,20.329772,129.479184,109.149412,2.351757,22.038064,19.686307,51.985918,103.933116,51.947198,0,28.028926,28.028926,27.416627,107.927238,80.510611,0.502601,12.490077,11.987476,0.919886,53.529118,52.609232,21.040946,45.521939,24.480993,235.433734,338.540265,103.106531,0.045504,2.471855,2.426351,15.8699,6.28426,-9.58564,3.509925,5.543264,2.033339,0.454007,24.634214,24.180207,0.014777,0.276207,0.26143,0.294196,3.78991,3.495714,0.905983,9.375491,8.469508,0.219694,3.091339,2.871645,0.36468,5.334395,4.969715,2.300468,28.621567,26.321099,544.7239,87.211248,-457.512652,48.955045,87.063005,38.10796,,,,,,,156.802755,36.961987,-119.840768,0.034983,3.215706,3.180723,0.011312,1.383681,1.372369,630.758695,416.766183,-213.992512,2518.095071,513.295917,-2004.799154,8.814085,11.045807,2.231722,6.201474,21.132773,14.931299,0,1.11437,1.11437,432.379516,123.632652,-308.746864,331.846994,212.611171,-119.235823,16.435689,16.195954,-0.239734999999996,670.291963,315.875282,-354.416681,2038.070725,1051.242258,-986.828467,5.407696,91.326667,85.918971,54.057532,22.57137,-31.486162,406.956389,290.957199,-115.99919,0.672495,0.070497,-0.601998,18.921593,28.07037,9.148777,914.362171,315.489059,-598.873112,0,0.548036,0.548036,434.820252,116.599141,-318.221111,289.757268,133.811115,-155.946153,0.784391,0.067019,-0.717372,344.806481,145.233897,-199.572584,3544.776694,2807.117599,-737.659095,1985.331728,676.703116,-1308.628612,1036.069965,2098.240507,1062.170542,983.260669,1454.417659,471.15699,23.410262,81.611987,58.201725,0.037919,0.711776,0.673857,1.147503,0.975251,-0.172252,2562.059966,1764.374878,-797.685088,5955.928052,2507.254191,-3448.673861,423.305375,144.058136,-279.247239,,,,136.921175,73.595286,-63.325889,33.68527,11.3282,-22.35707,198.365734,56.038742,-142.326992,20.216941,0.571231,-19.64571,983.198554,915.251503,-67.947051,20.273309,17.900591,-2.37271800000001,23.873138,10.543767,-13.329371,44.822896,30.246864,-14.576032,162.942659,87.082978,-75.859681,,,,1119.995679,235.861602,-884.134077,39.441049,2.264175,-37.176874,62.31103,39.991498,-22.319532,1.483484,3.032986,1.549502,0.595867,10.779753,10.183886,0.697086,16.858793,16.161707,58.61664,29.400294,-29.216346,0.83262,0.650344,-0.182276,3.145469,3.331254,0.185785,29.031635,3.264011,-25.767624,3.738832,11.597771,7.858939,10.091056,3.927366,-6.16369,626.924401,467.349133,-159.575268,196.826486,91.389805,-105.436681,1.208258,5.595867,4.387609,25.578303,10.378822,-15.199481,0.015819,0.306196,0.290377,0.010569,13.296802,13.286233,2352.74301,895.640517,-1457.102493,,,,25.887972,10.780023,-15.107949,32.898462,13.911707,-18.986755,1.915009,1.613231,-0.301778,4.50533,1.203019,-3.302311,5.318041,7.814976,2.496935,,,,,,,,,,0.701665,1.763154,1.061489,76.39169,81.669545,5.277855,61.019554,31.144643,-29.874911,32.671419,11.648548,-21.022871,424.948122,330.870583,-94.0775389999999,2.331795,6.715166,4.383371,20.113729,13.541882,-6.571847,6.112767,44.371832,38.259065,549.216289,68.346115,-480.870174,14.827878,5.613789,-9.214089,293.6,274.8,-18.8,0.001006,0,-0.001006,0.040387,0.004314,-0.036073,116.302421,35.312822,-80.989599,227.767171,120.085761,-107.68141,,,,1652.104659,414.374337,-1237.730322,36.212548,58.738127,22.525579,89.1428,376.884623,287.741823,32.346174,16.39174,-15.954434,47.479281,14.540673,-32.938608,47.822748,24.238863,-23.583885,1.652865,12.359544,10.706679,1389.008956,514.003206,-875.00575,207.655876,79.34265,-128.313226,9.793236,0.683796,-9.10944,194.94369,21.190854,-173.752836,198.411687,22.376643,-176.035044,0.02,0.221903,0.201903,1451.442432,572.825039,-878.617393,538.690987,64.103867,-474.58712,0.029535,0.388143,0.358608,138.679828,5.544719,-133.135109,2327.474906,684.51819,-1642.956716,1236.746918,1558.833327,322.086409,895.641891,249.37709,-646.264801,0,0.466786,0.466786,18.70046,3.220481,-15.479979,657.219252,506.165022,-151.05423,110.505941,6.76635,-103.739591,0.366182,1.999911,1.633729,3.688678,0.530999,-3.157679,17885.84061,2609.326126,-15276.514484,13.972908,0.724643,-13.248265,0.003252,1.737572,1.73432,4123.952751,2214.729533,-1909.223218,754.384554,1124.499924,370.11537,2959.212821,1748.890649,-1210.322172,10154.378114,3984.167985,-6170.210129,542.449418,1133.211166,590.761748,0.006767,0.062368,0.055601,0.016486,0.001462,-0.015024,0.015497,0.052811,0.037314,0.0025,0,-0.0025,3.924154,2.484138,-1.440016,243.598594,176.011608,-67.586986,0.081873,0.011873,-0.07,0.704664,6.995577,6.290913,0,0.018135,0.018135,0.340391,0.637005,0.296614,0.083285,0.025993,-0.057292,0.129417,0.550163,0.420746,0.025227,0.004098,-0.021129,0.042787,0.465528,0.422741,0.00595,0,-0.00595,2.123086,1.846261,-0.276825,0,0,0,4.610775,6.497659,1.886884,1.166896,2.528025,1.361129,0.348813,1.912822,1.564009,0.107197,1.230447,1.12325,0,0.097597,0.097597,11.983555,1.637296,-10.346259,0.264962,0.424624,0.159662,39.754653,50.200129,10.445476,528.855075,88.425288,-440.429787,9.481491,11.608811,2.12732,387.299312,39.633541,-347.665771,152.036988,286.29853,134.261542,0.72,10.619503,9.899503,,,,0,0,0,83.772917,14.663022,-69.109895,0.133106,5.445547,5.312441,35.597697,11.631001,-23.966696,0.270407,5.569308,5.298901,0.146212,3.799849,3.653637,5.534651,7.033781,1.49913,0.392107,3.105289,2.713182,112.708913,11.360585,-101.348328,8.584642,17.540849,8.956207,0.0026,1.714191,1.711591,0.979568,3.872122,2.892554,0.030556,1.869043,1.838487,1624.88205,93.323248,-1531.558802,0.281735,1.017573,0.735838,257.289674,3.71134,-253.578334,66.477512,6.018512,-60.459,0.101013,0.418218,0.317205,0.012182,3.167321,3.155139,0.04981,4.296907,4.247097,449.996467,49.260277,-400.73619,95.577733,15.628368,-79.949365,0,0.048362,0.048362,0.300471,1.044885,0.744414,0,7.609333,7.609333,7.610093,5.522989,-2.087104,7.376694,4.98816,-2.388534,0.127468,1.121258,0.99379,0.485452,0.407582,-0.0778700000000001,0.000336,0.902749,0.902413,2.2,4.5,2.3,0.128883,0.687369,0.558486,0.065758,1.636933,1.571175,1.439963,2.867333,1.42737,38.120057,11.464205,-26.655852,0.208345,0.57525,0.366905,0.004047,0.030348,0.026301,3.030768,3.390176,0.359408,22.511726,1.773024,-20.738702,0.466516,3.983752,3.517236,31.102869,1.411127,-29.691742,0,0,0,0.066244,0.000684,-0.06556,1.145459,0.047311,-1.098148,0,0.055406,0.055406,437.225764,377.006985,-60.218779,13.892468,8.517502,-5.374966,8.730757,6.139251,-2.591506,5.518887,1.890224,-3.628663,27.143312,1.051128,-26.092184,8.393445,4.154872,-4.238573,7.985505,2.761872,-5.223633,43.152772,0.170495,-42.982277,0,0,0,,,
2005-02-01,8063.796404,2008.3,-6055.496404,23647.06,14893,-8754.06,134921,72184.8,-62736.2,7805.393809,0,-7805.393809,11058.334913,5689.3,-5369.034913,18102,15152,-2950,7646.243641,6538.400768,-1107.842873,8582.963674,5186.46498,-3396.498694,34109.634134,25102.393328,-9007.24080600001,27105.925206,16735.74032,-10370.184886,4245.944884,1175.021004,-3070.92388,40033.761657,16688.472203,-23345.289454,122233,68256.311141,-53976.688859,47514.819445,18669.649491,-28845.169954,1429.437109,1242.748149,-186.68896,673.683521,1386.726329,713.042808,3265.03823,764.615178,-2500.423052,0.457472,0.238001,-0.219471,21502.547911,16092.264634,-5410.28327700001,0.017444,0.057374,0.03993,12607.086223,9010.128694,-3596.957529,262.631289,204.060621,-58.570668,14.463137,13.374189,-1.088948,155.508478,155.527075,0.0185969999999713,302.884417,249.306054,-53.578363,91.79053,37.121263,-54.669267,250.417736,270.846123,20.4283870000001,21.580562,169.5135,147.932938,0.799324,27.065788,26.266464,70.617075,127.958559,57.341484,0,21.514087,21.514087,22.192126,106.479858,84.287732,0.123385,17.300655,17.17727,0.704555,52.447937,51.743382,30.617258,57.709488,27.09223,366.204659,325.887013,-40.3176459999999,0.177802,2.832476,2.654674,1.549721,6.691566,5.141845,3.921806,4.694078,0.772271999999999,0.150278,21.149518,20.99924,0.006953,0.276829,0.269876,0.179466,3.703293,3.523827,1.23898,9.527668,8.288688,0.120507,2.948595,2.828088,0.424793,7.658401,7.233608,2.891506,28.046663,25.155157,481.246733,85.289919,-395.956814,54.41781,82.927814,28.510004,,,,,,,192.248304,27.747339,-164.500965,0.333044,2.641147,2.308103,0.045854,3.167537,3.121683,584.623068,415.590684,-169.032384,2154.531316,472.920764,-1681.610552,7.716602,12.892851,5.176249,11.117023,28.485561,17.368538,0.027333,0.49317,0.465837,459.515039,119.187661,-340.327378,396.835784,169.626879,-227.208905,19.912578,13.017702,-6.894876,544.718939,365.909282,-178.809657,1707.488922,1109.304117,-598.184805,2.529553,64.959058,62.429505,51.94482,21.453461,-30.491359,310.621228,267.196064,-43.4251640000001,1.893381,0.012673,-1.880708,18.170246,34.20312,16.032874,1151.371831,363.196616,-788.175215,0,0.452601,0.452601,354.506947,156.184771,-198.322176,325.085907,178.055268,-147.030639,0.613388,0.085538,-0.52785,345.688311,138.32736,-207.360951,3704.894708,3099.748746,-605.145961999999,2777.150306,772.837678,-2004.312628,962.360601,2108.812488,1146.451887,963.972986,1438.141485,474.168499,24.255014,23.30067,-0.954344000000003,0.105187,0.438593,0.333406,1.30187,0.486942,-0.814928,2585.976081,1924.842365,-661.133716,6378.311515,2702.261454,-3676.050061,416.659051,163.877559,-252.781492,,,,158.083191,73.203358,-84.879833,40.960954,9.33624,-31.624714,183.21143,68.529295,-114.682135,21.217291,0.355302,-20.861989,1055.089497,730.685203,-324.404294,9.813694,9.634389,-0.179304999999999,20.047001,12.4207,-7.626301,86.047786,27.6668,-58.380986,138.341874,88.778687,-49.563187,,,,1176.634704,300.418708,-876.215996,22.99404,2.361541,-20.632499,72.952711,52.426276,-20.526435,2.290465,6.920324,4.629859,0.705842,12.654761,11.948919,0.60849,9.935887,9.327397,179.548576,43.016118,-136.532458,0.912093,0.481845,-0.430248,3.885938,4.326521,0.440582999999999,0.394383,2.20704,1.812657,4.377489,16.674719,12.29723,2.718251,14.821362,12.103111,788.399035,520.685028,-267.714007,198.588857,94.015432,-104.573425,0.201083,0.379247,0.178164,23.903899,10.853544,-13.050355,0.173992,0.674263,0.500271,0.004555,0.460496,0.455941,2261.522616,951.255159,-1310.267457,,,,28.066249,11.956355,-16.109894,35.462082,15.329349,-20.132733,0.973034,1.504902,0.531868,6.20914,1.003864,-5.205276,5.06182,16.21097,11.14915,,,,,,,,,,0.556263,0.804338,0.248075,64.066126,88.776721,24.710595,53.514584,52.296,-1.218584,34.373673,26.157745,-8.215928,410.703646,342.126268,-68.577378,2.884903,9.142309,6.257406,37.499555,15.937088,-21.562467,6.757216,31.123934,24.366718,534.668107,65.012342,-469.655765,12.650675,4.997288,-7.653387,288.8,337.7,48.9,0,0,0,0.08406,0.0482,-0.03586,80.998535,34.012902,-46.985633,182.743765,122.366894,-60.376871,,,,1854.131913,418.702748,-1435.429165,30.844235,33.308627,2.46439199999999,84.69552,403.37308,318.67756,4.622855,8.012404,3.389549,112.305823,26.404182,-85.901641,31.534008,27.266861,-4.267147,0.878621,12.534713,11.656092,1341.926662,581.173513,-760.753149,241.993447,74.784118,-167.209329,8.265749,0.654361,-7.611388,193.952819,28.083592,-165.869227,176.498607,20.714819,-155.783788,0.03,0.335588,0.305588,1332.903152,607.623588,-725.279564,523.52548,72.578723,-450.946757,0.375067,0.928867,0.5538,128.494334,5.33188,-123.162454,2100.581904,772.936891,-1327.645013,1135.964449,1563.698144,427.733695,913.214496,310.777841,-602.436655,0,0.695486,0.695486,29.280921,3.436014,-25.844907,682.617005,513.581601,-169.035404,78.950863,7.416954,-71.533909,0.003647,0.459896,0.456249,1.049297,0.484971,-0.564326,16937.594812,3058.089091,-13879.505721,9.228775,0.705441,-8.523334,0,0.068855,0.068855,3410.606552,2242.501447,-1168.105105,551.252045,1221.41858,670.166535,2548.420595,1510.782597,-1037.637998,10993.373053,4132.788408,-6860.584645,416.986736,1170.728718,753.741982,0,0.029942,0.029942,0.377804,0.097765,-0.280039,0.072324,0.108502,0.036178,0,0.15918,0.15918,4.388289,2.547028,-1.841261,230.529937,177.768889,-52.761048,0.194403,0.188685,-0.00571800000000008,0.194114,13.607628,13.413514,0,0.137602,0.137602,0.484075,0.872665,0.38859,0.157288,0.027692,-0.129596,0.106071,0.714401,0.60833,0.006197,0.067439,0.061242,0.040439,0.223712,0.183273,0,0,0,1.569403,1.611778,0.0423749999999996,0,0,0,3.505538,7.675154,4.169616,3.093979,4.108004,1.014025,0.750452,2.072975,1.322523,0.009192,1.079736,1.070544,0.007276,0.072446,0.06517,10.927776,1.152674,-9.775102,0.288027,1.78434,1.496313,34.907313,91.680645,56.773332,689.529957,66.653275,-622.876682,11.786956,15.070433,3.283477,261.308673,75.736939,-185.571734,127.233069,230.842188,103.609119,0,8.520606,8.520606,,,,0,0,0,136.363121,21.7531,-114.610021,0.091913,6.071903,5.97999,20.434277,7.052542,-13.381735,0.107933,5.835516,5.727583,0.074138,1.903306,1.829168,5.267552,3.995747,-1.271805,0.509903,1.578009,1.068106,102.914062,6.654037,-96.260025,5.13039,24.018113,18.887723,0.019118,1.383934,1.364816,0.194337,2.570377,2.37604,0.025656,1.788883,1.763227,1530.417649,104.530897,-1425.886752,0.714654,0.321365,-0.393289,197.580378,14.011718,-183.56866,104.185909,3.632457,-100.553452,0.795805,0.026746,-0.769059,0.15181,0.509014,0.357204,0.042971,4.656238,4.613267,413.818211,159.952157,-253.866054,108.091954,5.435468,-102.656486,0,0.115015,0.115015,0.002516,1.905963,1.903447,0.077273,0.179343,0.10207,6.437589,5.117318,-1.320271,34.53744,3.356779,-31.180661,0.07582,1.426938,1.351118,0.888208,0.667296,-0.220912,0.0009,0.785377,0.784477,2.7,3.4,0.7,0.034087,7.453301,7.419214,0.140394,1.762613,1.622219,1.226644,5.504294,4.27765,21.660361,26.146282,4.48592099999999,0.274065,0.359105,0.08504,0.000599,0.067375,0.066776,2.700461,12.164459,9.463998,20.388323,1.506103,-18.88222,0.535777,5.266822,4.731045,20.250269,1.83474,-18.415529,0,0,0,0.097391,0.005817,-0.091574,0.402938,0.425786,0.022848,0,0.010643,0.010643,434.0661,263.676803,-170.389297,5.902691,9.620503,3.717812,7.920705,6.052691,-1.868014,4.088536,1.290665,-2.797871,17.64616,1.335677,-16.310483,13.414727,5.285033,-8.129694,7.023852,2.587396,-4.436456,37.060466,0.113895,-36.946571,0,0.020314,0.020314,,,
2005-03-01,9767.021242,2902.2,-6864.821242,26257.64,16834.2,-9423.44,130902,72793.3,-58108.7,8832.804497,0,-8832.804497,12077.94644,6820.2,-5257.74644,21093,19487,-1606,8216.11773,7904.728911,-311.388819,10119.560433,6027.530008,-4092.030425,38123.935346,28834.240452,-9289.694894,30408.099653,19371.039947,-11037.059706,4811.493946,1352.448768,-3459.045178,42521.416019,19403.426073,-23117.989946,135451,79512.577826,-55938.422174,51036.965596,22341.011912,-28695.953684,1711.583729,1414.276203,-297.307526000001,949.982848,1584.620006,634.637158,3970.846215,891.404106,-3079.442109,0.497238,1.683368,1.18613,24009.54836,18919.819143,-5089.729217,0,0.003365,0.003365,14114.386986,9914.421309,-4199.965677,312.310121,245.039242,-67.270879,14.275173,19.905512,5.630339,186.947614,157.950138,-28.9974759999999,341.99941,269.082893,-72.916517,110.113726,50.629323,-59.484403,333.833935,270.555925,-63.27801,28.66885,172.22613,143.55728,0.943252,41.702141,40.758889,55.150174,176.690178,121.540004,0,42.264057,42.264057,42.029411,170.791983,128.762572,1.089014,17.7885,16.699486,1.2631,92.743559,91.480459,46.080994,49.121085,3.04009100000001,426.378923,421.018682,-5.3602410000002,0.010742,3.110693,3.099951,1.283092,8.986145,7.703053,4.321635,6.118778,1.797143,0.61801,21.337698,20.719688,0.11973,0.329582,0.209852,0.404127,3.649409,3.245282,1.242923,10.238988,8.996065,0.095829,6.683472,6.587643,0.557417,6.583897,6.02648,3.039087,31.52445,28.485363,587.324167,104.272003,-483.052164,48.082092,117.719948,69.637856,,,,,,,217.509321,31.413674,-186.095647,0.122804,2.963326,2.840522,0.152264,2.668334,2.51607,710.344421,485.500341,-224.84408,2851.616849,480.839376,-2370.777473,9.673877,23.297948,13.624071,16.768015,20.524709,3.75669400000001,0.0021,1.026669,1.024569,458.532652,178.566949,-279.965703,396.351978,174.313769,-222.038209,23.084661,13.789984,-9.29467699999999,521.053861,446.193656,-74.8602049999998,1947.89213,1221.971075,-725.921055,3.621355,62.364643,58.743288,78.695291,29.42218,-49.273111,335.861666,334.53884,-1.32282600000008,0.09464,0.070124,-0.024516,37.679313,40.453169,2.773856,1316.840061,360.149913,-956.690148,0,0.670794,0.670794,748.570151,190.4745,-558.095651,458.485268,177.60449,-280.880778,0.768495,0.124633,-0.643862,410.557724,183.373322,-227.184402,4333.220001,3470.462147,-862.757853999999,2381.744395,815.823643,-1565.920752,1161.519015,2384.403674,1222.884659,1043.124912,1665.163257,622.038344999999,34.664031,28.940598,-5.72343300000001,0.04268,0.521443,0.478763,1.446147,0.380493,-1.065654,2834.06766,2026.260514,-807.807146,7382.464311,3126.927919,-4255.536392,519.252382,240.555041,-278.697341,,,,180.756834,106.770622,-73.986212,56.760018,8.722792,-48.037226,207.451546,120.291843,-87.1597030000001,26.572664,0.580631,-25.992033,1117.693072,1177.627823,59.9347509999996,25.838628,10.812931,-15.025697,23.985278,12.900779,-11.084499,30.480431,30.274199,-0.206231999999993,165.311275,98.747475,-66.5638,,,,1382.059895,363.52007,-1018.539825,67.92144,2.522866,-65.398574,107.176029,44.17836,-62.997669,3.456857,5.033442,1.576585,0.71977,8.926866,8.207096,21.619281,15.183753,-6.435528,16.627922,54.372346,37.744424,0.104085,4.093663,3.989578,3.141648,2.388214,-0.753434000000001,0.118219,1.458719,1.3405,4.049161,25.206422,21.157261,18.213822,3.690937,-14.522885,670.239432,584.38631,-85.853122,215.110824,84.27712,-130.833704,0.151495,56.427791,56.276296,25.98019,12.331954,-13.648236,0.364676,0.265247,-0.0994289999999999,0.019472,0.576377,0.556905,2658.844177,1091.292321,-1567.551856,,,,28.9716,16.293059,-12.678541,42.173735,26.14165,-16.032085,1.322206,1.03067,-0.291536,3.357201,3.174051,-0.183150000000001,3.957452,10.110438,6.152986,,,,,,,,,,0.529423,1.147615,0.618192,75.815979,160.509162,84.693183,99.277021,44.716592,-54.560429,44.882951,13.326289,-31.556662,409.644456,448.343225,38.698769,2.952942,7.095773,4.142831,23.650751,9.987321,-13.66343,5.962354,32.226406,26.264052,707.008947,103.298503,-603.710444,12.388267,6.730505,-5.657762,334.5,335.4,0.899999999999977,0,0,0,0.051894,0.022284,-0.02961,116.397447,50.499798,-65.897649,300.226296,218.805351,-81.420945,,,,2032.717498,571.84143,-1460.876068,39.016365,58.271305,19.25494,90.020187,892.882806,802.862619,54.354934,23.893593,-30.461341,14.160916,84.631943,70.471027,33.71119,29.13144,-4.57974999999999,0.419512,19.239059,18.819547,1605.805682,701.057216,-904.748466,269.015117,100.52522,-168.489897,11.077147,5.486879,-5.590268,218.38139,31.211837,-187.169553,201.091043,15.853162,-185.237881,0,1.026952,1.026952,1641.954746,637.827022,-1004.127724,440.328962,69.529847,-370.799115,0.267735,0.699157,0.431422,130.139955,4.996839,-125.143116,2454.520505,836.892851,-1617.627654,1163.796302,2017.178938,853.382636,1050.03622,324.155007,-725.881213,0,0.996357,0.996357,54.825967,4.074445,-50.751522,791.424016,540.485283,-250.938733,63.848593,6.500828,-57.347765,0.033679,0.072887,0.039208,0.084781,0.447085,0.362304,16184.944952,3336.381178,-12848.563774,8.197274,1.708769,-6.488505,0,0,0,3695.901365,2371.725822,-1324.175543,572.704948,1523.306135,950.601187,2783.715115,1992.518016,-791.197099,12779.195886,4890.670849,-7888.525037,591.138137,1357.991018,766.852881,0.012535,0.077158,0.064623,0.002279,0.264632,0.262353,0.088296,0.128811,0.040515,0,0.00901,0.00901,1.498094,4.373978,2.875884,333.865919,197.171725,-136.694194,0.143381,0.113689,-0.029692,0.235631,6.196129,5.960498,0,0.001313,0.001313,0.5722,1.020061,0.447861,0.109246,0.05326,-0.055986,0.066451,0.609538,0.543087,0.007886,0.025889,0.018003,0.098193,0.008649,-0.089544,0,0,0,1.63606,2.508134,0.872074,0,0,0,4.726452,7.870679,3.144227,1.936692,1.031764,-0.904928,0.039074,2.179192,2.140118,0.01027,0.954417,0.944147,0.024348,0.159578,0.13523,13.341975,1.032346,-12.309629,0.437615,0.778567,0.340952,28.31612,71.704791,43.388671,609.907364,118.010011,-491.897353,10.143226,14.932511,4.789285,308.150632,34.047957,-274.102675,118.577431,250.114784,131.537353,0.436916,12.840487,12.403571,,,,0,0.01215,0.01215,159.512057,21.2324,-138.279657,0.089134,9.263498,9.174364,6.051107,7.715347,1.66424,0.107721,9.7225,9.614779,0.329438,1.859722,1.530284,4.271524,11.29779,7.026266,0.445509,2.912332,2.466823,117.27261,16.07973,-101.19288,18.383445,21.842179,3.45873400000001,0.009252,1.38688,1.377628,0.16868,22.119854,21.951174,0.063696,2.108724,2.045028,1773.715417,121.821093,-1651.894324,0.81814,0.309058,-0.509082,270.998277,6.02186,-264.976417,70.269961,1.783836,-68.486125,0.20702,0.055951,-0.151069,0.049343,1.23451,1.185167,0,7.81154,7.81154,818.384437,142.385196,-675.999241,35.122692,4.428155,-30.694537,0.046409,0.091693,0.045284,0.366231,0.767773,0.401542,0.018938,0.558028,0.53909,10.193948,6.364001,-3.829947,71.045478,2.23794,-68.807538,0.002879,0.697844,0.694965,0.65834,1.193695,0.535355,0.079961,0.812311,0.73235,3,31.9,28.9,0.000645,2.427857,2.427212,0.165132,1.655764,1.490632,2.058215,5.646061,3.587846,33.211008,21.102765,-12.108243,0.185039,0.657845,0.472806,0,0.068946,0.068946,3.777676,4.79319,1.015514,14.775436,1.669258,-13.106178,0.519308,3.863494,3.344186,18.657222,3.15319,-15.504032,0,0,0,0.073501,0.000097,-0.073404,0.009607,0.622272,0.612665,0,0,0,449.172324,353.787898,-95.3844260000001,8.333602,12.403372,4.06977,12.877868,15.934199,3.056331,0.782535,2.607927,1.825392,13.56182,1.135308,-12.426512,8.194356,2.271866,-5.92249,13.467586,2.058637,-11.408949,27.03183,0.030406,-27.001424,0,0,0,,,
2005-04-01,10163.163153,2716.1,-7447.063153,25706.28,16300.5,-9405.78,137129,75490.2,-61638.8,8966.896558,0,-8966.896558,11344.88703,6577.5,-4767.38703,20890,18579,-2311,8035.076669,7146.92011,-888.156559,9943.834308,6149.964082,-3793.870226,37739.648445,27945.243149,-9794.405296,30178.122714,18245.813451,-11932.309263,5378.718424,1279.982249,-4098.736175,43343.037189,18020.124966,-25322.912223,135456,75914.3571349999,-59541.6428650001,51302.640156,20742.961979,-30559.678177,1457.160724,1343.659348,-113.501376,913.054578,1531.995364,618.940786,4296.931254,911.062723,-3385.868531,0.2693,0.320634,0.051334,23457.967483,18105.235381,-5352.732102,0.149893,0.000311,-0.149582,14281.680962,9840.007768,-4441.673194,281.322059,200.859061,-80.4629980000001,11.719805,20.808375,9.08857,158.149969,142.502489,-15.64748,277.191315,256.776754,-20.414561,81.016443,55.563788,-25.452655,277.432673,295.289597,17.856924,25.247571,194.91269,169.665119,2.801815,50.913098,48.111283,55.778902,144.782457,89.003555,0,37.478444,37.478444,32.353823,159.156596,126.802773,0.615179,17.541722,16.926543,1.062547,50.498316,49.435769,40.162101,71.298225,31.136124,382.048265,392.667659,10.6193940000001,0.034959,2.655658,2.620699,1.253396,6.745407,5.492011,4.026968,8.868221,4.841253,0.289309,22.633296,22.343987,0.024862,0.385998,0.361136,0.165055,5.988501,5.823446,1.336556,8.452314,7.115758,0.13519,3.139526,3.004336,0.676028,6.376408,5.70038,3.353998,33.026163,29.672165,685.417844,118.031942,-567.385902,37.781187,131.044236,93.263049,,,,,,,182.205041,37.191337,-145.013704,0.028558,3.553292,3.524734,0.019405,1.339699,1.320294,714.79257,470.055049,-244.737521,2654.889378,495.25544,-2159.633938,11.045102,16.923678,5.878576,12.316676,17.90013,5.58345400000001,0.030125,4.994939,4.964814,501.92491,158.348506,-343.576404,343.199278,199.388268,-143.81101,19.956913,23.034721,3.077808,622.753544,525.390568,-97.3629759999998,2043.647451,1218.038487,-825.608964,3.329725,110.925044,107.595319,51.16607,39.803893,-11.362177,421.131461,389.414216,-31.717245,0.000282,0.009874,0.009592,21.18136,39.124241,17.942881,1345.915322,327.879252,-1018.03607,0,0.576043,0.576043,545.061666,155.316161,-389.745505,443.569479,184.163179,-259.4063,0.629348,0.44661,-0.182738,360.40773,166.667037,-193.740693,4323.053956,3493.361395,-829.692561,2287.682433,742.946466,-1544.735967,1192.659298,2296.810814,1104.151516,1073.221945,1671.97257,598.750625,33.091702,39.556582,6.46488,0.038512,2.995139,2.956627,2.262178,0.591247,-1.670931,2936.024537,2047.131451,-888.893086,6941.298248,2790.130059,-4151.168189,508.418509,244.492383,-263.926126,,,,184.593291,128.927856,-55.6654349999999,73.919662,11.287891,-62.631771,179.25679,122.875122,-56.381668,27.751878,0.811235,-26.940643,1214.640226,722.423427,-492.216799,40.124945,21.869602,-18.255343,11.687195,11.815629,0.128434,48.961603,28.069429,-20.892174,159.741927,101.477295,-58.264632,,,,1754.682538,338.266965,-1416.415573,14.229645,2.696202,-11.533443,116.99166,41.112952,-75.878708,2.545883,8.377959,5.832076,0.187319,7.442244,7.254925,30.309175,13.194867,-17.114308,82.307591,63.07116,-19.236431,0.414878,1.515288,1.10041,3.870285,2.924118,-0.946167000000001,55.04961,5.803417,-49.246193,12.80934,6.939063,-5.870277,12.726421,8.172913,-4.553508,742.099655,592.705555,-149.3941,166.081999,74.891807,-91.1901920000001,0.136467,60.234416,60.097949,22.538197,28.380609,5.842412,0.04294,0.757059,0.714119,0.000468,0.386471,0.386003,2515.343754,1042.13063,-1473.213124,,,,21.141858,19.685196,-1.456662,38.370235,20.372411,-17.997824,1.533442,0.81211,-0.721332,1.806219,12.649999,10.84378,4.480302,8.812118,4.331816,,,,,,,,,,0.805946,1.830286,1.02434,75.531438,105.81071,30.279272,89.355786,54.258525,-35.097261,31.576853,16.841421,-14.735432,423.269065,347.244876,-76.0241890000001,2.690005,4.773989,2.083984,28.663067,10.082175,-18.580892,7.336672,32.383025,25.046353,743.179842,111.707224,-631.472618,12.122071,5.327998,-6.794073,284.6,324.2,39.6,0.179986,0,-0.179986,0.078724,0.240321,0.161597,85.186683,49.635118,-35.551565,284.649222,158.352681,-126.296541,,,,2171.82982,543.58368,-1628.24614,30.169468,72.642707,42.473239,84.252575,839.060302,754.807727,0.620268,23.310188,22.68992,9.540895,36.362939,26.822044,20.492031,36.228751,15.73672,1.69369,17.745517,16.051827,1396.405685,619.576793,-776.828892,231.721244,98.56982,-133.151424,10.453393,2.246639,-8.206754,186.673271,29.237951,-157.43532,142.432915,16.067449,-126.365466,0.0115,0.370584,0.359084,1577.582747,566.169786,-1011.412961,411.995028,83.643923,-328.351105,0.10928,1.236455,1.127175,114.030134,5.174209,-108.855925,2714.924969,800.447276,-1914.477693,1268.902387,1610.301621,341.399234,957.083124,292.045176,-665.037948,0,1.038431,1.038431,77.288934,3.649311,-73.639623,662.04952,520.27598,-141.77354,64.695881,7.955107,-56.740774,0.03328,0.094719,0.061439,0.055605,1.291625,1.23602,18148.45816,3263.670754,-14884.787406,6.113853,2.328359,-3.785494,0,0,0,3464.71483,2125.615585,-1339.099245,541.545885,1438.73695,897.191065,2759.913567,1972.265954,-787.647613000001,11793.35205,4486.131393,-7307.220657,595.719723,1313.159508,717.439785,0,0.055427,0.055427,0.0033,0.12916,0.12586,0.021278,0.390243,0.368965,0.017933,0.002528,-0.015405,2.051154,3.981615,1.930461,292.337005,181.888736,-110.448269,0.146748,0.093884,-0.052864,0.63767,4.191782,3.554112,0.004257,0,-0.004257,0.589588,0.872483,0.282895,0.095701,0.128726,0.033025,0.170453,0.2346,0.064147,0.007205,0.118086,0.110881,0.090547,0.038346,-0.052201,0,0.005702,0.005702,2.698238,2.167486,-0.530752000000001,0,0.02,0.02,4.022701,16.878225,12.855524,1.022797,1.755856,0.733059,0.041269,2.095637,2.054368,0.019175,0.99438,0.975205,0.04879,0.14886,0.10007,12.715073,2.034322,-10.680751,0.611311,0.673836,0.0625249999999999,48.954579,43.024683,-5.92989599999999,787.732398,81.997886,-705.734512,17.029727,13.867318,-3.162409,277.923112,81.039989,-196.883123,124.964788,222.691675,97.726887,0.808,5.766356,4.958356,,,,0,0.004145,0.004145,118.783187,9.020508,-109.762679,0.057769,8.630226,8.572457,4.097672,12.566221,8.468549,0.466134,7.980248,7.514114,0.219547,1.715341,1.495794,6.161779,6.856442,0.694662999999997,0.524203,3.458603,2.9344,124.773947,6.557347,-118.2166,12.863716,27.150608,14.286892,0.007529,3.289729,3.2822,15.799472,12.650143,-3.14932900000001,2.495072,2.790265,0.295193,2079.509732,109.55004,-1969.959692,0.067861,4.031446,3.963585,272.534816,5.993781,-266.541035,114.098879,2.720105,-111.378774,0.009019,0.53815,0.529131,0.101635,2.403686,2.302051,0.10619,8.308695,8.202505,710.49681,45.116535,-665.380275,85.990913,4.393713,-81.5972,0.000333,0.157099,0.156766,0.274932,0.104505,-0.170427,0.007418,0.294692,0.287274,5.994477,7.563383,1.568906,18.284114,6.896488,-11.387626,0.205909,0.473333,0.267424,0.383083,1.530687,1.147604,0,0.489237,0.489237,2,13.1,11.1,0.020792,4.189307,4.168515,0.317512,8.228145,7.910633,2.708322,4.12861,1.420288,23.70234,179.985928,156.283588,0.394951,1.519274,1.124323,0.040802,0.048459,0.00765700000000002,2.900609,9.773137,6.872528,19.31423,3.227401,-16.086829,1.056292,3.786781,2.730489,33.306461,1.683466,-31.622995,0,0.003961,0.003961,0.095121,0,-0.095121,0.64893,0.143482,-0.505448,0,0,0,543.535736,341.535986,-201.99975,3.731942,9.849495,6.117553,8.390297,7.030106,-1.360191,2.685626,1.032641,-1.652985,17.219634,0.413134,-16.8065,13.213848,2.362757,-10.851091,9.266816,4.267667,-4.999149,33.05467,0.046757,-33.007913,0,18.075916,18.075916,,,
2005-05-01,9870.913114,2566.5,-7304.413114,26691.3,16037,-10654.3,135665,75073.9,-60591.1,8989.724529,0,-8989.724529,11801.309919,6839.8,-4961.509919,21014,17449,-3565,8317.744084,7147.75125,-1169.992834,9990.289486,6296.024304,-3694.265182,37941.177946,28256.402944,-9684.77500200001,30440.189614,18170.199539,-12269.990075,4739.339903,1124.566902,-3614.773001,43538.015508,17667.035598,-25870.97991,136191,75852.4162650001,-60338.5837349999,52091.748769,20464.697527,-31627.051242,1575.200536,1479.834395,-95.366141,985.953761,1526.719338,540.765577,3773.665112,764.97843,-3008.686682,1.807626,0.495151,-1.312475,23527.721353,18327.078159,-5200.643194,0.086127,0.007584,-0.078543,14413.456593,9929.324785,-4484.131808,274.342923,272.009596,-2.333327,5.452897,19.467701,14.014804,160.191472,179.575055,19.383583,333.179989,273.73469,-59.445299,95.320258,56.596313,-38.723945,302.783468,276.328272,-26.4551960000001,27.289761,255.422988,228.133227,1.021956,41.877301,40.855345,85.858073,180.732898,94.874825,0,25.178407,25.178407,30.053871,131.143065,101.089194,1.150518,20.817793,19.667275,1.074045,50.9566,49.882555,39.71608,60.733514,21.017434,409.382426,421.590469,12.2080429999999,0.070958,2.149947,2.078989,3.831704,9.655085,5.823381,3.651271,8.088907,4.437636,0.49773,16.735525,16.237795,0.039287,0.62841,0.589123,0.193668,4.324109,4.130441,1.36661,7.975704,6.609094,0.100378,3.704017,3.603639,0.655917,5.776553,5.120636,3.396111,25.654114,22.258003,657.367353,121.058517,-536.308836,92.774854,70.924126,-21.850728,,,,,,,140.060486,37.092895,-102.967591,0.18164,2.979448,2.797808,0.029969,1.370924,1.340955,671.371952,468.801327,-202.570625,2840.803257,529.502432,-2311.300825,11.55633,13.161549,1.605219,15.318608,18.937738,3.61912999999999,0,5.602235,5.602235,415.716108,185.997576,-229.718532,418.826256,222.161814,-196.664442,19.879259,23.853684,3.974425,539.44017,473.223585,-66.2165849999999,1967.732239,1299.958182,-667.774057,3.394353,78.301745,74.907392,66.180663,27.170614,-39.010049,347.792783,365.042664,17.249881,1.241835,0.026216,-1.215619,19.055247,42.525388,23.470141,1249.86857,312.23416,-937.63441,0.025707,0.652932,0.627225,639.69917,153.599767,-486.099403,397.804593,191.320087,-206.484506,0.157799,0.033216,-0.124583,433.394016,160.469329,-272.924687,4325.628085,3623.032943,-702.595142000002,2696.344057,645.941189,-2050.402868,1285.880728,2239.456802,953.576074000001,1113.876402,1567.800771,453.924369,23.433173,26.646653,3.21348000000001,0.003022,0.636113,0.633091,1.053542,0.849273,-0.204269,2676.313037,1847.892285,-828.420752,7381.99608,2951.448338,-4430.547742,532.103875,199.113339,-332.990536,,,,189.75969,88.694274,-101.065416,140.385831,12.529254,-127.856577,217.481773,87.257637,-130.224136,33.589407,7.119497,-26.46991,1104.234474,834.432548,-269.801926,43.419877,9.452601,-33.967276,8.696734,16.592901,7.896167,98.699222,39.788131,-58.911091,173.925638,122.342396,-51.583242,,,,1168.268079,393.196432,-775.071647,21.205769,2.508382,-18.697387,64.406417,36.331064,-28.075353,5.899192,3.958637,-1.940555,1.809994,10.915954,9.10596,15.28308,13.914669,-1.368411,18.844819,44.967031,26.122212,0.170083,1.601449,1.431366,4.82911,2.827897,-2.001213,57.936558,2.24531,-55.691248,5.105751,68.677147,63.571396,15.964896,5.409333,-10.555563,718.535603,655.837744,-62.6978590000003,180.871002,85.165635,-95.705367,0.247455,14.465572,14.218117,23.842476,11.460276,-12.3822,0.101054,0.623532,0.522478,0,0.622015,0.622015,2673.18248,972.352987,-1700.829493,,,,31.547437,14.813162,-16.734275,40.153546,17.00281,-23.150736,1.014739,1.758482,0.743743,3.032771,2.120962,-0.911809000000001,3.757742,18.474107,14.716365,,,,,,,,,,28.065614,1.600831,-26.464783,64.044798,147.130463,83.085665,75.681114,54.675825,-21.005289,28.798312,50.649704,21.851392,399.130292,346.961656,-52.168636,1.629682,6.068647,4.438965,37.209125,24.351641,-12.857484,8.063452,36.766914,28.703462,708.813116,121.51044,-587.302676,10.819655,6.623304,-4.196351,296.1,334.3,38.2,0.043076,0,-0.043076,0.518849,1.284531,0.765682,84.334785,63.117191,-21.217594,349.516462,164.048857,-185.467605,,,,2188.250466,548.857659,-1639.392807,17.156171,61.792959,44.636788,136.684026,682.904756,546.22073,0.207582,35.734222,35.52664,44.300381,38.689034,-5.61134700000002,25.955147,29.678431,3.723284,2.330042,31.038476,28.708434,1596.745496,704.762188,-891.983308,267.651645,78.583448,-189.068197,11.466164,1.976886,-9.489278,184.108833,35.76792,-148.340913,137.684207,11.715458,-125.968749,0,0.275326,0.275326,1592.961619,567.944888,-1025.016731,487.814556,234.600561,-253.213995,0.336447,2.195736,1.859289,100.933627,6.1683,-94.765327,2712.030088,831.956924,-1880.073164,1230.838348,1722.219612,491.381264,908.525151,226.302349,-682.222802,0,0.655777,0.655777,50.120352,2.38819,-47.732162,724.114659,575.279768,-148.834891,58.325339,9.559338,-48.766001,0.056246,0.12004,0.063794,0.078299,1.361773,1.283474,19053.18688,3222.909738,-15830.277142,6.436389,2.887988,-3.548401,0,0,0,3627.168482,2168.807815,-1458.360667,564.276782,1281.230777,716.953995,2895.460472,1975.493046,-919.967426,10755.990061,4151.24106,-6604.749001,681.766032,1318.808819,637.042787,0.020545,0.004957,-0.015588,0,0.1113,0.1113,0,0.167692,0.167692,0,0,0,3.370588,3.380573,0.00998499999999858,272.842274,177.457589,-95.3846849999999,0.170131,0.056145,-0.113986,0.476876,5.024368,4.547492,0,0.051275,0.051275,0.704004,1.207851,0.503847,0.070061,0.167921,0.09786,0.042571,0.198085,0.155514,0.004655,0.164371,0.159716,0.107671,0.042847,-0.064824,0,0.000323,0.000323,1.756447,2.564373,0.807926,0,0.021132,0.021132,5.936269,9.52747,3.591201,1.219773,1.40142,0.181647,0.005335,2.130822,2.125487,0.081403,0.799257,0.717854,0.000557,0.052808,0.052251,16.826803,2.83743,-13.989373,0.556421,0.603603,0.0471819999999999,44.285326,23.903474,-20.381852,744.384328,93.626456,-650.757872,14.504761,19.030978,4.52621700000001,470.394496,70.546588,-399.847908,102.802873,212.503607,109.700734,0.404,7.090561,6.686561,,,,0,0.002865,0.002865,31.03869,22.991464,-8.04722599999999,0.017647,2.586333,2.568686,17.537909,12.493695,-5.044214,0.256744,6.797115,6.540371,0.093443,2.758738,2.665295,8.16321,8.661376,0.498166000000005,0.512665,4.185779,3.673114,90.075966,10.572807,-79.503159,6.050127,26.276489,20.226362,0.00615,1.378767,1.372617,16.515445,2.85311,-13.662335,0.380019,2.153172,1.773153,1903.064763,121.698864,-1781.365899,1.324787,1.190168,-0.134619,299.931109,5.299479,-294.63163,111.624446,3.357815,-108.266631,0.109267,0.040047,-0.06922,0.141313,1.16612,1.024807,0.190794,4.673418,4.482624,496.343005,59.507972,-436.835033,88.898046,10.074124,-78.823922,0.002191,0.67031,0.668119,0.298546,0.923375,0.624829,0,0.054192,0.054192,0.189233,2.790225,2.600992,52.168177,3.14331,-49.024867,0.208774,0.170393,-0.038381,0.343403,0.327241,-0.016162,0.012987,0.035336,0.022349,1.6,7.7,6.1,0.342,0.725938,0.383938,0.045325,1.621762,1.576437,3.01614,5.923108,2.906968,24.603081,43.280041,18.67696,0.701591,1.09625,0.394659,0.11359,0.097494,-0.016096,3.640251,13.08196,9.441709,14.698383,1.926753,-12.77163,0.183043,2.429549,2.246506,18.0936,1.358461,-16.735139,0,0.000066,0.000066,0.894867,0.039811,-0.855056,0.112889,0.602434,0.489545,0,0.105731,0.105731,483.657173,323.578787,-160.078386,22.399418,7.74522,-14.654198,16.413848,2.748994,-13.664854,2.570279,1.102916,-1.467363,11.143173,1.513997,-9.629176,6.323577,3.535007,-2.78857,8.889322,2.543249,-6.346073,24.039991,0.315914,-23.724077,0,13.302976,13.302976,,,
2005-06-01,10176.244476,2535.8,-7640.444476,26425.8,15586.7,-10839.1,137614,74950.1,-62663.9,9366.591421,0,-9366.591421,12285.319966,6881.9,-5403.419966,22866,19365,-3501,8644.789044,7269.575377,-1375.213667,10502.956454,6277.264607,-4225.691847,38520.880887,28797.976445,-9722.904442,30689.212312,17849.884717,-12839.327595,4746.759382,1509.049692,-3237.70969,47466.208382,18746.433372,-28719.77501,141426,77589.30663,-63836.69337,55957.660375,21587.518213,-34370.142162,1682.094414,1492.433895,-189.660519,1007.91425,1559.286725,551.372475,3400.649471,1067.04195,-2333.607521,0.58016,0.686705,0.106545,23672.246856,18684.461319,-4987.785537,0.338401,0.145051,-0.19335,14848.634031,10113.515126,-4735.118905,306.198328,264.069414,-42.128914,5.360313,19.713775,14.353462,190.070956,170.201365,-19.869591,350.611163,271.678623,-78.93254,98.39618,60.900154,-37.496026,309.985668,309.288654,-0.697013999999967,27.244552,187.307483,160.062931,1.70446,38.074346,36.369886,98.267061,152.517038,54.249977,0,35.430172,35.430172,25.56477,134.445039,108.880269,1.115378,19.819366,18.703988,1.168043,70.093449,68.925406,43.22704,51.6565,8.42946000000001,426.832119,416.295685,-10.5364339999999,0.191951,1.890494,1.698543,2.189989,8.451664,6.261675,4.745725,6.274622,1.528897,0.250904,11.732582,11.481678,0.078111,0.679112,0.601001,0.167763,5.115946,4.948183,1.071841,6.702508,5.630667,0.079959,2.997702,2.917743,0.857495,6.140481,5.282986,2.752309,35.117949,32.36564,705.99755,142.819723,-563.177827,114.838095,77.672301,-37.165794,,,,,,,223.967794,27.474162,-196.493632,0.078081,3.603648,3.525567,0.002549,2.648272,2.645723,775.897798,469.8172,-306.080598,2964.452479,500.073619,-2464.37886,10.860751,13.024367,2.163616,12.296057,19.399719,7.103662,0,3.656323,3.656323,478.745009,193.390784,-285.354225,375.539507,213.684476,-161.855031,21.226507,18.027121,-3.199386,344.137658,440.52559,96.387932,2163.652384,1330.761995,-832.890389,3.10581,75.222646,72.116836,55.95102,29.987724,-25.963296,354.071328,428.878964,74.807636,0.003999,0.00185,-0.002149,16.952899,114.954746,98.001847,1336.245499,300.738745,-1035.506754,0.000358,0.567584,0.567226,760.503973,150.743594,-609.760379,365.699266,163.73909,-201.960176,0.092026,0.096765,0.00473900000000001,438.381935,170.547222,-267.834713,4137.534951,3287.096103,-850.438848,2643.199019,613.948883,-2029.250136,1146.07758,2226.052225,1079.974645,1055.751256,1658.156172,602.404916,34.953102,53.241618,18.288516,0.248066,0.505633,0.257567,1.52215,0.737735,-0.784415,3192.970511,1950.800145,-1242.170366,7052.21885,2704.909143,-4347.309707,485.630521,238.56669,-247.063831,,,,205.068534,76.848818,-128.219716,95.642743,10.430732,-85.212011,217.08026,73.507599,-143.572661,22.48499,1.321026,-21.163964,1110.909446,983.061795,-127.847651,40.571004,7.503039,-33.067965,15.570069,14.839703,-0.730366,35.981187,31.722151,-4.25903599999999,159.934705,122.385468,-37.5492370000001,,,,1266.874684,305.915569,-960.959115,36.1261,2.642285,-33.483815,83.479273,66.761661,-16.717612,3.192791,3.8853,0.692508999999999,11.218192,13.36165,2.143458,40.92356,19.728352,-21.195208,214.98375,32.773605,-182.210145,0.011464,3.969182,3.957718,4.677691,4.335234,-0.342457,15.891092,0.907603,-14.983489,22.354726,9.50981,-12.844916,1.447839,9.805645,8.357806,734.689026,655.812965,-78.8760610000003,210.459923,128.698937,-81.760986,0.089545,13.427787,13.338242,25.996126,32.856048,6.85992200000001,0.024274,0.059497,0.035223,0.028164,0.095512,0.067348,2696.334061,934.994375,-1761.339686,,,,26.794257,30.173509,3.379252,36.0148,18.031581,-17.983219,0.969224,1.872668,0.903444,4.720625,1.561855,-3.15877,3.432863,13.518506,10.085643,,,,,,,,,,0.830333,0.71134,-0.118993,61.368154,105.491457,44.123303,110.145387,49.964655,-60.180732,25.636635,31.274173,5.637538,476.805637,394.959354,-81.8462829999999,2.467216,5.762178,3.294962,38.330097,11.845251,-26.484846,7.609855,34.705471,27.095616,818.084005,108.549309,-709.534696,11.842842,8.29353,-3.549312,332.8,332.5,-0.300000000000011,0.249654,0.22275,-0.026904,0.235305,1.551271,1.315966,93.970584,64.942539,-29.028045,316.689519,141.408165,-175.281354,,,,2168.187196,587.15791,-1581.029286,8.541119,108.638551,100.097432,122.506947,580.004418,457.497471,0.36,8.540806,8.180806,54.045022,39.520835,-14.524187,21.820234,27.300608,5.480374,1.274128,16.773065,15.498937,1419.668253,640.748621,-778.919632,267.144359,105.640727,-161.503632,9.980043,1.241287,-8.738756,222.298754,27.614282,-194.684472,159.592606,19.333595,-140.259011,0,0.356891,0.356891,1743.837948,718.557713,-1025.280235,535.008353,72.396457,-462.611896,0.347145,0.668366,0.321221,141.681706,4.673011,-137.008695,2951.340547,898.295577,-2053.04497,1254.110717,1696.31744,442.206723,983.532476,262.809175,-720.723301,0,0.361855,0.361855,39.242541,2.692491,-36.55005,802.765188,549.261285,-253.503903,82.778805,12.457917,-70.320888,0.000344,0.019871,0.019527,0.039939,0.817018,0.777079,20976.701857,3370.730806,-17605.971051,11.775962,1.644535,-10.131427,0,0,0,3806.372348,2427.060334,-1379.312014,637.826202,1378.35461,740.528408,2946.479777,1767.842993,-1178.636784,12004.217964,4855.805944,-7148.41202,658.031013,1339.695811,681.664798,0.064569,0.062979,-0.00159000000000002,0.001508,0.076139,0.074631,0.043337,0.059591,0.016254,0,0.0088,0.0088,1.828419,5.871357,4.042938,320.980528,179.237632,-141.742896,0.297501,0.208798,-0.088703,0.660459,9.458014,8.797555,0,0.088116,0.088116,0.64854,1.596368,0.947828,0.084921,0.184628,0.099707,0.163665,1.111771,0.948106,0.002399,0.092244,0.089845,0.104968,0.208292,0.103324,0.002825,0,-0.002825,2.320625,4.140271,1.819646,0,0.027877,0.027877,8.074355,7.718612,-0.355742999999999,1.184119,1.883393,0.699274,0.006232,1.544216,1.537984,0.074296,1.200198,1.125902,0.025375,0.103589,0.078214,12.911887,3.809203,-9.102684,0.407933,0.980437,0.572504,52.466769,32.40901,-20.057759,979.463912,72.668855,-906.795057,19.794297,39.799278,20.004981,505.098977,44.491593,-460.607384,120.964993,291.698293,170.7333,2.428,2.794443,0.366443,,,,0,0.009342,0.009342,122.574705,17.161588,-105.413117,0.0027,2.569537,2.566837,7.011805,10.818287,3.806482,0.664035,9.070557,8.406522,1.428134,3.131686,1.703552,5.455572,6.026703,0.571131,0.526145,2.962364,2.436219,68.789626,11.209935,-57.579691,18.477634,23.054114,4.57648000000001,0.005,1.710329,1.705329,14.782889,3.566171,-11.216718,1.524854,1.527581,0.00272700000000037,1637.131083,160.930785,-1476.200298,0.300218,1.250726,0.950508,94.721002,6.740104,-87.980898,146.149643,2.585286,-143.564357,0.400042,0.032305,-0.367737,0.053273,1.468502,1.415229,0.057982,7.260258,7.202276,498.299873,56.118479,-442.181394,56.142286,5.848338,-50.293948,0.065009,0.116814,0.051805,0.40591,0.798191,0.392281,0.07521,0.116465,0.041255,17.758941,8.37109,-9.38785099999999,2.783665,7.437313,4.653648,0.301807,0.548872,0.247065,0.363809,0.43577,0.0719610000000001,0.008796,0.14366,0.134864,3.3,31.5,28.2,0.017443,7.349396,7.331953,0.167633,7.735798,7.568165,2.241588,5.602964,3.361376,33.121435,199.113357,165.991922,0.263895,0.595664,0.331769,0.033748,0.096562,0.062814,1.652891,4.640591,2.9877,19.810432,2.186118,-17.624314,1.246529,6.146352,4.899823,31.707225,2.959961,-28.747264,0.00542,0.00395,-0.00147,0.005264,0.057403,0.052139,0.685658,0.027752,-0.657906,0,0.003367,0.003367,509.799041,337.353909,-172.445132,9.276182,6.240774,-3.035408,7.448885,1.930745,-5.51814,3.360492,2.515917,-0.844574999999999,19.488539,0.584545,-18.903994,8.083386,3.786354,-4.297032,9.409871,3.692449,-5.717422,39.717739,0.042104,-39.675635,0,7.494475,7.494475,,,
2005-07-01,11280.785061,2477.4,-8803.385061,26425.8,14272.8,-12153,137423,74688.4,-62734.6,7782.41745,0,-7782.41745,9707.764131,5113.9,-4593.864131,21449,17176,-4273,8197.031435,6982.543835,-1214.4876,10457.108947,6083.445091,-4373.663856,33797.458131,23920.47854,-9876.97959099999,29440.805145,16187.500653,-13253.304492,5489.928839,1378.616067,-4111.312772,46966.573322,18427.875972,-28538.69735,136515,70026.724192,-66488.275808,56258.724181,20829.504755,-35429.219426,1443.413034,1396.845756,-46.567278,1067.935678,1619.617823,551.682144999999,4133.237639,985.656861,-3147.580778,3.225629,0.387117,-2.838512,21087.259288,14719.574647,-6367.684641,0.093388,0.026842,-0.066546,12710.198843,9200.903893,-3509.29495,258.777202,213.648726,-45.128476,6.865611,14.967308,8.10169700000001,165.538477,151.151426,-14.387051,292.19852,257.273833,-34.9246869999999,93.997444,59.166986,-34.830458,260.650967,337.200051,76.5490839999999,28.626622,160.106626,131.480004,25.776511,38.682381,12.90587,53.549362,146.574018,93.024656,0,20.596463,20.596463,36.527285,140.72867,104.201385,0.076956,23.51655,23.439594,8.080018,43.443422,35.363404,42.433181,53.811653,11.378472,372.250424,378.404734,6.15431000000001,0.308134,2.153598,1.845464,2.31752,7.960265,5.642745,4.119591,6.918636,2.799045,0.300558,9.356477,9.055919,0.035082,0.390307,0.355225,0.115307,5.268439,5.153132,16.960213,12.802272,-4.157941,0.053202,4.266904,4.213702,0.414881,9.184462,8.769581,2.077353,34.800784,32.723431,587.752164,154.907122,-432.845042,133.223885,76.08658,-57.137305,,,,,,,264.831079,44.91759,-219.913489,0.590623,5.499062,4.908439,0.130503,3.554126,3.423623,619.23391,420.936252,-198.297658,3217.567729,522.442088,-2695.125641,12.417409,15.981923,3.564514,15.306444,22.498495,7.192051,0,0.87881,0.87881,461.820355,146.616531,-315.203824,407.370432,183.781361,-223.589071,32.613378,19.249493,-13.363885,455.983283,525.297099,69.3138160000002,2177.130282,1364.642147,-812.488135,4.109929,73.030768,68.920839,50.795077,31.041592,-19.753485,341.890724,339.709061,-2.18166299999996,2.29132,0,-2.29132,19.678522,34.461331,14.782809,1079.156134,246.194333,-832.961801,0,0.573289,0.573289,577.170673,157.477365,-419.693308,285.445302,190.747859,-94.697443,0.020207,0.102399,0.082192,449.227749,141.489748,-307.738001,4035.053742,3056.808477,-978.245265,2081.01541,595.985755,-1485.029655,1218.143938,2105.10718,886.963242,1240.288839,1454.947949,214.65911,30.879684,47.505279,16.625595,0.011316,0.804384,0.793068,2.269028,0.206708,-2.06232,2687.639008,1601.115138,-1086.52387,7206.450738,2654.395744,-4552.054994,505.807457,198.18784,-307.619617,,,,183.54739,90.181384,-93.366006,136.078751,11.961722,-124.117029,198.149438,80.512083,-117.637355,24.515822,0.891693,-23.624129,1025.62893,831.533206,-194.095724,111.082378,8.136161,-102.946217,13.872615,20.932468,7.059853,27.841699,30.008265,2.166566,172.425431,88.909984,-83.515447,,,,1313.227893,289.605465,-1023.622428,34.88789,2.880465,-32.007425,100.333222,42.094865,-58.238357,3.693992,5.603758,1.909766,0.320181,8.891043,8.570862,19.502849,14.282012,-5.220837,57.990393,43.560154,-14.430239,0.05248,4.110517,4.058037,3.439784,2.674241,-0.765543,24.350967,4.104596,-20.246371,37.276934,1.770777,-35.506157,2.084022,5.917731,3.833709,711.183422,600.852633,-110.330789,213.539862,54.163685,-159.376177,2.067361,6.390447,4.323086,18.928727,11.928546,-7.000181,0.071116,0.422412,0.351296,0.045228,0.152787,0.107559,2864.818443,876.537875,-1988.280568,,,,29.568659,13.339504,-16.229155,31.931095,14.478252,-17.452843,1.513341,2.441843,0.928502,6.233861,1.591799,-4.642062,5.247184,8.531471,3.284287,,,,,,,,,,0.64707,3.492857,2.845787,68.584764,86.508045,17.923281,107.093441,58.260564,-48.832877,61.334397,24.438889,-36.895508,407.319582,344.119488,-63.2000939999999,2.116784,5.176188,3.059404,54.975523,21.317521,-33.658002,6.55355,39.355074,32.801524,803.954533,128.233065,-675.721468,13.341926,8.431378,-4.910548,371.8,340.3,-31.5,0.050564,0,-0.050564,0.052011,0.062451,0.01044,104.84261,50.608883,-54.233727,361.180243,131.272939,-229.907304,,,,2632.375334,525.660023,-2106.715311,12.694915,60.428043,47.733128,101.628027,602.277891,500.649864,0.475768,12.83954,12.363772,55.684404,43.215589,-12.468815,29.694006,20.089061,-9.604945,24.721923,20.042137,-4.679786,1513.884079,711.075511,-802.808568,293.382851,77.833506,-215.549345,7.957999,0.837134,-7.120865,254.598562,24.442308,-230.156254,191.100093,13.259688,-177.840405,0,0.386974,0.386974,1644.353131,620.512339,-1023.840792,603.982076,72.923163,-531.058913,0.240688,0.462671,0.221983,158.475703,5.515879,-152.959824,3093.597171,888.243931,-2205.35324,1188.78058,1587.730228,398.949648,1014.40086,217.495943,-796.904917,0,0.91004,0.91004,47.381791,3.345478,-44.036313,788.082369,562.025268,-226.057101,111.85224,8.278364,-103.573876,0,0.038876,0.038876,0.043728,0.931609,0.887881,21272.66946,3559.972145,-17712.697315,13.377336,1.092613,-12.284723,0,0,0,3323.631381,2366.109723,-957.521658000001,777.783648,1331.528508,553.74486,2906.835826,1697.175376,-1209.66045,11394.165456,4628.856472,-6765.308984,790.998588,1381.770192,590.771604,0.009485,0.00956,0.0000750000000000004,0,0.025328,0.025328,0.019958,0.142565,0.122607,0,0,0,4.355453,6.876603,2.52115,252.038499,188.467741,-63.5707580000001,0.269485,0.048332,-0.221153,0.671682,14.107921,13.436239,0.076184,0.004823,-0.071361,0.685254,1.688792,1.003538,0.054654,0.156016,0.101362,0.169423,0.782976,0.613553,0.013185,0.067962,0.054777,0.104306,0.438706,0.3344,0.015489,0.015,-0.000488999999999996,1.709226,4.116776,2.40755,0,0.00024,0.00024,3.640105,11.64882,8.008715,1.017802,2.226492,1.20869,0.182384,2.607094,2.42471,0.02174,1.083942,1.062202,0,0.072259,0.072259,11.560861,2.709591,-8.85127,0.347377,0.524383,0.177006,36.283899,21.221097,-15.062802,967.599548,90.143272,-877.456276,20.219783,15.369912,-4.849871,543.701597,63.321196,-480.380401,178.276287,261.026684,82.7503969999999,1.504,6.657147,5.153147,,,,0,0.000154,0.000154,118.368785,10.332779,-108.036006,0.093918,16.954248,16.86033,26.828003,11.592565,-15.235438,0.610231,47.277012,46.666781,0.252813,5.246168,4.993355,5.910338,6.503274,0.592936,1.794598,0.87899,-0.915608,90.369133,10.067703,-80.30143,14.512931,53.583122,39.070191,0.036945,0.809444,0.772499,15.798924,3.779017,-12.019907,1.019667,2.151899,1.132232,2180.969177,186.248027,-1994.72115,1.214628,0.583579,-0.631049,233.813248,14.212275,-219.600973,169.713947,6.572119,-163.141828,0.0201,0.007978,-0.012122,0.083644,1.683926,1.600282,0.023372,5.857487,5.834115,374.414768,77.177376,-297.237392,184.453504,13.641551,-170.811953,0.000467,0.036713,0.036246,0.284247,1.714597,1.43035,0,0.169828,0.169828,1.910142,4.353573,2.443431,24.167158,5.578279,-18.588879,2.081883,0.611017,-1.470866,0.298722,1.714631,1.415909,0.113323,1.676585,1.563262,2.4,12.2,9.8,0.18,1.064406,0.884406,0.001203,9.982653,9.98145,2.518599,9.098826,6.580227,25.588731,13.714615,-11.874116,0.374462,8.720229,8.345767,0.005265,0.146651,0.141386,2.620411,13.250089,10.629678,16.32777,2.64243,-13.68534,0.658614,3.033311,2.374697,29.488037,1.232537,-28.2555,0,0.000066,0.000066,0,0.033369,0.033369,1.047812,0.302678,-0.745134,0,0.000054,0.000054,506.668564,348.003546,-158.665018,5.635511,6.042814,0.407302999999998,25.370493,3.854909,-21.515584,1.273974,1.85514,0.581166,15.646871,0.59448,-15.052391,3.626286,4.352128,0.725842000000001,5.848588,1.918894,-3.929694,32.650145,0.247892,-32.402253,0,7.147304,7.147304,,,
2005-08-01,12553.135127,2764.5,-9788.635127,25534.3,14459.9,-11074.4,139189,76214.7,-62974.3,9306.573191,0,-9306.573191,13339.875369,6365.8,-6974.075369,21726,18219,-3507,8947.217357,7597.204507,-1350.01285,10854.290687,6185.282981,-4669.007706,39936.852527,28876.213003,-11060.639524,29063.142293,16470.666499,-12592.475794,6508.647177,1235.383894,-5273.263283,48918.344476,19466.392514,-29451.951962,146397,76693.338164,-69703.661836,59168.118403,22334.768863,-36833.34954,1564.818415,1431.067962,-133.750453,862.562135,1573.002243,710.440108,4866.193755,756.278527,-4109.915228,3.061873,0.39331,-2.668563,25041.270324,18250.140662,-6791.129662,0.205471,0.040891,-0.16458,14895.582203,10626.072341,-4269.509862,289.107511,226.85081,-62.256701,6.72302,12.75309,6.03007,168.40846,144.546802,-23.8616579999999,322.436854,284.726831,-37.710023,111.148094,49.809896,-61.338198,269.999838,306.765595,36.765757,27.074459,129.66292,102.588461,5.774965,45.430998,39.656033,58.280033,160.443629,102.163596,0,30.569819,30.569819,23.476564,133.609136,110.132572,0.903831,20.135845,19.232014,1.07527,43.869975,42.794705,35.007022,63.465438,28.458416,403.717658,418.368028,14.65037,0.255278,2.557735,2.302457,2.559825,28.404667,25.844842,4.250945,8.660995,4.41005,0.450415,15.678687,15.228272,0.055022,0.502277,0.447255,0.238563,3.407471,3.168908,2.004854,12.626415,10.621561,7.779958,3.312803,-4.467155,0.397635,6.668965,6.27133,2.174899,30.934749,28.75985,613.055336,135.375392,-477.679944,108.170246,118.246939,10.076693,,,,,,,224.944549,42.347889,-182.59666,0.368825,7.59149,7.222665,0.073614,4.218682,4.145068,922.277902,450.658568,-471.619334,3056.120671,571.219863,-2484.900808,9.800913,9.356281,-0.444632,15.036452,16.290443,1.253991,0.03855,6.346319,6.307769,571.241563,215.697818,-355.543745,475.172691,207.151744,-268.020947,34.422506,19.199583,-15.222923,520.162187,386.828406,-133.333781,2023.301195,1372.551926,-650.749269,7.014593,67.280612,60.266019,63.167576,31.392299,-31.775277,466.476815,339.752279,-126.724536,0.14353,0.012872,-0.130658,17.787844,52.383372,34.595528,928.340668,259.547422,-668.793246,0,0.628683,0.628683,500.166779,132.175939,-367.99084,351.669419,186.309895,-165.359524,0.03052,0.429794,0.399274,423.882415,154.298022,-269.584393,4138.792553,3118.819432,-1019.973121,2134.453249,646.295128,-1488.158121,1235.56415,1955.28695,719.7228,874.386894,1562.328758,687.941864,58.454154,32.455994,-25.99816,0.018844,0.931587,0.912743,1.414712,8.47881,7.064098,2657.45395,1521.963368,-1135.490582,7423.579203,2888.171646,-4535.407557,523.298206,217.197136,-306.10107,,,,184.555949,82.897873,-101.658076,74.695326,26.909967,-47.785359,398.871497,72.014998,-326.856499,25.234129,2.212029,-23.0221,963.719453,867.354735,-96.364718,23.659814,17.136149,-6.523665,32.440445,15.229198,-17.211247,11.745995,34.178974,22.432979,160.48109,108.612938,-51.868152,,,,1102.852881,349.907732,-752.945149,9.562415,7.009465,-2.55295,64.024077,40.151604,-23.872473,5.337923,6.784965,1.447042,6.174715,9.262545,3.08783,0.591681,25.064006,24.472325,92.636366,26.335562,-66.300804,0.064538,0.587437,0.522899,6.282599,2.982219,-3.30038,0.076952,1.074829,0.997877,19.373618,59.093747,39.720129,18.748094,5.49055,-13.257544,690.53567,554.800568,-135.735102,179.015521,77.847964,-101.167557,0.122808,1.067061,0.944253,19.793824,17.981581,-1.812243,0.009002,0.344661,0.335659,0.009139,0.865025,0.855886,2871.50953,803.852945,-2067.656585,,,,24.7298,6.105283,-18.624517,34.181845,26.44577,-7.73607500000001,1.371004,0.799748,-0.571256,4.470812,2.6226,-1.848212,5.035041,10.20228,5.167239,,,,,,,,,,0.632219,2.309188,1.676969,100.177705,72.237102,-27.940603,132.538848,54.515196,-78.023652,32.199984,30.429711,-1.770273,493.603724,303.202409,-190.401315,2.7827,7.043949,4.261249,29.390568,15.187066,-14.203502,5.535697,41.772949,36.237252,789.577112,128.472968,-661.104144,14.784887,9.028735,-5.756152,278.5,330.4,51.9,0.050133,0.00837,-0.041763,0.079564,0.388717,0.309153,123.152436,67.181213,-55.971223,489.195349,156.021065,-333.174284,,,,2780.442129,630.131966,-2150.310163,5.129883,126.758759,121.628876,98.849348,646.098756,547.249408,73.515378,28.40191,-45.113468,16.94389,32.508976,15.565086,39.578195,35.591149,-3.987046,2.466964,16.125543,13.658579,1734.958374,703.600915,-1031.357459,303.865772,148.76827,-155.097502,8.344516,2.742455,-5.602061,276.379251,32.303324,-244.075927,185.284675,15.001745,-170.28293,0,0.321142,0.321142,1808.171088,620.075526,-1188.095562,656.8278,75.208251,-581.619549,0.108561,0.617929,0.509368,177.610832,5.475453,-172.135379,3101.843453,962.006242,-2139.837211,1338.237122,1743.507312,405.27019,1097.556054,192.565714,-904.99034,0,0.428475,0.428475,53.747317,5.925139,-47.822178,867.741227,619.264932,-248.476295,132.487242,6.381906,-126.105336,0.03325,0.095486,0.062236,0.017542,0.549826,0.532284,22421.292348,3728.723847,-18692.568501,17.739833,1.450096,-16.289737,0,0,0,3661.184416,2352.338357,-1308.846059,877.068681,1429.130509,552.061828,3070.727138,2072.228329,-998.498809000001,11457.191131,4809.676069,-6647.515062,608.272643,1315.728336,707.455693,0.01464,0.00033,-0.01431,0,0.155348,0.155348,0.023994,0.546027,0.522033,0,0.112542,0.112542,4.039012,5.931059,1.892047,226.956692,222.984763,-3.97192900000007,0.095897,0.094153,-0.00174399999999998,0.344211,5.147512,4.803301,0.018076,0,-0.018076,0.9565,1.224755,0.268255,0.081794,0.357198,0.275404,0.3296,0.398491,0.068891,0,0.129965,0.129965,0.094014,0.436942,0.342928,0,0.000849,0.000849,1.590559,3.583542,1.992983,0,0.015,0.015,4.188587,7.980306,3.791719,1.032766,1.968604,0.935838,0.090912,1.805448,1.714536,0.031267,1.087369,1.056102,0.005938,0.242985,0.237047,13.92145,2.703689,-11.217761,0.47113,0.56941,0.09828,34.737172,16.781011,-17.956161,1093.737635,156.905644,-936.831991,34.504906,20.879352,-13.625554,496.003286,60.677077,-435.326209,196.060698,272.87647,76.815772,3.434,3.954537,0.520537,,,,0,0,0,222.716122,29.365045,-193.351077,0.006531,5.282909,5.276378,3.363631,8.789303,5.425672,0.352333,7.611288,7.258955,0.362489,2.626557,2.264068,5.331637,10.54923,5.217593,0.627317,5.390046,4.762729,24.203052,6.895932,-17.30712,6.671971,31.938897,25.266926,0.001595,11.238606,11.237011,0.959005,4.677779,3.718774,0.446152,4.349123,3.902971,2411.858872,135.82882,-2276.030052,0.477804,1.546661,1.068857,272.54149,7.095505,-265.445985,168.147101,3.636826,-164.510275,1.031928,0.028374,-1.003554,0.054143,3.385502,3.331359,0.004515,6.459108,6.454593,961.257841,53.10532,-908.152521,127.486043,8.814788,-118.671255,0.006268,0.461743,0.455475,0.501696,0.656096,0.1544,0.004272,0.41173,0.407458,5.510709,7.45156,1.940851,11.45938,4.419938,-7.039442,0.578266,0.934409,0.356143,0.063065,1.121986,1.058921,0.007544,0.969075,0.961531,2.3,9.6,7.3,0.025702,1.889259,1.863557,0.076439,3.522996,3.446557,2.45991,3.241875,0.781965,29.921748,26.917135,-3.00461300000001,0.717178,1.380563,0.663385,0.019172,0.027747,0.008575,2.345171,7.27733,4.932159,23.640541,2.223281,-21.41726,0.502357,7.897677,7.39532,28.0672,0.993843,-27.073357,0,0,0,0.024385,0.022056,-0.002329,1.397374,0.121074,-1.2763,0.0247,0.009495,-0.015205,430.973038,301.899958,-129.07308,10.914255,8.979989,-1.934266,17.931346,4.267925,-13.663421,2.492602,2.92755,0.434948,17.452705,1.179753,-16.272952,10.954942,2.971042,-7.9839,6.487202,1.188238,-5.298964,43.968657,0.0305,-43.938157,0,17.58648,17.58648,,,
2005-09-01,11822.557411,2577.7,-9244.857411,24951.4,14684.2,-10267.2,143958,74227.5,-69730.5,8881.523836,0,-8881.523836,13540.231868,6719.8,-6820.431868,22677,17513,-5164,8575.360239,7045.902467,-1529.457772,10901.005012,5843.882055,-5057.122957,40467.512442,28652.740411,-11814.772031,28832.412468,16642.919565,-12189.492903,6222.557182,1114.314161,-5108.243021,48700.083575,18015.195626,-30684.887949,146216,74304.140414,-71911.859586,58919.206924,20449.581748,-38469.625176,1512.747811,1340.63787,-172.109941,869.668059,1562.274372,692.606313,4700.555653,736.98119,-3963.574463,3.854107,0.179614,-3.674493,25949.915501,18368.261822,-7581.653679,0.011971,0.003659,-0.008312,14517.596941,10284.478589,-4233.118352,251.351154,194.164163,-57.186991,6.194148,17.13071,10.936562,169.375618,128.154485,-41.221133,311.931891,284.305949,-27.625942,97.641199,46.366496,-51.274703,273.988991,273.781547,-0.20744400000001,31.671345,156.981883,125.310538,37.03825,78.676365,41.638115,39.060162,130.576174,91.516012,0.003453,22.573776,22.570323,26.767384,161.139342,134.371958,0.356958,17.935439,17.578481,1.196636,52.712709,51.516073,34.722058,52.583798,17.86174,408.458958,413.86523,5.406272,1.711202,3.642064,1.930862,0.744262,7.972097,7.227835,4.270331,12.270889,8.000558,0.538544,9.924624,9.38608,0.003651,0.351633,0.347982,0.614363,6.949251,6.334888,1.041005,15.080526,14.039521,6.512128,5.650423,-0.861705000000001,0.41462,7.974587,7.559967,1.897865,30.434196,28.536331,682.669617,107.545852,-575.123765,81.015699,63.809098,-17.206601,,,,,,,430.42758,56.705553,-373.722027,0.123299,5.381627,5.258328,0.092591,4.813939,4.721348,773.091143,419.098435,-353.992708,3317.386284,591.743565,-2725.642719,8.414847,15.39833,6.983483,15.16759,15.205121,0.037530999999996,0,1.594386,1.594386,371.599973,157.845358,-213.754615,497.144393,165.134762,-332.009631,44.835051,17.081555,-27.753496,489.3075,380.206755,-109.100745,2001.230828,1285.480219,-715.750609,6.94869,84.11343,77.16474,73.254661,27.881351,-45.37331,400.443886,312.789117,-87.654769,0.345204,0.855246,0.510042,17.737785,27.691083,9.953298,1124.55805,283.052545,-841.505505,0,0.449744,0.449744,462.960025,167.569866,-295.390159,321.910548,198.224746,-123.685802,0.352556,0.433116,0.0805600000000001,518.249305,153.132342,-365.116963,4352.135932,3029.086505,-1323.049427,2409.47909,658.47352,-1751.00557,1412.475549,2086.090782,673.615233,1169.797616,1474.721687,304.924071,26.325644,34.586858,8.261214,0.022242,0.575915,0.553673,9.181402,0.762228,-8.419174,2868.715411,1726.426812,-1142.288599,6445.166269,2889.475099,-3555.69117,486.643535,212.304274,-274.339261,,,,184.236545,81.095357,-103.141188,58.947368,11.729984,-47.217384,205.33989,77.358116,-127.981774,18.966771,1.8602,-17.106571,1061.634112,887.868298,-173.765814,66.789032,10.823794,-55.965238,12.649359,12.901117,0.251757999999995,36.888816,28.39095,-8.497866,157.95202,104.892773,-53.059247,,,,1272.792387,335.013278,-937.779109,22.088943,1.939969,-20.148974,139.594988,41.7975,-97.797488,4.606637,7.976814,3.370177,16.520578,11.632409,-4.888169,1.395437,27.556343,26.160906,65.706204,28.761914,-36.94429,1.139499,1.171632,0.0321329999999997,5.979484,3.643402,-2.336082,57.996001,1.609762,-56.386239,5.523586,1.725597,-3.797989,3.074013,4.176426,1.102413,597.747533,501.894031,-95.8535019999999,202.521849,58.724538,-143.797311,0.171342,0.455898,0.284556,22.366541,14.073547,-8.292994,0.015026,0.083179,0.068153,0.019136,2.04316,2.024024,2166.476177,907.206405,-1259.269772,,,,39.279298,6.950905,-32.328393,27.660889,25.062876,-2.59801300000001,1.233873,1.216192,-0.0176810000000003,4.668044,1.078425,-3.589619,4.008661,8.714091,4.70543,,,,,,,,,,1.179122,0.991853,-0.187269,74.449719,94.575689,20.12597,143.893486,55.856254,-88.037232,33.818324,12.681369,-21.136955,485.45631,314.463374,-170.992936,1.914509,9.865022,7.950513,31.169219,12.007194,-19.162025,5.959919,39.116683,33.156764,928.993319,174.602363,-754.390956,21.673593,13.965387,-7.708206,350.7,341.5,-9.19999999999999,0.74729,0,-0.74729,0.061247,0.090712,0.029465,137.148367,41.589789,-95.558578,361.524553,168.663788,-192.860765,,,,2450.527209,435.386022,-2015.141187,61.560328,110.153724,48.593396,164.019703,615.720313,451.70061,9.502628,13.520549,4.017921,17.689017,37.795269,20.106252,44.320713,33.705208,-10.615505,18.992143,10.328145,-8.663998,1674.560474,712.883807,-961.676667,298.825971,104.400296,-194.425675,8.601611,1.54298,-7.058631,275.809625,27.822862,-247.986763,189.11773,12.918511,-176.199219,0,0.434227,0.434227,1816.644351,556.894767,-1259.749584,667.87804,67.049829,-600.828211,0.681455,0.176883,-0.504572,191.748442,5.576392,-186.17205,3000.198734,946.619473,-2053.579261,1259.07481,1714.975794,455.900983999999,1109.408025,243.278666,-866.129359,0,0.628845,0.628845,44.24877,5.611026,-38.637744,863.085021,625.730561,-237.35446,138.728517,6.409406,-132.319111,0.071023,0.033422,-0.037601,0.031241,0.855399,0.824158,23294.481679,3165.813266,-20128.668413,18.596334,1.268871,-17.327463,0,2.347347,2.347347,3342.957705,2137.280651,-1205.677054,1057.879977,1586.358952,528.478975000001,2915.447747,1607.28707,-1308.160677,10837.650276,4439.88986,-6397.760416,611.030729,1313.50383,702.473101,0,0.0108,0.0108,0.031828,0.099623,0.067795,0.002207,0.076662,0.074455,0,0.163861,0.163861,5.144349,6.605288,1.460939,220.747236,215.831783,-4.91545299999996,0.09585,0.143038,0.047188,0.361938,2.888353,2.526415,0,0,0,0.900829,1.700614,0.799785,0.066827,0.208891,0.142064,0.431633,1.54925,1.117617,0.008466,0.106034,0.097568,0.082334,0.308693,0.226359,0.003345,0,-0.003345,7.556286,3.696615,-3.859671,0,0.005554,0.005554,4.615425,7.836697,3.221272,0.759436,1.491481,0.732045,0.076396,1.940588,1.864192,0.051057,0.726679,0.675622,0.029268,0.0356,0.00633199999999999,16.330983,2.978618,-13.352365,0.509916,0.504842,-0.00507400000000002,31.306792,22.651142,-8.65565,1032.397783,92.558172,-939.839611,71.955231,30.400802,-41.554429,175.402185,44.103805,-131.29838,244.240748,227.3646,-16.876148,0.24,7.020887,6.780887,,,,0,0,0,180.519331,6.906615,-173.612716,0.088532,6.007235,5.918703,22.736023,4.152962,-18.583061,0.151964,10.379136,10.227172,0.164761,2.314882,2.150121,4.379286,7.631449,3.252163,1.822482,1.520617,-0.301865,88.259681,5.360513,-82.899168,27.861303,27.257878,-0.603424999999998,0.314024,2.082998,1.768974,0.029991,4.400025,4.370034,0.07934,1.850137,1.770797,1989.471019,127.568029,-1861.90299,0.109152,1.550742,1.44159,302.788876,12.14931,-290.639566,114.682612,5.109844,-109.572768,0.009265,0.102853,0.093588,1.244099,4.467676,3.223577,0.00429,5.006448,5.002158,981.704024,64.938307,-916.765717,233.030839,5.243076,-227.787763,0,0.043519,0.043519,0.039516,0.527432,0.487916,0.002098,0.23964,0.237542,12.58458,7.360673,-5.223907,30.743019,7.547221,-23.195798,0.394397,0.309726,-0.0846710000000001,0.668723,0.399171,-0.269552,0.031613,1.486024,1.454411,1.6,12.1,10.5,0.159141,2.46465,2.305509,0.046462,6.739223,6.692761,2.19922,3.449752,1.250532,32.96099,16.93814,-16.02285,0.581438,0.739933,0.158495,0.012618,0.004332,-0.008286,2.373257,5.059541,2.686284,20.618289,2.696318,-17.921971,0.533154,3.638869,3.105715,34.697165,0.838748,-33.858417,0,0,0,0.058076,0.050476,-0.00760000000000002,0.379469,0.217228,-0.162241,0,0.015874,0.015874,508.806588,305.641878,-203.16471,20.901743,21.455917,0.554174000000003,19.267835,1.637708,-17.630127,2.366592,1.978534,-0.388058,15.865513,1.037314,-14.828199,2.936637,2.059028,-0.877609,10.502459,2.565419,-7.93704,27.619802,0.013634,-27.606168,0,38.244829,38.244829,,,
2005-10-01,12514.837982,2956.2,-9558.637982,27799.9,15838.5,-11961.4,148676,76236.2,-72439.8,10317.934147,0,-10317.934147,13772.39617,6838.9,-6933.49617,23670,19174,-4496,9094.304949,7500.597641,-1593.707308,10665.079289,6111.747892,-4553.331397,43445.318112,29688.045258,-13757.272854,32116.869302,17846.616849,-14270.252453,6612.62819,1320.461963,-5292.166227,51934.619898,19701.65035,-32232.969548,156162,79147.116402,-77014.883598,62413.127369,22495.821406,-39917.305963,1389.784237,1447.718184,57.933947,907.996625,1624.886148,716.889523,4994.824106,886.119177,-4108.704929,0.670442,0.181959,-0.488483,27725.016027,18746.501671,-8978.514356,0.057996,0.059454,0.00145800000000001,15720.302085,10941.543587,-4778.758498,195.839497,242.63452,46.795023,8.660962,24.849592,16.18863,151.875854,165.751033,13.875179,307.737755,294.544945,-13.19281,90.413105,55.59833,-34.814775,277.095273,308.123346,31.028073,32.808286,206.148617,173.340331,7.151368,37.403304,30.251936,55.604312,132.036507,76.432195,0,28.066527,28.066527,36.899865,153.596703,116.696838,0.949931,20.880294,19.930363,34.533668,57.220295,22.686627,38.201099,59.958087,21.756988,366.822753,381.06601,14.243257,0.176388,2.701955,2.525567,1.008378,7.375769,6.367391,4.516089,10.284998,5.768909,0.423259,9.464954,9.041695,0.027602,0.350552,0.32295,0.434344,4.147547,3.713203,3.204791,12.63463,9.429839,0.258998,3.356048,3.09705,0.476977,6.036335,5.559358,2.425444,36.423676,33.998232,843.417626,121.952717,-721.464909,109.081793,81.240696,-27.841097,,,,,,,344.483933,57.66117,-286.822763,0.031387,6.527649,6.496262,18.944261,4.277973,-14.666288,684.488449,455.784472,-228.703977,2797.517214,566.989853,-2230.527361,6.884048,15.521033,8.636985,17.444112,18.488453,1.044341,0.023177,0.396148,0.372971,562.917638,161.360128,-401.55751,427.635624,178.700893,-248.934731,26.091293,14.107769,-11.983524,536.919951,383.37564,-153.544311,2219.468751,1308.006128,-911.462623,3.441331,72.40114,68.959809,74.09524,30.84189,-43.25335,372.350015,370.614054,-1.73596099999997,2.297448,2.845512,0.548064,18.352955,35.144179,16.791224,1193.814366,333.759095,-860.055271,0.007283,0.215148,0.207865,664.002722,179.545036,-484.457686,380.545475,203.770915,-176.77456,0.228662,0.09691,-0.131752,545.794903,193.144734,-352.650169,4913.754592,3332.461582,-1581.29301,2598.185779,744.320882,-1853.864897,1518.114075,2385.171999,867.057924000001,1185.586784,1557.252434,371.66565,30.207374,46.924895,16.717521,0.004492,0.731047,0.726555,10.896443,0.188433,-10.70801,2800.090898,1857.631024,-942.459874,7538.757392,2859.362023,-4679.395369,515.056618,227.498991,-287.557627,,,,190.921579,88.613238,-102.308341,105.54036,12.25984,-93.28052,175.093226,84.192831,-90.900395,21.09753,1.35911,-19.73842,1150.321666,876.810921,-273.510745,43.153169,13.777026,-29.376143,26.045733,16.893795,-9.151938,104.297658,42.038599,-62.259059,161.426519,108.318188,-53.108331,,,,1337.793911,356.360458,-981.433453,29.011951,2.659276,-26.352675,108.242911,48.09238,-60.150531,5.377234,5.974063,0.596829,3.080542,16.476327,13.395785,13.157932,22.108173,8.95024099999999,181.99295,23.402642,-158.590308,0.469578,7.6428,7.173222,5.049296,6.000417,0.951121000000001,0,4.05789,4.05789,11.922445,7.870264,-4.052181,3.530444,6.803715,3.273271,693.586041,566.680201,-126.90584,193.769902,86.304643,-107.465259,0.057004,2.326591,2.269587,21.826397,17.695728,-4.130669,0.014299,0.074805,0.060506,0.076044,1.631347,1.555303,2754.340227,957.15924,-1797.180987,,,,37.586811,11.1927,-26.394111,32.792612,15.660711,-17.131901,55.698868,1.471921,-54.226947,4.201707,1.896255,-2.305452,5.52391,6.040429,0.516518999999999,,,,,,,,,,1.180388,2.76157,1.581182,74.962461,79.297731,4.33526999999998,135.806677,42.889148,-92.917529,48.147616,14.204379,-33.943237,464.123308,322.116195,-142.007113,2.247583,8.281975,6.034392,15.758307,11.0031,-4.75520700000001,11.74162,46.767969,35.026349,994.579613,129.825867,-864.753746,18.403477,7.754084,-10.649393,279,432.4,153.4,0.054534,0,-0.054534,0.129562,0.020274,-0.109288,117.404486,72.551854,-44.852632,625.807272,218.682428,-407.124844,,,,2611.35819,723.642305,-1887.715885,40.308099,102.096884,61.788785,223.864201,706.64178,482.777579,62.338057,21.526691,-40.811366,71.723169,55.781701,-15.941468,60.628614,29.291421,-31.337193,4.010919,34.036823,30.025904,1929.232124,678.900276,-1250.331848,313.653775,131.665081,-181.988694,9.689208,1.934377,-7.754831,247.701188,20.022953,-227.678235,180.526171,14.825365,-165.700806,0,0.205875,0.205875,1832.090016,623.249026,-1208.84099,637.47318,63.991996,-573.481184,0.743588,0.319186,-0.424402,163.250671,8.886987,-154.363684,3246.50925,1012.561672,-2233.947578,1312.691281,1933.358436,620.667155000001,1135.213138,238.567194,-896.645944,0,0.444291,0.444291,15.528981,5.192115,-10.336866,858.721575,614.625791,-244.095784,149.726192,11.282512,-138.44368,0.006515,0.025847,0.019332,0.034042,0.587393,0.553351,24382.852726,3899.151496,-20483.70123,16.919079,0.893806,-16.025273,0,1.603274,1.603274,3727.039932,2522.217357,-1204.822575,1027.864525,1312.556354,284.691829,3026.709211,1732.465494,-1294.243717,12173.324398,4828.848944,-7344.475454,607.879363,1265.607131,657.727768,0.005,0.017846,0.012846,0.012359,0.058305,0.045946,0.055773,0.271063,0.21529,0,0.023666,0.023666,11.742337,5.201555,-6.540782,258.816989,320.014299,61.19731,0.036165,0.229134,0.192969,0.237978,2.853766,2.615788,0,0.076384,0.076384,0.673594,1.450044,0.77645,0.110747,0.209987,0.09924,0.146424,1.464678,1.318254,0.00751,0.130488,0.122978,0.105614,0.149398,0.043784,0,0.02805,0.02805,0.210733,5.002071,4.791338,0,0.000266,0.000266,5.228345,11.567455,6.33911,2.180878,1.515476,-0.665402,0.007821,3.162409,3.154588,0.060625,0.884539,0.823914,0.007234,0.098192,0.090958,19.926986,3.75954,-16.167446,0.510447,1.108742,0.598295,27.574582,44.81387,17.239288,1200.430682,56.048842,-1144.38184,7.183474,19.452225,12.268751,467.625458,74.947341,-392.678117,236.641621,303.320138,66.6785170000001,1.004355,11.399489,10.395134,,,,0,0,0,141.656229,14.380268,-127.275961,0.072195,3.937209,3.865014,6.263947,6.933992,0.670045,0.196141,11.55085,11.354709,0.178617,2.902732,2.724115,14.683426,8.341461,-6.341965,0.43843,6.811555,6.373125,149.460909,9.000609,-140.4603,10.353688,25.988457,15.634769,0.015646,1.504106,1.48846,0.137896,5.82862,5.690724,0.108525,3.185751,3.077226,2433.839566,195.808707,-2238.030859,0.002098,1.207239,1.205141,274.313261,9.252359,-265.060902,165.204916,3.106124,-162.098792,0.161254,0.273797,0.112543,0.059091,0.519692,0.460601,0,4.70656,4.70656,860.079082,73.560988,-786.518094,196.665325,12.936727,-183.728598,0,0.051182,0.051182,0.094932,0.814833,0.719901,0.010588,0.031993,0.021405,1.854508,6.59948,4.744972,4.657472,6.227768,1.570296,0.142002,0.314717,0.172715,1.843784,0.971286,-0.872498,0.000319,0.359551,0.359232,1.9,13.3,11.4,0.241448,0.354056,0.112608,0.0442,3.128418,3.084218,2.736771,6.221041,3.48427,26.047255,13.812313,-12.234942,0.696989,0.874507,0.177518,0.076908,0.051721,-0.025187,3.74819,11.016146,7.267956,17.149509,4.455776,-12.693733,5.721945,6.673434,0.951488999999999,30.659376,3.901442,-26.757934,0,0.003621,0.003621,0.094547,0.022433,-0.072114,0.002615,0.190014,0.187399,0,0.012761,0.012761,539.947175,349.01491,-190.932265,9.73775,10.870277,1.132527,21.400248,2.935411,-18.464837,3.008491,3.430505,0.422014,13.015183,0.72939,-12.285793,5.728604,4.161072,-1.567532,17.058425,1.810403,-15.248022,26.349427,0.089265,-26.260162,0,59.295473,59.295473,,,
2005-11-01,11657.27676,3035.3,-8621.97676,27795.4,15978.8,-11816.6,146650,77744.5,-68905.5,10061.829105,0,-10061.829105,13608.78709,6559.4,-7049.38709,23841,18796,-5045,9086.415779,6562.016048,-2524.399731,10663.808793,6371.343324,-4292.465469,41881.850012,29356.754618,-12525.095394,31524.43034,18201.801963,-13322.628377,6376.762256,1380.520315,-4996.241941,49204.656048,18417.833162,-30786.822886,150245,78240.954488,-72004.045512,58894.253593,21174.740843,-37719.51275,1598.692201,1549.449971,-49.2422299999998,903.065006,1722.210449,819.145443,4986.539458,889.488288,-4097.05117,1.102855,0.141029,-0.961826,26382.724787,18417.32224,-7965.40254699999,0,0.005488,0.005488,15499.125225,10939.432378,-4559.692847,229.908193,281.598578,51.690385,7.594238,20.98106,13.386822,171.86623,156.779247,-15.086983,344.913235,287.337051,-57.576184,115.103366,50.847514,-64.255852,324.890071,336.7291,11.8390290000001,27.033614,188.419498,161.385884,1.179362,32.694259,31.514897,32.880718,182.036685,149.155967,0,34.194468,34.194468,37.725632,154.194682,116.46905,1.057792,23.359348,22.301556,1.824303,53.047894,51.223591,40.987088,70.902141,29.915053,412.011106,436.158481,24.147375,0.567008,2.936735,2.369727,0.349386,14.110604,13.761218,4.656452,8.453415,3.796963,0.196981,14.083851,13.88687,0.009744,0.361395,0.351651,0.258251,9.210023,8.951772,0.973436,17.314789,16.341353,0.209276,3.579736,3.37046,0.330441,6.007792,5.677351,2.611162,43.089753,40.478591,780.518956,107.276318,-673.242638,45.920756,105.310704,59.389948,,,,,,,275.977771,99.273569,-176.704202,0.120815,4.959233,4.838418,1.70224,1.828788,0.126548,941.040469,467.849514,-473.190955,2624.858827,563.21952,-2061.639307,10.490333,15.618103,5.12777,20.836259,24.875993,4.03973400000001,0,0.522942,0.522942,468.505494,155.058523,-313.446971,547.856049,179.604276,-368.251773,18.222384,13.45385,-4.76853400000001,624.979773,505.987733,-118.99204,1982.344505,1282.053388,-700.291117,5.942547,50.839975,44.897428,62.404593,32.527415,-29.877178,492.891381,330.669265,-162.222116,0.058556,1.986116,1.92756,35.213758,26.017277,-9.196481,1085.032683,285.590979,-799.441704,0,0.154452,0.154452,571.544361,179.285527,-392.258834,359.896653,232.611769,-127.284884,0.302803,0.133187,-0.169616,485.598206,151.726189,-333.872017,4969.084054,3101.598879,-1867.485175,2229.403254,703.259684,-1526.14357,1488.687747,2154.641741,665.953994,1173.718492,1633.020317,459.301825,34.410317,234.716786,200.306469,0.069941,1.123296,1.053355,2.737155,2.031344,-0.705811,3017.770345,2013.645556,-1004.124789,7564.442772,3092.58903,-4471.853742,645.816581,244.667918,-401.148663,,,,209.958324,77.837443,-132.120881,59.781395,11.17036,-48.611035,211.45802,92.076617,-119.381403,26.97822,1.188778,-25.789442,1167.73147,971.967272,-195.764198,36.819947,10.171015,-26.648932,110.097168,14.736482,-95.360686,62.950029,36.580592,-26.369437,168.25657,117.885894,-50.370676,,,,1035.916447,403.718757,-632.19769,26.659948,2.709677,-23.950271,92.93767,34.145296,-58.792374,5.363682,5.139092,-0.22459,3.154901,10.925791,7.77089,39.415462,22.570764,-16.844698,105.264658,97.392454,-7.87220400000002,0.117838,1.070312,0.952474,3.539284,1.632643,-1.906641,0.183738,0.588137,0.404399,4.869849,4.205233,-0.664616000000001,4.052231,2.144962,-1.907269,869.093107,546.835356,-322.257751,193.432861,106.81506,-86.617801,0.140917,1.20199,1.061073,24.89522,12.847076,-12.048144,0.256962,0.907317,0.650355,0,2.449516,2.449516,2687.911795,994.01604,-1693.895755,,,,39.96555,6.200456,-33.765094,31.359384,18.317569,-13.041815,1.583351,1.864178,0.280826999999999,3.270334,0.8173,-2.453034,4.852476,13.951029,9.098553,,,,,,,,,,0.995356,0.533989,-0.461367,71.988776,85.924193,13.935417,103.068665,60.31479,-42.753875,38.163237,18.272487,-19.89075,410.657517,348.347675,-62.3098419999999,3.558859,5.51444,1.955581,2.796692,8.634335,5.837643,9.595797,40.452092,30.856295,1003.39217,134.41886,-868.97331,14.464704,8.730674,-5.73403,377,319.6,-57.4,0.001,0,-0.001,0.20577,0,-0.20577,103.709876,51.716993,-51.992883,427.56387,192.485588,-235.078282,,,,2269.042138,628.332134,-1640.710004,112.28874,99.378571,-12.910169,167.482333,936.745706,769.263373,39.649459,7.776056,-31.873403,16.052564,110.998244,94.94568,39.747382,27.278549,-12.468833,4.655595,46.177507,41.521912,1661.558425,605.08862,-1056.469805,310.395011,103.265736,-207.129275,8.930043,3.2723,-5.657743,212.644243,18.885769,-193.758474,151.154933,18.428222,-132.726711,0,1.348568,1.348568,1734.934421,610.987574,-1123.946847,564.445443,69.175659,-495.269784,0.660221,1.969708,1.309487,149.638627,6.722138,-142.916489,2879.61932,893.580355,-1986.038965,1321.92402,1605.234404,283.310384,1020.256865,244.071319,-776.185546,0.084126,1.534029,1.449903,77.093979,4.514811,-72.579168,773.694386,631.287048,-142.407338,128.099987,9.843197,-118.25679,0.01135,0.003395,-0.007955,0.268391,0.504295,0.235904,22426.128316,3807.491572,-18618.636744,9.845565,1.087947,-8.757618,0,0,0,3901.323923,2015.57029,-1885.753633,813.253594,1299.08549,485.831896,3049.914242,1642.125864,-1407.788378,11945.905042,4568.460019,-7377.445023,641.944271,1334.075107,692.130836,0.00908,0.022288,0.013208,0.0216,0.00314,-0.01846,0.044934,0.015237,-0.029697,0.017784,0.000834,-0.01695,7.760796,2.272534,-5.488262,217.737307,360.221152,142.483845,0.024187,0.126839,0.102652,5.365403,2.546694,-2.818709,0.024775,0.072737,0.047962,0.67317,1.362484,0.689314,0.067991,0.215527,0.147536,0.283556,0.750156,0.4666,0.019209,0.137103,0.117894,0.142624,0.043211,-0.099413,0,0.001588,0.001588,2.185207,3.369982,1.184775,0.0117,0.059607,0.047907,7.660164,8.479545,0.819381,1.632875,1.810091,0.177216,0,2.396709,2.396709,0.018322,1.010843,0.992521,0,0.202477,0.202477,16.911493,2.022203,-14.88929,0.485438,1.134008,0.64857,28.540181,34.011356,5.471175,895.381843,89.340001,-806.041842,7.179945,22.186906,15.006961,123.355607,61.031869,-62.323738,282.240238,333.858764,51.618526,1.65,9.346903,7.696903,,,,0,0,0,181.049191,104.756844,-76.292347,0.12075,10.23732,10.11657,3.804031,13.297166,9.493135,0.176961,12.450346,12.273385,0.19365,2.328797,2.135147,5.83381,7.372386,1.538576,1.452826,1.908073,0.455247,66.158396,14.602963,-51.555433,15.382861,36.397087,21.014226,0.00578,1.996863,1.991083,0.102974,6.044311,5.941337,0.247856,2.181239,1.933383,2289.623687,128.348955,-2161.274732,0.104376,0.976414,0.872038,117.03296,5.700558,-111.332402,171.586219,7.217027,-164.369192,0.364381,1.105006,0.740625,0.007947,3.123007,3.11506,0.011429,8.796033,8.784604,1208.241013,53.729752,-1154.511261,243.076939,10.775499,-232.30144,0,0.253738,0.253738,0.024005,0.424097,0.400092,0.01718,0.243084,0.225904,9.376072,3.596496,-5.779576,3.432859,6.56025,3.127391,0.146393,0.712227,0.565834,0.120469,0.898019,0.77755,0.03952,0.065991,0.026471,3.6,10.4,6.8,0.017705,2.146484,2.128779,0.011739,0.842837,0.831098,0.979572,3.790191,2.810619,27.60419,10.744701,-16.859489,0.688256,0.95011,0.261854,0.084269,0.048847,-0.035422,2.488318,5.440637,2.952319,16.939837,3.276981,-13.662856,0.324523,7.654638,7.330115,25.213054,7.500168,-17.712886,0.008489,0.00006,-0.008429,0.022474,0.062049,0.039575,0,0.236214,0.236214,0,0.026492,0.026492,484.628456,301.728169,-182.900287,13.913238,5.186072,-8.727166,20.449681,7.589388,-12.860293,1.999872,4.646867,2.646995,18.226428,1.010762,-17.215666,6.384753,5.849842,-0.534911,9.792544,0.858721,-8.933823,34.809296,2.196194,-32.613102,0,33.436459,33.436459,,,
2005-12-01,11150.056526,3109,-8041.056526,26395.5,16298.2,-10097.3,149264,79809.2,-69454.8,9577.70589,0,-9577.70589,12746.079641,6160.8,-6585.279641,23461,20378,-3083,8774.467104,7660.610626,-1113.856478,10990.223865,6618.916957,-4371.306908,40615.266485,27930.299105,-12684.96738,30103.405256,18384.347835,-11719.057421,5911.199002,1262.977392,-4648.22161,46859.691166,20116.441235,-26743.249931,144262,79395.507019,-64866.492981,55729.360803,23551.800454,-32177.560349,1532.516874,1484.366687,-48.1501869999997,911.229053,1625.353854,714.124801,4565.508613,821.272935,-3744.235678,1.313609,0.124746,-1.188863,26188.580031,17699.617914,-8488.96211700001,0.086299,0.007566,-0.078733,14426.686454,10230.681191,-4196.005263,231.584652,295.507534,63.922882,5.783405,20.871856,15.088451,176.940386,150.868988,-26.071398,317.335042,271.335077,-45.9999649999999,106.555801,56.197942,-50.357859,305.957875,335.58601,29.628135,29.484675,211.838966,182.354291,0.733733,35.939899,35.206166,42.904213,148.458788,105.554575,0.005626,43.139532,43.133906,34.565002,147.556965,112.991963,1.492869,26.167104,24.674235,0.595804,60.107113,59.511309,35.022448,72.858729,37.836281,394.143118,374.871136,-19.2719820000002,0.204811,3.083548,2.878737,0.622434,12.219156,11.596722,3.727803,7.892636,4.164833,0.24437,13.715995,13.471625,0.539085,0.316304,-0.222781,0.27914,5.986102,5.706962,1.049717,12.65783,11.608113,0.085223,2.680836,2.595613,0.281997,8.698029,8.416032,2.983587,37.246026,34.262439,721.392534,131.007726,-590.384808,48.152479,125.588167,77.435688,,,,,,,266.277059,60.137286,-206.139773,0.114747,5.597027,5.48228,1.031926,3.688035,2.656109,821.459671,521.499139,-299.960532,2980.29573,613.395286,-2366.900444,12.256964,14.482731,2.225767,7.537666,21.961944,14.424278,0,0.367631,0.367631,575.781089,168.123386,-407.657703,501.376784,203.286965,-298.089819,16.535826,28.467676,11.93185,794.585007,384.709755,-409.875252,2163.559967,1527.707927,-635.85204,2.800014,65.053879,62.253865,50.599101,32.582399,-18.016702,333.125629,352.299459,19.17383,0.218856,3.158438,2.939582,28.243558,36.991237,8.74767899999999,1095.471888,327.536501,-767.935387,0.006228,0.188303,0.182075,517.302201,202.910337,-314.391864,361.810764,213.694579,-148.116185,0.296078,0.478965,0.182887,388.212875,160.014503,-228.198372,4254.691837,3148.489238,-1106.202599,2509.091541,830.236049,-1678.855492,1204.488865,2427.669416,1223.180551,1145.915945,1552.683511,406.767566,34.750036,61.89515,27.145114,0.070927,0.574547,0.50362,2.253751,1.088204,-1.165547,3022.976109,1976.544514,-1046.431595,7480.257945,3016.731628,-4463.526317,540.952615,213.961966,-326.990649,,,,184.460529,84.891972,-99.568557,84.332385,12.133652,-72.198733,169.413374,88.60333,-80.810044,27.080078,1.445768,-25.63431,1045.080184,918.511333,-126.568851,49.834152,8.208507,-41.625645,63.194517,17.730546,-45.463971,45.194724,31.06287,-14.131854,167.846542,118.314309,-49.532233,,,,1375.574737,290.485225,-1085.089512,21.032243,2.748456,-18.283787,85.579247,45.870852,-39.708395,2.943285,2.795878,-0.147406999999999,0.873324,11.193455,10.320131,10.880256,13.489207,2.608951,26.625562,51.233652,24.60809,0.329533,4.246432,3.916899,2.384068,3.003677,0.619609000000001,0,1.465386,1.465386,3.92362,1.899542,-2.024078,2.976722,3.465669,0.488947,771.609215,591.277054,-180.332161,178.455847,189.57074,11.114893,0.043346,1.284901,1.241555,27.003762,12.921486,-14.082276,0.300812,0.157841,-0.142971,0.069511,1.601719,1.532208,2506.233806,1097.886793,-1408.347013,,,,30.738112,11.131841,-19.606271,30.020784,23.075631,-6.94515299999999,1.33402,1.187848,-0.146172,1.673458,1.836138,0.16268,3.957335,10.115915,6.15858,,,,,,,,,,1.065351,0.566904,-0.498447,76.34855,84.317676,7.96912600000002,96.190155,49.966575,-46.22358,42.659211,18.009705,-24.649506,376.39052,396.211091,19.820571,2.959216,8.739611,5.780395,4.042486,1.154805,-2.887681,5.142089,46.646197,41.504108,472.228633,100.009209,-372.219424,17.137442,10.276396,-6.861046,328.1,373.8,45.7,0.066418,0,-0.066418,0.066825,0.007918,-0.058907,103.40163,63.026245,-40.375385,407.917723,182.682034,-225.235689,,,,2381.675486,777.732204,-1603.943282,53.939223,94.434156,40.494933,105.17096,836.932926,731.761966,0.641976,19.100821,18.458845,95.118163,50.275735,-44.842428,36.307652,30.984168,-5.323484,4.213789,25.752684,21.538895,1540.415444,745.731762,-794.683682,247.876907,148.253068,-99.623839,6.652968,2.085574,-4.567394,225.543409,23.186106,-202.357303,170.044231,17.136637,-152.907594,0,0.180142,0.180142,1712.880126,553.948991,-1158.931135,563.188829,247.949926,-315.238903,0.266434,0.144748,-0.121686,172.273094,5.587122,-166.685972,3102.518719,932.773785,-2169.744934,1399.022688,1712.718202,313.695514,929.475885,252.468487,-677.007398,0.000837,0.525102,0.524265,55.282333,5.564654,-49.717679,778.919171,637.423484,-141.495687,129.02252,8.72402,-120.2985,0,0.08783,0.08783,0.104913,0.893557,0.788644,20485.952995,4169.750104,-16316.202891,11.442096,6.086218,-5.355878,0,0,0,3696.587371,2627.649063,-1068.938308,715.864734,1424.821822,708.957088,2962.992311,1895.421539,-1067.570772,11714.952724,4904.042844,-6810.90988,595.962297,1344.240041,748.277744,0.030529,0.037877,0.007348,0.017151,0.025849,0.008698,0.030015,0.046716,0.016701,0,0.114676,0.114676,8.348601,5.822144,-2.526457,284.788817,195.021046,-89.767771,0.189204,0.058239,-0.130965,0.910136,6.804783,5.894647,0.015586,0.157258,0.141672,0.70943,0.905839,0.196409,0.369049,0.561592,0.192543,0.449877,0.774469,0.324592,0.003368,0.32153,0.318162,0.091084,0.047284,-0.0438,0,0,0,1.818381,3.795817,1.977436,0.0336,0.028374,-0.00522599999999999,3.915519,8.157762,4.242243,0.957113,53.763744,52.806631,0.009043,1.501356,1.492313,0,1.173433,1.173433,0,0.338359,0.338359,12.101869,1.500681,-10.601188,0.459854,0.598339,0.138485,38.66661,28.391319,-10.275291,917.017329,99.812746,-817.204583,39.984316,38.567994,-1.416322,162.383442,71.293933,-91.089509,207.197153,266.663555,59.466402,0.945,22.094535,21.149535,,,,0,0,0,64.783162,8.908798,-55.874364,0.051124,9.149256,9.098132,4.435762,10.270806,5.835044,0.302358,7.256077,6.953719,0.206711,1.83415,1.627439,3.740788,9.327421,5.586633,0.266637,3.117696,2.851059,162.988865,15.880671,-147.108194,14.136909,22.34192,8.205011,0.003514,2.108571,2.105057,0.044209,6.150415,6.106206,0.01788,1.972571,1.954691,2384.873716,134.130994,-2250.742722,0.281494,0.796032,0.514538,222.057182,8.917568,-213.139614,95.945149,8.012204,-87.932945,0.060173,0.103204,0.043031,0.125723,1.981854,1.856131,0.021831,4.446057,4.424226,711.32607,94.194417,-617.131653,168.365266,6.836289,-161.528977,0,0.054167,0.054167,0.031248,0.190078,0.15883,0.00304,0.244955,0.241915,11.406971,4.229532,-7.177439,2.90276,6.574685,3.671925,0.157631,0.800444,0.642813,0.18441,0.866798,0.682388,0.012339,1.105608,1.093269,1.9,15.6,13.7,0.101555,0.306688,0.205133,0.019409,0.713983,0.694574,2.184125,7.099597,4.915472,31.478073,10.146015,-21.332058,0.79754,0.443562,-0.353978,0.041966,0.11763,0.075664,2.417472,6.556654,4.139182,15.676234,3.276736,-12.399498,0.157696,8.45062,8.292924,22.388687,1.337554,-21.051133,0,0,0,0.015174,0.001024,-0.01415,0.002777,0.849665,0.846888,0.02694,0.033855,0.00691500000000001,557.159989,303.717912,-253.442077,4.951872,5.337243,0.385370999999999,11.962461,7.150817,-4.811644,1.555004,3.834223,2.279219,12.476958,1.271405,-11.205553,7.074422,4.751975,-2.322447,9.76975,1.796292,-7.973458,34.153253,0.717977,-33.435276,0,21.67911,21.67911,,,
2006-01-01,11492.365738,2472.6,-9019.765738,24878.4,15035.4,-9843,152919,80555,-72364,9741.014636,0,-9741.014636,12991.128055,5933.9,-7057.228055,21652,17877,-3775,9135.491363,6912.141521,-2223.349842,11041.650944,6444.24917,-4597.401774,41193.766796,27744.981461,-13448.785335,28733.797851,16916.408683,-11817.389168,6025.331248,1224.018027,-4801.313221,47223.672782,18240.406337,-28983.266445,144562,74338.315685,-70223.684315,56604.02998,20209.520429,-36394.509551,1241.88131,1453.856875,211.975565,961.481547,1799.10892,837.627373,4759.316168,782.10477,-3977.211398,1.509937,0.024105,-1.485832,25965.868063,17261.09118,-8704.776883,0.066493,0.00489,-0.061603,15227.898733,10483.890281,-4744.008452,215.074969,253.914806,38.839837,4.656801,25.229671,20.57287,122.112822,164.639323,42.526501,255.995349,283.629122,27.6337729999999,109.8432,53.755189,-56.088011,265.07986,316.205281,51.1254210000001,20.511786,188.254355,167.742569,0.822483,37.097774,36.275291,41.590853,181.599726,140.008873,0,29.207667,29.207667,29.831828,137.512562,107.680734,0.644276,28.818724,28.174448,1.561504,54.335221,52.773717,23.111432,66.634064,43.522632,273.77511,381.713154,107.938044,0.028952,2.368869,2.339917,7.048673,8.994777,1.946104,3.077059,10.391426,7.314367,0.461054,23.781045,23.319991,0.287877,0.470086,0.182209,0.917433,3.041701,2.124268,15.72255,7.51326,-8.20929,0.033785,4.130131,4.096346,0.339449,4.468239,4.12879,2.844502,30.396579,27.552077,814.050211,111.794664,-702.255547,127.320345,111.328128,-15.992217,,,,,,,301.731745,65.04133,-236.690415,0.317389,4.290494,3.973105,0.26764,1.792726,1.525086,778.214229,460.557714,-317.656515,3140.60155,591.23791,-2549.36364,13.974754,12.0187,-1.956054,11.528806,20.551676,9.02287,0.224499,2.936526,2.712027,655.142581,205.580619,-449.561962,481.0925,234.388953,-246.703547,42.014073,15.946502,-26.067571,843.349493,477.942859,-365.406634,2006.435172,1386.609651,-619.825521,3.600883,68.504859,64.903976,55.332073,32.528866,-22.803207,370.614699,342.806958,-27.807741,0.464695,0.287283,-0.177412,22.184682,34.325678,12.140996,1021.123974,302.394569,-718.729405,0,0.14868,0.14868,578.237713,170.618569,-407.619144,365.329926,163.302283,-202.027643,0.243114,0.094171,-0.148943,323.935559,170.012629,-153.92293,3824.179584,3151.859382,-672.320202,2225.236391,651.282691,-1573.9537,1434.220221,2178.962015,744.741794,1007.484577,1491.546238,484.061661,106.321289,37.506708,-68.814581,0.023978,0.61789,0.593912,1.691582,0.32087,-1.370712,2882.794488,1959.509424,-923.285064,6610.821368,2658.729344,-3952.092024,544.498671,210.273546,-334.225125,,,,177.77469,75.901271,-101.873419,70.96956,10.019573,-60.949987,329.987965,81.240458,-248.747507,39.730293,1.256656,-38.473637,1035.437717,837.903358,-197.534359,69.119937,9.399501,-59.720436,114.933052,17.967783,-96.965269,23.839832,29.681199,5.841367,201.285147,106.067708,-95.217439,,,,1303.973385,301.134766,-1002.838619,42.497602,7.49669,-35.000912,89.013311,36.07279,-52.940521,2.750472,4.569888,1.819416,1.989584,17.495283,15.505699,5.108866,13.480375,8.371509,99.728961,49.721478,-50.007483,0.803586,2.161896,1.35831,3.024699,4.055221,1.030522,0,4.814127,4.814127,9.788418,1.037527,-8.750891,2.247937,3.620939,1.373002,647.238294,535.956272,-111.282022,196.582922,73.142982,-123.43994,0.095041,1.15631,1.061269,24.040913,14.947644,-9.093269,0.520627,0.141183,-0.379444,0.158338,0.666832,0.508494,2566.768501,972.482804,-1594.285697,,,,33.920194,11.236006,-22.684188,33.081262,22.246392,-10.83487,1.171066,1.240036,0.0689700000000002,6.461982,0.967254,-5.494728,8.134202,9.87898,1.744778,,,,,,,,,,12.951151,0.520691,-12.43046,74.31579,103.056289,28.740499,87.863735,35.632982,-52.230753,43.906092,10.643222,-33.26287,421.764592,318.000435,-103.764157,2.491018,7.889195,5.398177,27.855879,18.464451,-9.391428,6.263355,60.822643,54.559288,732.941068,130.630891,-602.310177,16.467092,8.802006,-7.665086,385.5,404.6,19.1,0.04514,0,-0.04514,0.072874,0.043725,-0.029149,100.877891,55.156876,-45.721015,152.203983,157.117947,4.91396399999996,,,,2344.153492,463.776514,-1880.376978,72.904187,48.966338,-23.937849,125.566661,623.388856,497.822195,105.108004,19.66988,-85.438124,6.091753,25.299707,19.207954,51.865937,22.735304,-29.130633,5.984125,20.047556,14.063431,1857.570292,596.405335,-1261.164957,292.210758,80.854159,-211.356599,7.502757,2.618263,-4.884494,272.361314,22.190553,-250.170761,203.10792,11.147298,-191.960622,0,1.17163,1.17163,1657.934661,582.097194,-1075.837467,630.128227,57.399662,-572.728565,0.580507,0.148824,-0.431683,189.320488,5.64359,-183.676898,2818.163634,882.610296,-1935.553338,1307.33375,1623.818577,316.484827,1071.640952,231.634053,-840.006899,0.009911,0.558323,0.548412,12.97877,4.563737,-8.415033,795.590142,664.614274,-130.975868,148.786436,9.491528,-139.294908,0.022032,0.011744,-0.010288,0.123205,0.446246,0.323041,21382.505907,3396.870149,-17985.635758,11.260373,1.24205,-10.018323,0,0,0,3890.926855,2506.040776,-1384.886079,755.260869,1201.739298,446.478429,3181.969889,1580.54287,-1601.427019,10913.250856,4364.856612,-6548.394244,657.161553,1464.830151,807.668598,0.000455,0.153262,0.152807,0.017732,0.016316,-0.001416,0.064824,0.036338,-0.028486,0.010604,0.088402,0.077798,3.159496,2.417318,-0.742178,284.943673,306.376698,21.433025,0.038178,0.160632,0.122454,0.700404,4.452488,3.752084,0,0.05135,0.05135,0.353374,0.992187,0.638813,0.070788,0.367875,0.297087,0.065569,1.132355,1.066786,0,0.043365,0.043365,0.073166,0.028182,-0.044984,0.003608,0.002938,-0.000669999999999999,0.888713,1.850116,0.961403,0.000301,0.001415,0.001114,4.270386,8.216972,3.946586,1.343627,1.34443,0.000803000000000109,0.031273,1.457953,1.42668,0.017242,0.785061,0.767819,0.011161,0.394507,0.383346,7.621074,2.004289,-5.616785,0.621132,2.035526,1.414394,38.729082,40.542039,1.812957,870.19649,63.415173,-806.781317,28.772472,27.287624,-1.484848,107.060045,36.302905,-70.75714,225.173391,295.264767,70.0913760000001,1.382,5.252083,3.870083,,,,0,0,0,203.517275,56.914587,-146.602688,0.00871,2.369279,2.360569,9.110398,5.767866,-3.342532,0.944463,6.745659,5.801196,0.150081,1.352707,1.202626,6.120709,5.824233,-0.296475999999998,1.063121,2.041031,0.97791,102.265211,7.474836,-94.790375,20.473667,27.847522,7.373855,0,1.603926,1.603926,0.026749,7.732883,7.706134,0.081173,2.842482,2.761309,2543.317125,138.965982,-2404.351143,0.865562,3.446687,2.581125,114.002425,7.101339,-106.901086,107.146853,1.924299,-105.222554,0.14618,0.024321,-0.121859,0.029051,3.748985,3.719934,0.00229,3.703568,3.701278,736.720546,65.461945,-671.258601,199.669075,5.506908,-194.162167,0.25,0.050647,-0.199353,0.035722,0.070737,0.035015,0,0.014122,0.014122,9.510414,4.127567,-5.382847,2.192128,5.29158,3.099452,0.303796,0.680953,0.377157,0.535709,1.085953,0.550244,0.17613,2.041045,1.864915,1,3.8,2.8,0.003825,0.24367,0.239845,0.25,5.081517,4.831517,2.127568,3.975417,1.847849,29.050609,19.018104,-10.032505,0.774333,0.434355,-0.339978,0,0.026528,0.026528,3.492903,6.665885,3.172982,18.470164,4.153204,-14.31696,0.098534,3.365092,3.266558,24.01794,5.189761,-18.828179,0,0,0,0.124048,0,-0.124048,0.846502,0.618883,-0.227619,0,0.02266,0.02266,531.154005,307.308722,-223.845283,4.275267,10.108503,5.833236,27.832364,1.68814,-26.144224,1.701595,5.047972,3.346377,10.100031,2.645116,-7.454915,7.977518,8.103453,0.125935000000002,7.316349,13.224442,5.908093,27.640668,1.047237,-26.593431,0,0,0,,,
2006-02-01,11045.84404,2979.7,-8066.14404,24114,15966.5,-8147.5,148596,81535,-67061,9217.378055,0,-9217.378055,12553.153715,6321.4,-6231.753715,19798,17921,-1877,7907.687157,6775.513335,-1132.173822,10068.461296,6201.958481,-3866.502815,38570.159409,27962.156755,-10608.002654,28113.100618,18413.524493,-9699.576125,5886.711604,1217.849917,-4668.861687,42358.897644,18480.825601,-23878.072043,134702,76935.197688,-57766.802312,51367.727197,21601.96002,-29765.767177,1481.759432,1445.119082,-36.6403500000001,695.482795,1537.637127,842.154332,4685.023793,841.186728,-3843.837065,0.589338,0.085508,-0.50383,23750.043408,17930.940713,-5819.102695,0.0125,0.025387,0.012887,14820.116001,10031.216042,-4788.899959,228.297514,283.005363,54.707849,10.228572,20.297902,10.06933,158.051339,148.805373,-9.24596600000004,303.633354,253.601425,-50.031929,149.12863,54.68386,-94.4447699999999,292.579892,316.806291,24.226399,23.025775,197.852489,174.826714,0.442073,72.486942,72.044869,63.961301,151.025704,87.064403,0,31.983527,31.983527,45.201358,159.761191,114.559833,0.528826,26.015437,25.486611,1.255617,48.009197,46.75358,31.535959,65.784435,34.248476,350.068703,388.21677,38.1480669999999,0.526593,2.233425,1.706832,1.470393,24.850919,23.380526,4.168277,34.574414,30.406137,0.763567,14.732199,13.968632,0.004469,0.333756,0.329287,0.412841,3.137943,2.725102,1.903602,7.165496,5.261894,0.108727,3.897838,3.789111,0.318847,4.85955,4.540703,3.081858,35.368575,32.286717,621.77159,96.087175,-525.684415,97.031939,135.282993,38.251054,,,,,,,142.735376,56.70871,-86.026666,0.05815,2.506282,2.448132,0.049358,1.290242,1.240884,710.335084,461.598336,-248.736748,2888.031946,632.697587,-2255.334359,7.213487,13.541765,6.328278,9.237257,21.648514,12.411257,0.000723,0.737361,0.736638,477.279222,172.270699,-305.008523,457.295947,223.471957,-233.82399,20.382811,17.965247,-2.417564,739.287795,365.204711,-374.083084,1857.874777,1259.761698,-598.113079,2.555133,63.846348,61.291215,47.670962,27.833019,-19.837943,318.646059,299.996401,-18.6496579999999,0.305593,0.019415,-0.286178,19.103639,24.267485,5.163846,1182.924557,307.6638,-875.260757,0,0.249552,0.249552,588.448375,193.787774,-394.660601,309.38825,171.258206,-138.130044,0.368304,0.271988,-0.096316,310.505175,141.369333,-169.135842,3816.441037,3434.45981,-381.981227000001,2012.50332,634.71225,-1377.79107,1125.91603,2297.136991,1171.220961,1165.050926,1551.286957,386.236031000001,41.27101,38.718978,-2.552032,0.010353,1.074096,1.063743,1.445687,0.439866,-1.005821,2838.029639,1813.738382,-1024.291257,6879.670985,3157.254399,-3722.416586,466.14615,216.406376,-249.739774,,,,159.124995,81.401889,-77.7231060000001,44.163221,16.107273,-28.055948,178.006531,84.757618,-93.248913,22.138956,1.347744,-20.791212,1030.030534,1167.019784,136.98925,40.778632,16.074939,-24.703693,8.964095,14.837486,5.873391,98.569548,26.050866,-72.518682,153.203,115.340736,-37.862264,,,,1326.241603,343.121064,-983.120539,28.817995,2.50122,-26.316775,122.252666,74.892562,-47.360104,3.497659,3.53008,0.0324209999999998,0.510254,11.768858,11.258604,11.317398,14.829964,3.512566,139.684761,73.767356,-65.917405,0.656211,3.24787,2.591659,3.316786,2.616332,-0.700453999999999,60.311514,1.23168,-59.079834,2.76996,30.047187,27.277227,1.269924,3.367032,2.097108,713.898838,623.447041,-90.4517969999999,169.992886,81.874807,-88.118079,0.061172,2.264089,2.202917,22.953807,13.831481,-9.122326,0.24473,0.389976,0.145246,0.011088,0.670649,0.659561,2289.077762,1011.143257,-1277.934505,,,,34.567895,11.198823,-23.369072,27.710059,12.763849,-14.94621,0.673419,2.212372,1.538953,9.611696,0.686792,-8.924904,4.226248,8.9555,4.729252,,,,,,,,,,1.379869,1.158539,-0.22133,57.403643,98.376998,40.973355,118.391603,61.637569,-56.754034,42.890848,15.982946,-26.907902,424.829893,388.454617,-36.3752760000001,2.325482,6.519405,4.193923,1.875982,13.930606,12.054624,13.199717,73.475957,60.27624,757.998295,144.528196,-613.470099,18.863742,7.186604,-11.677138,335.2,332.4,-2.80000000000001,0.12682,0,-0.12682,0.08841,0.012,-0.07641,103.549363,43.102673,-60.44669,259.300529,134.252723,-125.047806,,,,2313.668655,527.352855,-1786.3158,23.68339,81.245473,57.562083,97.380373,1018.534028,921.153655,0.621276,15.176827,14.555551,66.424918,34.195929,-32.228989,31.153018,35.504645,4.351627,5.978512,55.934543,49.956031,1565.396762,691.696313,-873.700449,250.785279,217.756513,-33.028766,7.417895,0.801029,-6.616866,217.254028,25.02105,-192.232978,164.828397,15.390924,-149.437473,0.006813,0.755395,0.748582,1562.85722,496.070967,-1066.786253,585.476656,61.737002,-523.739654,1.315103,0.404056,-0.911047,158.86909,5.34197,-153.52712,2464.911702,870.751203,-1594.160499,1239.040607,1697.435164,458.394557000001,948.459683,223.902743,-724.55694,0,0.587716,0.587716,53.917968,3.517172,-50.400796,711.870698,585.906855,-125.963843,103.429326,16.037164,-87.392162,0.136708,0.05449,-0.082218,0.068898,1.493018,1.42412,17905.353467,4072.245086,-13833.108381,9.735836,0.864703,-8.871133,0,0,0,3559.597641,2344.367414,-1215.230227,553.851542,1195.021689,641.170147,2555.197367,1538.689068,-1016.508299,11585.77085,4418.889478,-7166.881372,465.540756,1198.184867,732.644111,0,0.094895,0.094895,0.02184,0.026796,0.004956,0.15666,0.205561,0.048901,0,0.494605,0.494605,2.359762,1.650499,-0.709263,209.596275,314.227199,104.630924,0.020627,0.084601,0.063974,0.56231,4.850942,4.288632,0,0.011398,0.011398,0.390306,0.800288,0.409982,0.070062,0.237255,0.167193,0.421289,0.913513,0.492224,0.0028,0.276125,0.273325,0.071587,0.139318,0.067731,0,0.000166,0.000166,4.301678,1.448335,-2.853343,0,0.025,0.025,1.612838,7.622767,6.009929,0.880854,1.239088,0.358234,0.050863,1.32452,1.273657,0.082081,1.078133,0.996052,0.003492,0.47191,0.468418,8.701379,2.056725,-6.644654,0.631939,0.741898,0.109959,30.483167,54.592529,24.109362,876.379723,71.547818,-804.831905,22.078901,35.071652,12.992751,107.071912,48.518258,-58.553654,139.962865,205.637033,65.674168,0.558,2.904507,2.346507,,,,0,0,0,173.584654,92.965915,-80.618739,0.079465,2.657111,2.577646,26.023591,7.014614,-19.008977,0.21961,5.01804,4.79843,0.160611,1.112162,0.951551,4.161817,6.025888,1.864071,0.428798,3.637007,3.208209,106.073185,11.459241,-94.613944,6.57163,23.755588,17.183958,0.026911,1.778881,1.75197,26.953098,8.363831,-18.589267,0.106957,2.905492,2.798535,2332.700062,129.094981,-2203.605081,0.093423,1.933339,1.839916,65.365003,12.355611,-53.009392,161.338033,6.581271,-154.756762,0.167387,0.12125,-0.046137,0.023706,1.437994,1.414288,0.006634,10.276045,10.269411,868.704503,64.073408,-804.631095,290.241144,9.437197,-280.803947,0.009342,1.11664,1.107298,0.010908,0.74777,0.736862,0,0.275292,0.275292,16.800277,4.656111,-12.144166,1.955606,5.888358,3.932752,0.072458,1.482176,1.409718,0.895606,0.96451,0.068904,0.010459,1.250316,1.239857,0.4,12.8,12.4,0.113115,0.384743,0.271628,0.191713,3.179577,2.987864,2.006824,3.781178,1.774354,21.407096,12.038988,-9.368108,1.026005,0.464251,-0.561754,0.0048,0.007162,0.002362,2.454296,13.673623,11.219327,23.942717,1.431093,-22.511624,3.063209,11.301977,8.238768,19.285083,1.835146,-17.449937,0,0,0,0.052839,0.049282,-0.003557,0.757368,0.321732,-0.435636,0,0.000367,0.000367,463.198053,320.672443,-142.52561,3.698802,8.027898,4.329096,15.091017,3.231684,-11.859333,2.221999,4.288435,2.066436,7.595476,2.035518,-5.559958,11.520665,6.276203,-5.244462,4.767869,7.899094,3.131225,17.795737,0.22095,-17.574787,0,0,0,,,
2006-03-01,11616.612471,2982.7,-8633.912471,29297.6,18824.7,-10472.9,150759,83299,-67460,11091.089145,0,-11091.089145,13991.228901,7653.5,-6337.728901,25348,22340,-3008,8944.36981,8468.470456,-475.899354000003,11657.035031,7332.577931,-4324.4571,43841.076226,33121.280335,-10719.795891,33233.051326,21666.440009,-11566.611317,5776.063932,1397.890813,-4378.173119,48464.174265,22489.750664,-25974.423601,154040,90852.8933060001,-63187.1066939999,58500.425455,25704.172822,-32796.252633,1712.621765,1681.90275,-30.7190150000004,1032.125238,1630.095609,597.970371,4440.278138,913.589418,-3526.68872,0.558599,0.363479,-0.19512,26477.665627,21153.328316,-5324.337311,0.012893,0.072308,0.059415,17363.410599,11967.952019,-5395.45858,321.536507,308.559604,-12.976903,16.329794,20.762969,4.433175,92.995869,176.583136,83.587267,340.418525,318.309324,-22.109201,125.015063,69.495192,-55.519871,404.455864,339.866109,-64.589755,34.660103,204.7756,170.115497,0.837568,83.425408,82.58784,34.329232,192.250319,157.921087,0,36.744867,36.744867,57.85615,152.28367,94.42752,1.268044,28.128924,26.86088,1.461922,57.794772,56.33285,46.528015,62.831462,16.303447,428.199937,469.089385,40.8894480000001,0.496427,3.333885,2.837458,0.573933,21.72249,21.148557,4.390311,13.522333,9.132022,0.637166,18.671113,18.033947,0.003097,0.370208,0.367111,0.153281,5.143823,4.990542,1.202553,10.90993,9.707377,0.12958,3.652928,3.523348,0.447627,7.290861,6.843234,2.599665,40.983864,38.384199,652.153271,136.605817,-515.547454,105.857477,145.574755,39.717278,,,,,,,270.370073,44.864413,-225.50566,0.096426,4.882759,4.786333,0.048034,2.862588,2.814554,809.353412,549.715696,-259.637716,3202.616361,676.1047,-2526.511661,14.04636,18.819613,4.773253,7.788159,25.805413,18.017254,0,1.032395,1.032395,580.622737,241.167895,-339.454842,530.210988,238.272156,-291.938832,18.23534,19.151614,0.916273999999998,858.10169,557.65088,-300.45081,2218.166635,1499.5826,-718.584035,3.797086,79.503742,75.706656,55.140447,33.720443,-21.420004,410.140445,410.470676,0.330230999999969,3.763857,0.2876,-3.476257,27.462247,52.504548,25.042301,1315.018743,363.217651,-951.801092,0,0.21208,0.21208,609.890388,218.376387,-391.514001,411.178513,190.226565,-220.951948,0.859887,0.40657,-0.453317,479.228935,197.408146,-281.820789,4706.391867,4325.478106,-380.913761,2838.036552,796.655665,-2041.380887,1231.027503,2552.703943,1321.67644,1514.659498,1721.586605,206.927107,42.487457,83.624104,41.136647,0.006185,1.071466,1.065281,1.753563,0.750629,-1.002934,3239.81141,2290.58199,-949.229419999999,8058.998968,3564.208214,-4494.790754,778.036089,268.000136,-510.035953,,,,227.655061,100.079929,-127.575132,59.80047,56.235194,-3.565276,216.733752,130.012722,-86.72103,26.876696,2.000144,-24.876552,1197.207093,1452.526344,255.319251,14.784681,12.594601,-2.19008,12.76354,18.043804,5.280264,109.81945,35.571592,-74.247858,236.217886,134.182886,-102.035,,,,1307.369173,382.276969,-925.092204,17.105088,3.300164,-13.804924,112.907553,70.165336,-42.742217,2.855831,4.917567,2.061736,0.398651,15.507258,15.108607,7.089538,17.188179,10.098641,20.027016,49.947404,29.920388,0.610068,1.044783,0.434715,2.955675,1.583404,-1.372271,0.191519,3.219827,3.028308,3.171741,1.318565,-1.853176,1.797256,5.330704,3.533448,701.348846,689.220815,-12.128031,182.500455,128.337919,-54.1625360000001,0.096717,12.789893,12.693176,27.252895,16.315794,-10.937101,0.164821,1.298975,1.134154,0.008625,0.505812,0.497187,2782.147421,1031.881661,-1750.26576,,,,29.838719,9.457834,-20.380885,36.080344,19.229185,-16.851159,0.903056,0.954002,0.0509460000000002,2.553748,1.079004,-1.474744,5.616011,10.938184,5.322173,,,,,,,,,,1.773044,1.678431,-0.0946130000000005,73.560682,90.327119,16.766437,85.775865,60.301426,-25.474439,22.828988,27.142797,4.313809,445.40483,431.957027,-13.4478030000001,2.010716,8.96395,6.953234,1.392645,9.095252,7.702607,6.56087,76.991306,70.430436,909.880595,132.747244,-777.133351,19.996157,14.757258,-5.238899,384.8,453.3,68.5,0.044075,0,-0.044075,0.089739,1.214761,1.125022,121.378235,62.888504,-58.489731,248.937454,151.332477,-97.604977,,,,2501.901251,559.763039,-1942.138212,18.180681,96.003563,77.822882,107.984788,875.029403,767.044615,62.284449,18.578532,-43.705917,28.662796,41.622525,12.959729,34.600959,39.342641,4.741682,5.55165,20.648405,15.096755,1841.156655,810.010517,-1031.146138,298.364374,242.222674,-56.1417,13.281907,1.156927,-12.12498,275.475431,37.151875,-238.323556,203.815068,13.359162,-190.455906,0,0.809968,0.809968,1950.457866,627.979241,-1322.478625,585.724628,79.055161,-506.669467,0.666448,0.323808,-0.34264,180.802794,8.98919,-171.813604,2885.958562,1324.418491,-1561.540071,1511.294978,2021.219273,509.924295,1138.433868,236.850208,-901.58366,0,0.498021,0.498021,36.598977,2.664951,-33.934026,849.567404,645.396053,-204.171351,94.587812,20.466377,-74.121435,0.000914,0.004336,0.003422,0.216496,1.259383,1.042887,20531.25833,4867.06471,-15664.19362,9.219822,5.000946,-4.218876,0,0,0,3773.111499,2976.763422,-796.348077,640.23868,1592.85927,952.62059,3019.724653,1877.628491,-1142.096162,12977.200587,5320.611925,-7656.588662,719.638089,1437.557609,717.91952,0.031674,0.078173,0.046499,0.030658,0.119126,0.088468,0.074965,0.209871,0.134906,0.014312,0.398418,0.384106,3.24503,4.684107,1.439077,283.315796,161.565777,-121.750019,0.040934,0.136477,0.095543,0.718667,2.469289,1.750622,0,0.028308,0.028308,0.563858,0.907042,0.343184,0.217018,0.192018,-0.025,0.032915,0.687688,0.654773,0,0.130003,0.130003,0.104237,0.08942,-0.014817,0,0,0,3.707997,2.252216,-1.455781,0.0024,0.016415,0.014015,4.710551,8.583674,3.873123,0.562924,1.048838,0.485914,0.153214,2.857605,2.704391,0.082434,1.354252,1.271818,0.03918,0.368444,0.329264,14.120505,4.457223,-9.663282,0.721381,0.413553,-0.307828,45.004474,83.804749,38.800275,942.81246,49.608733,-893.203727,46.464111,13.980512,-32.483599,78.559009,64.415092,-14.143917,136.632305,316.125002,179.492697,0.003722,2.763956,2.760234,,,,0,0,0,166.325179,55.095229,-111.22995,0.058295,2.886797,2.828502,4.438265,11.041627,6.603362,0.202457,15.53963,15.337173,2.649107,12.070382,9.421275,10.215836,5.04947,-5.166366,1.038616,3.212358,2.173742,88.018977,7.762894,-80.256083,18.700642,27.198578,8.49793600000001,0.081968,4.079369,3.997401,1.787665,5.043302,3.255637,0.057869,2.110127,2.052258,2094.825292,170.5004,-1924.324892,0.199194,1.161187,0.961993,118.793053,8.792547,-110.000506,168.957508,3.675107,-165.282401,0.009369,0.637329,0.62796,0.088125,1.045511,0.957386,0.008707,7.027226,7.018519,824.909266,90.347547,-734.561719,127.35507,13.423613,-113.931457,0,0.405683,0.405683,0.120428,1.654516,1.534088,0.01034,0.113778,0.103438,15.311452,3.979106,-11.332346,4.006789,4.235104,0.228314999999999,0.184075,0.14748,-0.036595,0.571245,1.604693,1.033448,0.010522,2.394163,2.383641,2.1,2.6,0.5,0.03791,0.130755,0.092845,0.135727,1.708895,1.573168,3.85753,4.201883,0.344353,31.390188,26.574248,-4.81594,1.472811,0.517181,-0.95563,0.478558,0.012773,-0.465785,2.910287,26.067811,23.157524,18.651612,2.094574,-16.557038,0.437528,2.108374,1.670846,23.175145,3.120329,-20.054816,0,0,0,0.754644,0.018405,-0.736239,0.439088,0.161507,-0.277581,0,0.003816,0.003816,610.306619,344.842737,-265.463882,16.928005,10.312594,-6.615411,17.753342,3.653357,-14.099985,0.170239,5.460168,5.289929,12.385126,1.314332,-11.070794,3.411679,5.99972,2.588041,5.420387,3.753132,-1.667255,36.541582,0.24119,-36.300392,0,0,0,,,
2006-04-01,11540.690617,2998.2,-8542.490617,27054.7,17374,-9680.7,151278,83188,-68090,10012.223908,0,-10012.223908,12851.263907,7076.2,-5775.063907,21517,19775,-1742,8713.592447,7874.504928,-839.087519,10370.144408,6903.28421,-3466.860198,40502.060053,29874.97299,-10627.087063,31502.479587,19926.282127,-11576.19746,6007.668887,1321.890836,-4685.778051,48189.848195,20057.394301,-28132.453894,146919,82447.851496,-64471.148504,57627.646309,22793.520781,-34834.125528,1287.229895,1577.865293,290.635398,908.01495,1625.394297,717.379347,4493.744495,776.491197,-3717.253298,0.843165,0.165794,-0.677371,24836.757199,19102.469412,-5734.287787,0,0.240461,0.240461,15665.302854,10772.503578,-4892.79927599999,235.467804,288.557043,53.089239,12.32501,26.739696,14.414686,106.890219,175.811595,68.921376,206.947994,311.498772,104.550778,115.932134,64.14109,-51.791044,288.454817,365.318789,76.863972,23.46299,185.051337,161.588347,0.932997,71.918458,70.985461,27.207649,166.527928,139.320279,0.08119,37.239943,37.158753,41.493307,135.907479,94.414172,0.938023,27.046058,26.108035,0.794989,60.397349,59.60236,40.108493,78.555875,38.447382,333.536927,372.538004,39.001077,0.724156,3.617557,2.893401,0.699382,11.125734,10.426352,4.584806,7.542396,2.95759,0.262048,15.079606,14.817558,0.005,9.077513,9.072513,0.264279,5.782984,5.518705,0.962679,12.712014,11.749335,0.081707,3.74977,3.668063,0.292111,6.395886,6.103775,3.132181,31.111467,27.979286,794.549113,130.745363,-663.80375,75.50363,134.950072,59.446442,,,,,,,284.515717,37.812845,-246.702872,0.21239,3.391841,3.179451,0.006311,1.682941,1.67663,796.413796,491.971098,-304.442698,2884.150665,723.839578,-2160.311087,14.295643,15.256605,0.960962000000006,11.41478,17.496661,6.081881,0,2.565159,2.565159,537.629122,216.415995,-321.213127,376.599303,243.210004,-133.389299,29.963557,21.704313,-8.259244,749.935713,501.201867,-248.733846,2060.751543,1421.538142,-639.213401,3.773632,75.0599,71.286268,35.166656,29.338416,-5.82824,268.539429,361.621837,93.082408,1.140516,0.03723,-1.103286,21.813862,38.235618,16.421756,1386.941658,349.60603,-1037.335628,0,0.108723,0.108723,659.633439,190.072142,-469.561297,404.221577,195.321133,-208.900444,0.36949,0.211157,-0.158333,427.877498,191.986629,-235.890869,4460.119499,3761.9813,-698.138199,1838.4194,620.70439,-1217.71501,1316.519513,2618.477829,1301.958316,1054.545503,1710.321911,655.776408,30.980438,54.081912,23.101474,0.002394,0.998327,0.995933,1.294614,3.482852,2.188238,3059.173582,1794.492074,-1264.681508,7744.98369,3403.243999,-4341.739691,625.274644,228.034706,-397.239938,,,,195.824106,85.246941,-110.577165,98.866133,79.751353,-19.11478,187.293148,106.055754,-81.237394,27.228946,0.758585,-26.470361,1091.804805,1005.914119,-85.8906859999997,50.002542,19.428388,-30.574154,9.514927,20.2985,10.783573,30.385924,32.167632,1.78170799999999,195.220374,119.504935,-75.715439,,,,1659.619702,468.687631,-1190.932071,51.135479,6.209239,-44.92624,128.582329,83.028976,-45.553353,4.219545,5.379614,1.160069,0.183574,24.430961,24.247387,7.453718,26.260424,18.806706,13.047255,36.188775,23.14152,0.25702,4.572458,4.315438,3.780693,1.359707,-2.420986,0.002069,0.508997,0.506928,3.357646,2.079845,-1.277801,3.089198,2.299471,-0.789727000000001,803.429791,571.082428,-232.347363,291.138394,95.873608,-195.264786,0.013048,6.483761,6.470713,63.329159,14.674955,-48.654204,0.3932,0.518831,0.125631,0.021267,0.423655,0.402388,2613.883509,1130.66372,-1483.219789,,,,35.057977,17.285924,-17.772053,39.834361,18.132696,-21.701665,1.234037,1.764252,0.530215,1.483705,2.353175,0.86947,4.278088,15.898037,11.619949,,,,,,,,,,0.736304,1.514333,0.778029,124.325541,144.429764,20.104223,156.756191,42.882378,-113.873813,38.967312,37.765778,-1.201534,531.924606,524.629578,-7.295028,2.633163,8.412217,5.779054,30.236538,4.756353,-25.480185,7.57277,93.667567,86.094797,782.044225,148.317009,-633.727216,10.272212,4.343235,-5.928977,297.9,342.3,44.4,0.019716,0.033939,0.014223,0.092179,0.838297,0.746118,108.714632,45.910493,-62.804139,371.030017,163.63608,-207.393937,,,,2603.45391,573.687303,-2029.766607,14.821786,68.329617,53.507831,99.415206,719.438053,620.022847,42.1816,22.976353,-19.205247,77.849018,41.493735,-36.355283,52.951091,30.626892,-22.324199,1.836857,20.857858,19.021001,1682.612747,801.769552,-880.843195,264.810928,79.030776,-185.780152,8.356375,0.63228,-7.724095,227.080034,39.178419,-187.901615,157.434925,10.966609,-146.468316,0,0.335922,0.335922,1691.141343,590.363159,-1100.778184,614.926937,81.363937,-533.563,0.391099,0.845238,0.454139,131.980919,5.993487,-125.987432,2997.070568,1066.993755,-1930.076813,1471.041551,2007.615014,536.573462999999,978.207881,265.324459,-712.883422,0,0.713396,0.713396,32.788512,3.900331,-28.888181,763.240378,545.599839,-217.640539,98.568808,13.538899,-85.029909,0.00335,1.323986,1.320636,0.155978,1.440733,1.284755,21459.069933,4232.404495,-17226.665438,7.442853,1.435751,-6.007102,0,0,0,3561.075495,2729.221617,-831.853877999999,586.258261,1416.336023,830.077762,3095.21714,1721.332274,-1373.884866,12261.319539,4453.680661,-7807.638878,616.18396,1437.492698,821.308738,0.027328,0.049071,0.021743,0.202349,0.278849,0.0765,0.007162,0.148774,0.141612,0,0.291973,0.291973,2.04398,6.010852,3.966872,267.762189,157.943384,-109.818805,0.146807,0.134435,-0.012372,0.413676,2.474932,2.061256,0,0.046003,0.046003,0.339176,1.210214,0.871038,0.091149,0.226082,0.134933,0.096319,0.760101,0.663782,0.009721,0.492902,0.483181,0.062935,0.031168,-0.031767,0.00214,0,-0.00214,3.89735,2.681241,-1.216109,0.003912,0.037897,0.033985,3.112807,7.415242,4.302435,0.889361,0.797349,-0.0920119999999999,0.034681,3.626255,3.591574,0.050941,0.755016,0.704075,0.003524,0.615252,0.611728,11.953919,2.004067,-9.949852,0.666699,0.533598,-0.133101,39.017285,83.559572,44.542287,1024.689169,112.573488,-912.115681,12.308005,31.571512,19.263507,204.939191,63.783962,-141.155229,246.508545,286.570998,40.062453,0.8,2.34886,1.54886,,,,0,0,0,109.122817,14.166805,-94.956012,0.006656,2.872491,2.865835,2.822887,3.964691,1.141804,0.25198,5.112255,4.860275,0.629533,7.117789,6.488256,7.001803,3.546812,-3.454991,2.029427,1.656161,-0.373266,23.774898,10.213546,-13.561352,14.796811,18.57206,3.775249,0.004988,1.401504,1.396516,21.321891,21.323277,0.00138600000000011,0.408986,2.103931,1.694945,2172.002909,188.000651,-1984.002258,0.042714,0.658314,0.6156,74.156551,7.065028,-67.091523,107.535664,4.488987,-103.046677,0.015378,0.104741,0.089363,0.01237,1.827002,1.814632,0.169426,8.623638,8.454212,850.957955,62.153182,-788.804773,277.063334,5.301275,-271.762059,0,0.099708,0.099708,0.01947,0.288395,0.268925,0.0141,0.238873,0.224773,2.355201,4.96646,2.611259,7.932703,2.414266,-5.518437,0.135651,0.09808,-0.037571,0.479474,1.884874,1.4054,0.014396,3.85232,3.837924,3.1,2.8,-0.3,0.137809,0.416667,0.278858,0.008427,2.023471,2.015044,2.862356,2.556983,-0.305373000000001,29.723178,16.633697,-13.089481,0.356749,0.362198,0.00544899999999993,0.054994,0.058851,0.00385699999999999,3.282418,10.58995,7.307532,14.721049,1.496699,-13.22435,0.344131,4.498203,4.154072,22.298281,1.298504,-20.999777,0.30042,0.003798,-0.296622,0.028375,0.000303,-0.028072,1.107575,0.209693,-0.897882,0,0.0151,0.0151,612.803472,322.600188,-290.203284,4.906211,9.310552,4.404341,54.565576,1.74477,-52.820806,3.563741,4.202193,0.638452,11.324957,0.453243,-10.871714,10.223798,2.485006,-7.738792,3.654448,2.897375,-0.757072999999999,34.185814,0.214237,-33.971577,0,2.1,2.1,,,
2006-05-01,14169.008013,3134.1,-11034.908013,29601.5,18145.3,-11456.2,154996,84593,-70403,11256.553188,0,-11256.553188,14277.575424,7723,-6554.575424,23088,19812,-3276,9316.169026,7654.398494,-1661.770532,11890.634557,7205.664658,-4684.969899,43613.579674,32059.279861,-11554.299813,34984.014039,20695.464361,-14288.549678,6960.331373,1581.874569,-5378.456804,49621.37094,20682.019413,-28939.351527,159164,86969.042384,-72194.957616,60752.900362,23660.379208,-37092.521154,1644.139747,1682.458992,38.3192450000004,961.495502,1766.122455,804.626953000001,4912.910657,875.745464,-4037.165193,1.042459,0.227016,-0.815443,26459.01217,20489.642759,-5969.36941100001,0.4012,0.030256,-0.370944,17154.567504,11569.637102,-5584.930402,290.402119,266.438435,-23.963684,4.869525,16.041885,11.17236,157.731244,214.54031,56.809066,319.547906,335.75832,16.210414,114.022165,74.030347,-39.991818,365.956888,357.234667,-8.72222100000005,38.981338,238.765956,199.784618,1.477998,46.212231,44.734233,35.525092,193.48559,157.960498,0,18.215429,18.215429,47.424547,145.0695,97.644953,1.065327,24.615533,23.550206,1.224839,46.081009,44.85617,50.772659,75.722516,24.949857,396.479425,434.456913,37.977488,0.974644,2.743979,1.769335,1.158663,28.25218,27.093517,4.437327,7.532299,3.094972,0.524053,14.295368,13.771315,0.008417,0.408526,0.400109,0.293082,5.966258,5.673176,1.170348,12.826976,11.656628,0.075009,3.034043,2.959034,0.452624,5.064806,4.612182,3.016093,32.552074,29.535981,922.301205,137.28387,-785.017335,89.945334,112.124931,22.179597,,,,,,,339.984584,30.596495,-309.388089,0.163109,3.707058,3.543949,0.138158,2.751059,2.612901,889.632649,561.600159,-328.03249,3474.491534,699.794408,-2774.697126,10.813228,14.003138,3.18991,14.392473,19.325289,4.932816,0,2.234874,2.234874,661.243599,217.587509,-443.65609,538.067427,192.014439,-346.052988,22.388097,17.184705,-5.20339199999999,760.297951,561.133192,-199.164759,1943.914725,1514.126143,-429.788582,3.131417,75.529553,72.398136,56.913617,34.05595,-22.857667,324.442038,411.255735,86.8136969999999,0.78208,0.011001,-0.771079,19.001403,27.292374,8.290971,1287.651853,375.08181,-912.570043,0,0.180742,0.180742,735.692605,197.524331,-538.168274,517.822451,224.601637,-293.220814,0.000641,0.0149,0.014259,504.485915,207.121707,-297.364208,5080.506284,4023.578512,-1056.927772,2802.465453,514.206694,-2288.258759,1640.705284,2750.081224,1109.37594,1422.590907,1850.838973,428.248066,41.699387,47.866812,6.167425,0.066963,0.686974,0.620011,3.403822,1.034909,-2.368913,3122.505898,1961.431976,-1161.073922,7412.005164,3375.629473,-4036.375691,650.390816,296.201366,-354.18945,,,,203.486803,91.934049,-111.552754,96.033149,57.338253,-38.694896,192.261297,87.533201,-104.728096,26.468709,1.433062,-25.035647,1212.92112,1033.846712,-179.074408,103.812684,21.042008,-82.770676,62.663511,25.001029,-37.662482,71.520322,72.913998,1.39367600000003,226.371798,127.525613,-98.8461850000001,,,,2383.838317,442.428057,-1941.41026,47.232316,3.739318,-43.492998,235.852196,55.557611,-180.294585,3.406795,8.046579,4.639784,0.265266,18.796748,18.531482,21.176423,11.416443,-9.75998,64.124838,70.776513,6.65167499999998,0.390224,6.63437,6.244146,3.689537,1.467829,-2.221708,0.014625,13.431546,13.416921,4.10103,32.180896,28.079866,9.840717,5.232228,-4.608489,889.096321,610.794723,-278.301598,209.903701,128.015788,-81.887913,0.112571,20.120047,20.007476,38.370308,20.034038,-18.33627,0.153698,0.358273,0.204575,0.001136,0.390814,0.389678,2909.217165,1080.362262,-1828.854903,,,,24.347927,7.934569,-16.413358,44.382475,14.757826,-29.624649,1.115476,28.256489,27.141013,0.948949,4.715532,3.766583,4.424964,9.962519,5.537555,,,,,,,,,,1.715432,1.71781,0.00237799999999977,68.289095,123.806458,55.517363,94.106307,40.267799,-53.838508,48.750946,38.712267,-10.038679,435.299277,465.990694,30.6914170000002,3.311768,57.615976,54.304208,1.901051,13.379322,11.478271,7.469418,126.318106,118.848688,1270.561871,138.893423,-1131.668448,15.849549,6.369921,-9.479628,330.8,381.1,50.3,0.02405,0,-0.02405,0.02846,0.019131,-0.009329,111.417004,50.396805,-61.020199,430.704579,157.420591,-273.283988,,,,3023.660748,619.612232,-2404.048516,6.967941,94.870521,87.90258,122.393466,819.307938,696.914472,67.859877,8.235661,-59.624216,49.103255,43.114423,-5.988832,86.312728,33.818233,-52.494495,2.787201,24.771839,21.984638,1792.247801,916.092805,-876.154996,312.729613,83.711009,-229.018604,7.108068,1.437535,-5.670533,225.769408,25.599871,-200.169537,144.750156,13.644123,-131.106033,0,0.382568,0.382568,1782.527145,608.791631,-1173.735514,695.001064,81.825704,-613.17536,0.312466,0.147527,-0.164939,132.715965,4.417861,-128.298104,2999.708822,1191.371001,-1808.337821,1392.663265,1979.549226,586.885961,1107.054317,289.842375,-817.211942,0,0.896478,0.896478,35.059705,2.85701,-32.202695,769.617018,645.092881,-124.524137,99.79839,19.72151,-80.07688,0.236463,0.507674,0.271211,0.193889,1.24683,1.052941,22317.635131,4434.090049,-17883.545082,6.801,1.822782,-4.978218,0,0,0,4061.520009,2411.523276,-1649.996733,611.415952,1449.998056,838.582104,3250.5698,1813.327936,-1437.241864,12033.996166,4707.117153,-7326.879013,677.414444,1416.3098,738.895356,0.022615,0.016724,-0.005891,0.003688,0.018247,0.014559,0.003444,0.007599,0.004155,0,0.248328,0.248328,5.509969,4.260451,-1.249518,259.407952,316.958689,57.550737,0.040417,0.044602,0.00418500000000001,0.273794,8.413725,8.139931,0,0.03343,0.03343,0.498376,1.287376,0.789,0.248757,0.201843,-0.0469139999999999,0.081623,0.812392,0.730769,0,0.14909,0.14909,0.079177,0.013288,-0.065889,0.030341,0,-0.030341,1.739849,2.655557,0.915708,0,0.002097,0.002097,5.091643,8.340022,3.248379,0.842725,1.077207,0.234482,0.03787,2.612398,2.574528,0.020606,0.718121,0.697515,0,0.321457,0.321457,9.607201,1.292159,-8.315042,0.566697,0.540784,-0.025913,40.58783,53.242501,12.654671,1447.674089,137.891981,-1309.782108,65.88375,37.056331,-28.827419,148.70228,64.572848,-84.129432,292.536978,455.081575,162.544597,0.78,6.184149,5.404149,,,,0,0,0,106.381816,19.881501,-86.500315,0.002196,3.552266,3.55007,20.413862,17.116708,-3.297154,0.310521,8.009387,7.698866,0.173459,1.390077,1.216618,7.25461,4.15581,-3.0988,4.164231,4.187233,0.023002,15.670634,8.315676,-7.354958,8.976525,26.311548,17.335023,0.030165,2.729621,2.699456,1.58956,40.607302,39.017742,0.098402,2.241958,2.143556,2851.575312,148.404116,-2703.171196,0.292771,1.933845,1.641074,59.749098,18.037527,-41.711571,150.667035,6.993543,-143.673492,0.013094,0.035884,0.02279,0.017379,1.604153,1.586774,0.17135,10.456698,10.285348,663.958051,68.976724,-594.981327,152.428798,4.53444,-147.894358,0,0.20533,0.20533,0.001023,1.178993,1.17797,0.047207,0.288184,0.240977,21.516958,8.216832,-13.300126,9.453288,5.213501,-4.239787,0.037202,1.117923,1.080721,0.001476,1.368534,1.367058,0.003365,2.413036,2.409671,3.5,4.8,1.3,0.160177,0.838294,0.678117,0.444933,2.883794,2.438861,0.886562,5.917981,5.031419,19.37282,19.705397,0.332577000000001,0.684408,0.718398,0.0339900000000001,0.136285,0.501859,0.365574,3.224023,14.208165,10.984142,16.736179,3.668883,-13.067296,0.644646,2.44226,1.797614,17.079797,2.602293,-14.477504,0.00216,0.000063,-0.002097,0.103967,0,-0.103967,0.661416,0.586272,-0.075144,0,0.000167,0.000167,685.454263,366.648421,-318.805842,4.781127,7.51361,2.732483,25.767012,1.192574,-24.574438,2.425991,3.107117,0.681126,14.513875,0.657437,-13.856438,8.489378,3.586735,-4.902643,2.482665,2.499519,0.0168539999999999,22.25493,0.122176,-22.132754,0,0,0,,,
2006-06-01,13732.894434,3272,-10460.894434,28397.9,19028.5,-9369.4,155279,86432,-68847,11442.933872,0,-11442.933872,14873.87376,7413.3,-7460.57376,24534,21688,-2846,9312.497503,8587.306868,-725.190634999997,11565.717012,7362.858968,-4202.858044,44331.501822,32589.27555,-11742.226272,32841.783834,21724.06097,-11117.722864,7811.205549,1543.759672,-6267.445877,51762.38237,21574.773771,-30187.608599,160487,89730.572257,-70756.427743,62903.590113,24969.640479,-37933.949634,1717.143683,1696.42476,-20.7189229999994,1032.099409,1538.90775,506.808341,5561.965935,953.577728,-4608.388207,0.717248,0.303077,-0.414171,26544.18887,20874.721681,-5669.46718900001,0.297468,0.029853,-0.267615,17787.312952,11714.553869,-6072.759083,283.429707,326.023524,42.593817,5.841051,21.552704,15.711653,172.945052,181.829258,8.88420600000001,349.841663,331.802499,-18.0391640000001,147.246988,59.824756,-87.422232,380.464749,349.627375,-30.8373740000002,59.280808,253.232791,193.951983,3.185132,42.844298,39.659166,37.766355,199.720843,161.954488,0,24.308029,24.308029,43.560575,167.528417,123.967842,1.009683,26.444279,25.434596,1.98811,47.005009,45.016899,39.77897,68.884603,29.105633,383.215524,447.317348,64.1018239999999,0.367619,3.376138,3.008519,1.599909,11.730086,10.130177,4.6927,7.409449,2.716749,0.514157,14.917488,14.403331,0.12878,0.576859,0.448079,0.202092,8.300571,8.098479,1.539596,11.824651,10.285055,0.011257,5.313132,5.301875,0.713016,7.607508,6.894492,2.919812,39.356754,36.436942,722.813384,150.797084,-572.0163,124.186428,105.188103,-18.998325,,,,,,,241.061947,30.512001,-210.549946,0.462585,2.994306,2.531721,0.103576,1.491831,1.388255,846.12126,557.937032,-288.184228,3072.516709,750.107685,-2322.409024,8.685786,15.156529,6.470743,19.159102,22.101801,2.94269899999999,0.045594,1.23998,1.194386,580.416629,204.910129,-375.5065,496.863328,268.129206,-228.734122,32.294973,15.167866,-17.127107,855.110883,656.776087,-198.334796,2259.321732,1398.207045,-861.114687,3.201273,72.02961,68.828337,36.147053,53.09334,16.946287,343.856986,398.652041,54.795055,1.104479,0.008923,-1.095556,17.657884,27.090936,9.433052,1130.909443,360.947584,-769.961859,0,0.134455,0.134455,395.905789,192.003076,-203.902713,434.921669,237.339552,-197.582117,0.106982,0.483051,0.376069,505.403613,176.916606,-328.487007,4630.516236,4385.062795,-245.453441000001,2513.354947,654.474099,-1858.880848,1576.684747,2660.276233,1083.591486,1314.267809,1830.639972,516.372163,35.881181,46.079895,10.198714,0.043735,0.910886,0.867151,2.822488,5.729725,2.907237,3268.5545,2266.343539,-1002.210961,7401.622343,3406.568248,-3995.054095,592.906796,258.572017,-334.334779,,,,195.278575,114.149129,-81.129446,96.895132,55.236593,-41.658539,194.652428,88.867196,-105.785232,26.090646,1.720041,-24.370605,1217.287831,1373.109995,155.822164,12.802272,24.448394,11.646122,9.796661,19.589261,9.7926,23.288506,39.645688,16.357182,184.293592,127.724452,-56.56914,,,,1804.432213,314.959687,-1489.472526,34.46602,7.033297,-27.432723,145.17695,56.309742,-88.867208,2.537988,7.768908,5.23092,63.618361,9.70667,-53.911691,1.669213,21.35693,19.687717,126.286678,62.418138,-63.86854,0.520362,1.912101,1.391739,2.986723,1.99645,-0.990273,0.046755,2.892045,2.84529,4.544165,3.203282,-1.340883,23.102211,8.295511,-14.8067,982.66777,621.623103,-361.044667,268.865623,261.846602,-7.01902100000001,0.044581,12.547036,12.502455,33.76781,15.688278,-18.079532,0.169039,0.700524,0.531485,0.015235,1.201877,1.186642,2890.345102,1186.70643,-1703.638672,,,,20.703463,13.18816,-7.515303,38.256194,25.043985,-13.212209,9.948824,0.81888,-9.129944,6.254245,2.694011,-3.560234,5.1489,10.710987,5.562087,,,,,,,,,,0.904898,1.687543,0.782645,59.983926,107.44482,47.460894,67.868862,45.511443,-22.357419,32.616407,34.947671,2.331264,430.871705,472.561936,41.6902309999999,2.017806,57.221505,55.203699,1.944172,27.498819,25.554647,9.134533,87.98465,78.850117,1047.402895,142.776398,-904.626497,7.809081,4.915408,-2.893673,354.2,333.6,-20.6,0.020807,0.00315,-0.017657,0.064888,0.0264,-0.038488,103.776242,57.414638,-46.361604,427.963308,196.158543,-231.804765,,,,3018.786672,732.547395,-2286.239277,4.577437,105.297402,100.719965,134.590362,758.07658,623.486218,0.509812,24.419362,23.90955,53.78849,33.409074,-20.379416,87.495254,48.22538,-39.269874,2.810006,27.248655,24.438649,1633.467905,740.776529,-892.691376,367.723437,123.904568,-243.818869,9.521607,1.445667,-8.07594,289.536378,29.636698,-259.89968,177.797207,87.087596,-90.709611,0,0.720463,0.720463,1875.547205,661.869271,-1213.677934,870.305196,88.021213,-782.283983,0.550067,0.145216,-0.404851,184.76505,5.443773,-179.321277,2991.09497,1070.856408,-1920.238562,1545.528734,1815.152393,269.623659000001,1115.10513,250.016648,-865.088482,0,0.631937,0.631937,69.688616,3.406682,-66.281934,811.031141,623.426794,-187.604347,124.41817,17.229785,-107.188385,0.020199,0.665237,0.645038,0.202154,1.596273,1.394119,23989.699396,4302.905336,-19686.79406,8.626345,2.057699,-6.568646,0,0,0,3885.55226,2725.504162,-1160.048098,700.374086,1621.444438,921.070352,3181.042423,2425.205875,-755.836548,12337.281789,5215.495373,-7121.786416,744.258454,1341.411242,597.152788,0.00702,0.085192,0.078172,0.018828,0.037837,0.019009,0,0.085161,0.085161,0,0.017975,0.017975,3.803697,4.108699,0.305002,263.503504,158.609936,-104.893568,0.047582,1.627751,1.580169,0.50773,5.943236,5.435506,0,0.027659,0.027659,0.415819,1.269012,0.853193,0.148265,0.340419,0.192154,0.110976,1.287395,1.176419,0.010472,0.022543,0.012071,0.029566,0.067906,0.03834,0.012482,0,-0.012482,5.233246,3.817722,-1.415524,0,0.055887,0.055887,3.797796,12.527811,8.730015,1.347111,1.05583,-0.291280999999999,0.003592,3.158187,3.154595,0.063434,0.676139,0.612705,0.052199,0.166278,0.114079,8.215424,1.331371,-6.884053,0.532767,1.144046,0.611279,42.511077,141.008197,98.49712,1617.245038,86.587305,-1530.657733,43.538815,19.353282,-24.185533,173.304634,54.989906,-118.314728,210.57007,320.07669,109.50662,0.08,16.808528,16.728528,,,,0,0,0,338.439288,33.899955,-304.539333,0.077909,3.055558,2.977649,40.721043,8.844788,-31.876255,0.193866,10.000965,9.807099,0.237231,1.056509,0.819278,19.838605,5.562617,-14.275988,3.174887,1.72578,-1.449107,34.134977,19.042917,-15.09206,6.277616,27.357207,21.079591,0.016736,1.534711,1.517975,18.820239,6.336666,-12.483573,2.117118,11.309465,9.192347,2428.256027,223.365229,-2204.890798,0.789384,1.542842,0.753458,130.88191,10.335138,-120.546772,180.592721,3.351413,-177.241308,0.00825,0.062146,0.053896,0.018863,1.616855,1.597992,0.005548,6.017075,6.011527,1058.787207,81.577535,-977.209672,416.644348,5.869762,-410.774586,0,0.148452,0.148452,0.086565,4.226662,4.140097,0.000418,0.265116,0.264698,0.018572,4.823897,4.805325,6.053347,3.980381,-2.072966,0.031028,0.38683,0.355802,0.620151,1.128773,0.508622,0,0.359554,0.359554,2.5,12.9,10.4,0.001555,0.264319,0.262764,0.318431,1.493875,1.175444,1.350337,4.57947,3.229133,34.948972,38.135045,3.18607299999999,0.689099,0.423691,-0.265408,0.018054,0.541841,0.523787,1.816858,18.686298,16.86944,16.767469,2.026424,-14.741045,0.341189,8.56929,8.228101,23.277539,3.178229,-20.09931,0,0,0,0.058762,0,-0.058762,0.799821,0.311937,-0.487884,0,0.046657,0.046657,700.151084,358.42324,-341.727844,6.280698,7.019501,0.738803000000002,14.436765,1.160801,-13.275964,4.362967,2.290383,-2.072584,15.634003,0.685335,-14.948668,6.531613,2.760728,-3.770885,3.536982,1.80572,-1.731262,35.820615,1.195598,-34.625017,0,1.735938,1.735938,,,
2006-07-01,15102.719941,3068,-12034.719941,28875.3,15865.6,-13009.7,156232,84328,-71904,9740.540984,0,-9740.540984,11406.416855,6014.1,-5392.316855,24151,19211,-4940,9477.211488,7611.254747,-1865.956741,12256.677262,7251.175498,-5005.501764,38391.090179,27029.222514,-11361.867665,33603.945552,18256.319366,-15347.626186,8144.197402,1362.92461,-6781.272792,53167.465367,20947.635132,-32219.830235,157768,79354.303564,-78413.696436,64245.095604,23634.8979,-40610.197704,1597.880834,1600.70761,2.82677599999965,1125.632496,1815.665611,690.033115,5713.002221,909.155362,-4803.846859,1.532671,0.211477,-1.321194,22926.596456,16621.086123,-6305.51033299999,0.07876,0.004637,-0.074123,15464.493723,10408.136391,-5056.357332,272.192824,306.966025,34.773201,15.251989,16.570217,1.318228,187.83424,174.103538,-13.730702,324.271678,283.904844,-40.366834,119.624362,61.904661,-57.719701,302.599214,339.577184,36.9779699999999,30.06528,236.680526,206.615246,1.059708,41.70291,40.643202,40.680759,182.985779,142.30502,0.062464,37.465033,37.402569,34.574619,177.75319,143.178571,0.540795,27.947544,27.406749,1.04369,46.541631,45.497941,43.109911,56.883415,13.773504,391.358516,434.251358,42.8928419999999,0.357416,3.653768,3.296352,0.751192,12.380958,11.629766,4.816161,6.56436,1.748199,0.352476,11.987586,11.63511,0.045138,0.472376,0.427238,0.233251,6.077785,5.844534,1.414461,14.161741,12.74728,0.086679,4.701744,4.615065,0.269508,4.848292,4.578784,2.559225,31.252717,28.693492,646.922489,119.980503,-526.941986,74.548727,86.776184,12.227457,,,,,,,284.893663,35.060411,-249.833252,0.120306,3.467379,3.347073,23.602417,3.325618,-20.276799,958.977769,510.368083,-448.609686,3796.452378,813.068995,-2983.383383,10.157786,13.327886,3.1701,13.214549,21.168862,7.954313,0,5.922203,5.922203,491.719081,260.877719,-230.841362,455.149987,189.395539,-265.754448,33.595852,12.594203,-21.001649,760.850235,596.719919,-164.130316,2550.9951,1542.651879,-1008.343221,3.823964,73.393689,69.569725,51.82022,46.6884,-5.13181999999999,323.690439,395.027551,71.337112,0.986744,0.021293,-0.965451,13.453576,27.12439,13.670814,1168.983205,287.268217,-881.714988,0,0.185683,0.185683,610.187782,223.191455,-386.996327,511.178652,218.015094,-293.163558,0.27549,0.54673,0.27124,560.148318,166.452887,-393.695431,4559.942652,3641.951246,-917.991405999999,2520.979507,507.261599,-2013.717908,1750.760637,2252.598573,501.837935999999,1386.181839,1597.340759,211.15892,49.131056,65.068162,15.937106,0.015013,0.293323,0.27831,1.880966,0.967949,-0.913017,3078.743444,1679.197346,-1399.546098,7405.705453,3224.890725,-4180.814728,625.398951,166.815489,-458.583462,,,,218.906074,83.34673,-135.559344,107.604229,13.894113,-93.710116,218.545135,81.220368,-137.324767,27.848364,1.261436,-26.586928,1143.663634,1011.118072,-132.545562,47.692525,7.606466,-40.086059,22.38242,19.240652,-3.141768,55.04402,48.041944,-7.00207600000001,189.309495,112.273932,-77.035563,,,,1826.332748,377.405081,-1448.927667,75.540459,4.701445,-70.839014,184.941354,56.585837,-128.355517,4.245692,5.33926,1.093568,37.630426,18.626076,-19.00435,5.734678,16.797051,11.062373,103.453197,34.139329,-69.313868,0.277404,3.950598,3.673194,3.44727,2.903777,-0.543493000000001,0.032476,1.754845,1.722369,29.63492,3.886387,-25.748533,22.063055,2.525773,-19.537282,874.29141,493.670099,-380.621311,385.627285,76.167188,-309.460097,0.148198,55.152955,55.004757,24.170048,12.007732,-12.162316,0.15559,1.064682,0.909092,0.047836,0.831074,0.783238,2960.147609,950.108351,-2010.039258,,,,29.742468,8.407279,-21.335189,44.644186,18.416537,-26.227649,1.536195,0.464568,-1.071627,2.533066,1.689805,-0.843261,7.607863,12.553525,4.945662,,,,,,,,,,1.181742,1.876837,0.695095,107.926308,132.754862,24.828554,87.592971,34.998312,-52.594659,41.765331,15.830351,-25.93498,465.647426,464.59396,-1.05346599999996,1.883904,9.94245,8.058546,21.211932,11.303339,-9.908593,4.807723,90.39061,85.582887,1274.083999,100.990404,-1173.093595,10.021069,9.370349,-0.650720000000002,395.9,347.9,-48,0.297635,0,-0.297635,0.270628,0.004833,-0.265795,137.96537,68.304027,-69.661343,287.79282,144.619737,-143.173083,,,,2881.519812,632.593311,-2248.926501,28.565221,156.798197,128.232976,111.272545,613.868338,502.595793,1.528664,21.175043,19.646379,154.255249,111.589481,-42.665768,58.897014,47.385396,-11.511618,7.62756,41.46325,33.83569,1783.215064,696.200213,-1087.014851,347.38905,85.06433,-262.32472,9.044063,2.586159,-6.457904,282.364231,26.011297,-256.352934,181.660653,11.449041,-170.211612,0,0.550557,0.550557,1975.08691,605.546431,-1369.540479,772.890264,88.664163,-684.226101,0.793503,1.900223,1.10672,200.808611,5.891874,-194.916737,3256.374948,1012.92696,-2243.447988,1678.750528,1783.76954,105.019012,1120.168985,275.996427,-844.172558,0.002085,1.788778,1.786693,71.030793,4.682,-66.348793,832.581703,635.663378,-196.918325,118.305155,13.777575,-104.52758,0.339236,0.067903,-0.271333,0.064679,1.618951,1.554272,24632.010765,4806.275103,-19825.735662,14.472054,2.835231,-11.636823,0,0,0,3853.995351,2555.700317,-1298.295034,695.749494,1391.125986,695.376492,3248.716115,1880.658904,-1368.057211,12557.582243,4797.472678,-7760.109565,799.049263,1452.133568,653.084305,0.003839,0.026752,0.022913,0.14447,0.004782,-0.139688,0.044375,0.04138,-0.002995,0,0.009675,0.009675,4.52528,3.834474,-0.690806,298.624744,333.618222,34.993478,0.212906,0.339172,0.126266,0.431397,4.389135,3.957738,0,0.059625,0.059625,0.320565,0.779265,0.4587,0.06235,0.679898,0.617548,0.193641,1.471414,1.277773,0,0.07629,0.07629,0.038531,0.134523,0.095992,0,0.007265,0.007265,3.391603,2.275124,-1.116479,0,0.018163,0.018163,5.904941,8.07282,2.167879,1.446914,1.424553,-0.0223609999999996,0.054396,2.343669,2.289273,0.017981,0.802563,0.784582,0.043894,0.041931,-0.00196300000000001,10.649855,2.243512,-8.406343,0.444676,0.881027,0.436351,50.036102,58.162653,8.12655100000001,1885.211156,78.498745,-1806.712411,35.541841,26.064904,-9.476937,206.519846,51.571377,-154.948469,193.204935,257.763882,64.558947,0.285,1.302277,1.017277,,,,0,0,0,72.031654,21.639227,-50.392427,0.00106,4.250246,4.249186,14.607033,7.51855,-7.088483,0.199275,5.453136,5.253861,0.809054,2.330583,1.521529,6.212322,5.143725,-1.068597,2.63453,3.356129,0.721599,66.710331,11.385435,-55.324896,17.061798,13.426673,-3.635125,0.020402,2.2912,2.270798,35.375637,6.551049,-28.824588,0.032853,28.753801,28.720948,2667.289467,209.398115,-2457.891352,0.452329,0.467454,0.015125,144.542435,7.709464,-136.832971,135.79003,3.726203,-132.063827,0.121468,0.269021,0.147553,0.037072,1.746442,1.70937,0.028676,9.185306,9.15663,1402.023036,70.349884,-1331.673152,320.080062,34.844089,-285.235973,0,0.680323,0.680323,0.330026,1.729956,1.39993,0.00835,0.140665,0.132315,15.749245,6.097224,-9.652021,2.304173,2.751546,0.447372999999999,0.00869,0.465387,0.456697,0.294347,0.380232,0.085885,0.060179,1.209562,1.149383,2.7,5.6,2.9,0.234558,4.356646,4.122088,0.145793,3.167373,3.02158,1.102188,6.861607,5.759419,30.85182,22.986018,-7.865802,0.836097,0.966515,0.130418,0,0.099709,0.099709,2.04965,10.37392,8.32427,18.403951,2.079326,-16.324625,0.213604,6.089663,5.876059,27.164019,2.127371,-25.036648,0,0,0,0,0.00868,0.00868,0.310322,0.065416,-0.244906,0,0.020085,0.020085,613.616113,367.459987,-246.156126,18.267212,6.212452,-12.05476,22.058351,1.316433,-20.741918,2.47374,2.578795,0.105055000000001,13.369087,0.943774,-12.425313,3.784334,1.887787,-1.896547,2.853113,1.151308,-1.701805,43.075604,0.016295,-43.059309,0,3.881951,3.881951,,,
2006-08-01,15205.98892,3441.1,-11764.88892,28457.7,17415.4,-11042.3,159838,86715,-73123,11725.524374,0,-11725.524374,14288.750795,7339,-6949.750795,24923,20683,-4240,9951.46393,8269.103809,-1682.360121,12311.917013,7583.961302,-4727.955711,44337.912509,32002.683946,-12335.228563,33724.831281,19971.307984,-13753.523297,7976.768066,1750.181937,-6226.586129,55989.070895,21596.692362,-34392.378533,167558,88245.688647,-79312.311353,68201.502468,25169.632229,-43031.870239,1672.537779,1655.892106,-16.6456729999995,1004.076567,1767.64941,763.572843,5541.807241,1032.339274,-4509.467967,0.46214,0.271501,-0.190639,26299.179437,20287.498898,-6011.680539,0.164482,0.000338,-0.164144,18038.733072,11715.185048,-6323.548024,264.593176,300.246358,35.653182,14.570568,20.407423,5.836855,191.638545,165.633721,-26.004824,346.229635,320.438192,-25.791443,136.38659,54.054556,-82.332034,321.680854,334.995238,13.3143839999999,25.226247,246.384774,221.158527,1.002096,89.115251,88.113155,25.539145,230.389932,204.850787,0,11.71108,11.71108,28.563283,163.005952,134.442669,1.379016,37.359451,35.980435,1.970873,60.759352,58.788479,42.125945,60.984027,18.858082,412.008979,480.524041,68.5150620000001,0.129718,5.498473,5.368755,0.839551,10.752017,9.912466,3.305121,7.022398,3.717277,0.477702,10.532798,10.055096,0.01779,0.615247,0.597457,0.115246,5.687622,5.572376,1.418428,11.634009,10.215581,0.078876,5.178348,5.099472,0.232335,4.710861,4.478526,3.137238,37.957908,34.82067,678.091159,140.847749,-537.24341,106.224069,114.494528,8.27045899999996,,,,,,,172.722697,44.149849,-128.572848,0.518525,7.690472,7.171947,0.080162,4.080839,4.000677,743.767233,589.50287,-154.264363,3542.930903,738.111964,-2804.818939,9.752644,12.739505,2.986861,12.395863,20.523507,8.127644,0,6.808839,6.808839,763.227968,206.981158,-556.24681,529.540418,240.185623,-289.354795,40.788106,13.918408,-26.869698,912.156999,486.945536,-425.211463,2650.224201,1716.070534,-934.153667,5.653461,92.714976,87.061515,28.225069,47.096486,18.871417,292.947413,425.471993,132.52458,0.003166,0.027437,0.024271,13.044768,24.28723,11.242462,890.034877,354.058863,-535.976014,0,0.084752,0.084752,761.734454,193.73597,-567.998484,460.272009,311.414059,-148.85795,0.046462,0.221797,0.175335,503.443527,172.83112,-330.612407,4605.272892,3722.360076,-882.912816,2460.854485,526.081299,-1934.773186,1681.792328,2504.186677,822.394349000001,1182.343643,1840.268109,657.924466,34.911969,43.320072,8.408103,0,0.369591,0.369591,2.760683,7.111103,4.35042,3002.329432,1902.957813,-1099.371619,7687.369726,3553.661615,-4133.708111,633.301927,335.769374,-297.532553,,,,228.211294,90.742682,-137.468612,143.260652,21.831038,-121.429614,211.020321,86.922091,-124.09823,28.196607,1.505876,-26.690731,1116.001423,1161.476859,45.4754360000002,86.657198,31.536836,-55.120362,29.598778,20.211788,-9.38699,61.385312,60.825954,-0.559357999999982,176.800204,133.645137,-43.155067,,,,2412.482012,378.494871,-2033.987141,92.524992,11.97588,-80.549112,115.70745,66.0416,-49.66585,3.947105,10.042045,6.09494,20.950456,23.368645,2.418189,9.455893,17.286627,7.830734,65.994716,31.274048,-34.720668,0.126002,1.332695,1.206693,3.489761,2.898552,-0.591208999999999,0,2.657189,2.657189,4.775794,5.900424,1.12463,0.8496,2.859273,2.009673,885.197641,549.780597,-335.417044,332.77795,124.272948,-208.505002,0.110317,29.287271,29.176954,25.13818,10.500382,-14.637798,0.354539,2.329761,1.975222,0.184038,1.350615,1.166577,2997.765309,867.203575,-2130.561734,,,,15.064834,17.043361,1.978527,38.196465,22.719747,-15.476718,1.576169,7.141986,5.565817,2.705024,1.330225,-1.374799,5.821764,11.279744,5.45798,,,,,,,,,,0.494682,4.860836,4.366154,97.806593,121.731491,23.924898,91.399709,34.637984,-56.761725,40.222402,26.346965,-13.875437,457.09668,477.330998,20.2343179999999,1.970233,6.609868,4.639635,2.370123,12.296113,9.92599,6.590781,8.601222,2.010441,1478.957846,69.298596,-1409.65925,10.760567,6.217676,-4.542891,334.9,398.7,63.8,0.08554,0,-0.08554,0.627456,0.031099,-0.596357,133.328762,60.581947,-72.746815,373.96548,152.691514,-221.273966,,,,3129.226488,777.903756,-2351.322732,8.457206,140.309904,131.852698,175.217993,984.756504,809.538511,71.978968,11.069721,-60.909247,163.863577,135.116583,-28.746994,34.15589,40.40793,6.25203999999999,3.779823,31.876624,28.096801,2100.30516,893.641797,-1206.663363,319.981177,94.201084,-225.780093,8.895091,1.125214,-7.769877,332.732616,22.945414,-309.787202,197.186589,12.789332,-184.397257,0.00221,0.934159,0.931949,2095.344137,630.459539,-1464.884598,804.229866,88.056245,-716.173621,0.500977,1.321273,0.820296,209.854855,5.394185,-204.46067,3479.790727,1106.741402,-2373.049325,1665.441951,2082.45457,417.012618999999,1315.802137,245.846438,-1069.955699,0,1.127015,1.127015,60.521941,3.988778,-56.533163,891.445793,700.090563,-191.35523,105.804455,18.055507,-87.748948,0.010109,0.013535,0.003426,0.033825,1.204129,1.170304,26713.335235,4603.268577,-22110.066658,12.243893,1.289462,-10.954431,0,0,0,4015.626252,2888.299098,-1127.327154,733.237983,1429.149267,695.911284,3537.157744,1869.200874,-1667.95687,12495.400032,4914.185508,-7581.214524,693.733792,1573.129477,879.395685000001,0.0029,0.022522,0.019622,0.656315,0.161377,-0.494938,0.020436,0.002069,-0.018367,0,0.01378,0.01378,7.76763,3.361835,-4.405795,274.005223,158.920468,-115.084755,0.074426,0.14892,0.074494,0.11853,2.433964,2.315434,0,0.041729,0.041729,0.259119,1.631491,1.372372,0.199397,0.451557,0.25216,0.210989,0.699101,0.488112,0,0.145282,0.145282,0.214453,0.072967,-0.141486,0,0.064786,0.064786,5.937249,9.437752,3.500503,0.005658,0.007786,0.002128,4.844815,8.042565,3.19775,1.633202,1.455976,-0.177226,0.083837,2.438179,2.354342,0.078438,1.043093,0.964655,0.030233,0.233955,0.203722,13.746202,2.658707,-11.087495,0.459381,0.975447,0.516066,38.245968,77.522095,39.276127,1854.523987,130.139381,-1724.384606,28.910233,41.225143,12.31491,129.515804,45.24383,-84.271974,230.543754,436.826391,206.282637,0.305,6.798561,6.493561,,,,0,0,0,159.833483,149.059943,-10.77354,0.019385,2.499058,2.479673,76.031396,14.610413,-61.420983,7.366016,7.629877,0.263860999999998,0.674257,1.15664,0.482383,7.139986,6.355033,-0.784953000000002,6.680689,3.052898,-3.627791,54.588113,27.7184,-26.869713,24.157144,28.377758,4.220614,0.002251,0.828331,0.82608,2.341349,8.15708,5.815731,0.032886,4.022286,3.9894,2387.019366,163.920447,-2223.098919,0.354909,0.390934,0.036025,174.428128,11.100494,-163.327634,247.912919,2.099889,-245.81303,0.000491,0.116852,0.116361,0.628386,1.368762,0.740376,0.056561,11.42556,11.368999,1199.688397,71.02285,-1128.665547,253.236384,9.616961,-243.619423,0.043891,0.170513,0.126622,0.096944,0.74173,0.644786,0.033302,1.193706,1.160404,13.201966,5.857503,-7.344463,7.414206,11.54939,4.135184,0.068137,0.425266,0.357129,0.581742,1.135516,0.553774,0.006965,2.885712,2.878747,2.9,2.7,-0.2,0.050898,0.629441,0.578543,0.155286,2.65863,2.503344,1.616519,3.363706,1.747187,40.79135,36.000366,-4.79098400000002,0.867015,0.905085,0.03807,0.043919,0.010849,-0.03307,1.878836,6.097006,4.21817,22.170082,5.486258,-16.683824,1.118149,2.078698,0.960549,27.984333,0.996457,-26.987876,0,0,0,0.011336,0.007439,-0.003897,0.679754,0.142034,-0.53772,0,0.000323,0.000323,720.483641,393.941398,-326.542243,16.179208,4.725824,-11.453384,10.452444,1.327302,-9.125142,2.268668,4.911383,2.642715,14.630506,0.618019,-14.012487,10.491851,2.942518,-7.549333,2.801771,2.558485,-0.243285999999999,38.5447,0.13228,-38.41242,0,0,0,,,
2006-09-01,13388.103084,3587.5,-9800.603084,25538.9,18274.1,-7264.8,157913,87510,-70403,11097.33688,0,-11097.33688,13304.270546,6979.1,-6325.170546,26202,21610,-4592,9299.079921,8618.890303,-680.189618000002,11369.054905,7662.577772,-3706.477133,41863.823999,30229.444566,-11634.379433,30112.816416,20874.382492,-9238.43392400002,7510.71795,1836.250414,-5674.467536,55210.601387,21630.740935,-33579.860452,158470,87545.4838179999,-70924.5161820001,66649.866819,25213.379286,-41436.487533,1588.187631,1661.34379,73.1561589999997,962.997384,1720.070446,757.073062,5485.64053,1296.537929,-4189.102601,0.341364,0.484584,0.14322,24966.349827,19249.056574,-5717.293253,0.000529,0.00371,0.003181,16897.474172,10980.387992,-5917.08617999999,269.272218,272.675807,3.40358899999995,8.933557,18.168934,9.235377,178.943386,166.070452,-12.872934,323.686982,311.520414,-12.1665679999999,120.115426,56.984809,-63.130617,295.87328,363.12035,67.2470699999999,35.304631,245.879959,210.575328,1.57994,40.440377,38.860437,35.416568,222.067897,186.651329,0,28.567343,28.567343,76.843904,167.864411,91.020507,1.082062,37.573426,36.491364,1.157796,56.754749,55.596953,46.952725,70.299735,23.34701,400.296339,490.971958,90.6756189999999,0.164286,4.808458,4.644172,0.483056,8.959838,8.476782,4.499045,7.554259,3.055214,0.735199,15.718933,14.983734,0.014652,0.796863,0.782211,0.070819,6.632522,6.561703,1.364237,13.028299,11.664062,0.210224,4.89916,4.688936,0.378413,4.988224,4.609811,2.125725,37.928526,35.802801,589.213315,167.091627,-422.121688,83.472518,84.683732,1.21121400000004,,,,,,,161.296623,39.063493,-122.23313,0.22409,7.584016,7.359926,0.016916,3.093718,3.076802,817.081355,609.480224,-207.601131,3063.250138,771.223509,-2292.026629,13.826618,12.433171,-1.393447,13.917709,24.436222,10.518513,0.269978,1.84399,1.574012,628.141585,267.959524,-360.182061,544.036806,220.419972,-323.616834,31.914349,17.452242,-14.462107,936.687749,473.282625,-463.405124,2309.022967,1707.089648,-601.933319,8.24517,82.574714,74.329544,41.338363,46.710819,5.37245599999999,320.898247,471.864566,150.966319,0.695939,0.014257,-0.681682,17.358544,31.170997,13.812453,1030.145568,359.224263,-670.921305,0,0.05187,0.05187,545.821011,199.218593,-346.602418,373.405332,218.624455,-154.780877,0.347181,0.669881,0.3227,519.010631,259.40188,-259.608751,4349.615791,3796.613223,-553.002568000001,2344.891995,689.396076,-1655.495919,1399.613026,2839.65516,1440.042134,1073.085488,1849.839023,776.753535,28.858986,40.057494,11.198508,0,1.272874,1.272874,0.988891,11.186051,10.19716,2918.080669,1862.305251,-1055.775418,6755.265741,3632.908648,-3122.357093,671.1456,246.24024,-424.90536,,,,175.820314,97.680917,-78.139397,173.330177,18.656979,-154.673198,223.302389,104.271193,-119.031196,18.213779,1.114703,-17.099076,1081.093863,1138.533344,57.4394809999999,16.599651,19.315768,2.716117,6.503249,23.543241,17.039992,45.266735,53.725775,8.45904000000001,172.823961,136.26223,-36.561731,,,,1902.066791,420.975162,-1481.091629,24.689442,5.433347,-19.256095,77.824687,51.859897,-25.96479,4.535505,5.053863,0.518358,174.448722,14.014603,-160.434119,9.370715,14.890859,5.520144,103.873944,82.269124,-21.60482,0.092956,8.144274,8.051318,3.018723,2.521769,-0.496954,0,0.454198,0.454198,5.818696,2.898999,-2.919697,27.089271,2.116999,-24.972272,672.10756,633.073297,-39.034263,215.790449,108.65619,-107.134259,0.017995,48.084897,48.066902,23.351743,10.583512,-12.768231,0.135693,0.59857,0.462877,0.373634,0.711284,0.33765,2203.048909,1095.762512,-1107.286397,,,,28.615558,6.497489,-22.118069,35.005558,26.659225,-8.34633300000001,1.447786,3.117174,1.669388,2.350415,1.86251,-0.487905,5.390596,16.471932,11.081336,,,,,,,,,,0.787516,3.234524,2.447008,94.945309,144.246793,49.301484,68.396748,60.508107,-7.88864099999999,26.265578,32.949062,6.68348399999999,443.508666,432.434714,-11.0739520000001,17.858679,7.357477,-10.501202,2.587858,18.898524,16.310666,2.499949,64.912445,62.412496,1120.225604,97.399383,-1022.826221,10.093617,4.496875,-5.596742,395,307.8,-87.2,0.093578,0,-0.093578,1.024861,0,-1.024861,144.716336,45.658851,-99.057485,346.851633,195.892499,-150.959134,,,,2786.884609,671.593594,-2115.291015,15.476882,118.271445,102.794563,135.118057,1063.144774,928.026717,37.149776,31.780859,-5.368917,126.486586,46.846973,-79.639613,40.870908,47.525361,6.65445299999999,2.028115,44.639281,42.611166,1983.734121,980.953269,-1002.780852,343.695139,133.455595,-210.239544,7.291162,1.550413,-5.740749,355.441524,22.079419,-333.362105,193.130957,13.777808,-179.353149,0,0.21078,0.21078,1991.435535,609.547081,-1381.888454,841.280932,97.755176,-743.525756,1.341943,0.637278,-0.704665,233.269665,6.150928,-227.118737,3254.522161,1004.68476,-2249.837401,1423.155896,2105.555753,682.399857,1263.351548,251.40506,-1011.946488,0,0.621562,0.621562,78.019211,3.23254,-74.786671,899.960217,632.868351,-267.091866,100.713215,14.666643,-86.046572,0.003,0.007802,0.004802,0.041712,2.027206,1.985494,27570.617915,4461.009876,-23109.608039,13.412958,1.454575,-11.958383,0,0,0,3687.467055,2878.187473,-809.279582000001,772.043349,1752.940757,980.897408,3416.413621,1882.20632,-1534.207301,11825.467364,4957.213129,-6868.254235,646.843223,1500.006606,853.163383000001,0,0.44785,0.44785,0.132603,0.08262,-0.049983,0,0.075374,0.075374,0,0.00075,0.00075,26.520708,2.240396,-24.280312,245.505904,184.523271,-60.982633,1.06156,0.07575,-0.98581,0.269853,3.238574,2.968721,0.050734,0.009968,-0.040766,0.233377,2.960263,2.726886,0.063025,0.448505,0.38548,0.106853,0.231044,0.124191,0.025253,0.238654,0.213401,0.31023,0.342574,0.0323439999999999,0.004352,0.003644,-0.000708,5.394006,3.416375,-1.977631,0.020882,0.000393,-0.020489,10.607316,11.653256,1.04594,2.58549,1.092347,-1.493143,0.065627,2.610198,2.544571,0.045707,0.904685,0.858978,0.009187,0.375911,0.366724,22.349538,4.034403,-18.315135,0.833977,1.025027,0.19105,46.259404,74.102187,27.842783,1584.353985,115.538427,-1468.815558,58.387168,22.393955,-35.993213,157.976627,76.544102,-81.432525,174.352716,299.808638,125.455922,0.515,2.586258,2.071258,,,,0,0,0,130.854839,19.881358,-110.973481,50.819213,6.257995,-44.561218,37.675291,13.55566,-24.119631,1.395708,4.946135,3.550427,0.393382,2.282277,1.888895,5.967342,7.444002,1.47666,4.595353,4.017017,-0.578336000000001,30.430368,7.631999,-22.798369,35.80648,15.917432,-19.889048,0.084611,0.861463,0.776852,14.443119,5.550933,-8.892186,0.291933,2.60405,2.312117,2277.126148,271.252853,-2005.873295,0.357409,0.515653,0.158244,161.509457,23.44861,-138.060847,190.336614,6.551099,-183.785515,0.008314,0.11286,0.104546,0.044367,0.199251,0.154884,0.043581,8.19365,8.150069,1259.265883,372.088647,-887.177236,437.222415,8.83062,-428.391795,0.000315,0.103792,0.103477,0.02056,1.033335,1.012775,0.034614,0.27196,0.237346,11.176194,3.99422,-7.181974,11.106748,5.345243,-5.761505,0.298615,0.250432,-0.0481830000000001,0.467843,0.693392,0.225549,0.076338,2.228704,2.152366,2.6,3.3,0.7,0.003839,0.232209,0.22837,0.671242,10.118499,9.447257,1.715464,1.452107,-0.263357,30.574744,18.651701,-11.923043,0.929644,1.010318,0.0806739999999999,0.071056,0.004809,-0.066247,2.521875,7.046699,4.524824,20.795512,1.947971,-18.847541,2.513679,6.402822,3.889143,31.555035,19.114194,-12.440841,0,0.004458,0.004458,0.017037,0.000121,-0.016916,0.32284,0.491228,0.168388,0.006994,0,-0.006994,634.390659,397.542389,-236.84827,4.155578,9.112154,4.956576,15.955617,3.21801,-12.737607,2.569181,4.32597,1.756789,11.634975,0.667377,-10.967598,6.336532,2.31885,-4.017682,2.404194,1.6728,-0.731394,38.151914,0.018287,-38.133627,0,8.890548,8.890548,,,
2006-10-01,11852.037895,3697.1,-8154.937895,28222.8,18763.9,-9458.9,153411,88264,-65147,11270.727009,0,-11270.727009,13654.63187,7339.5,-6315.13187,27237,21991,-5246,9762.112713,8161.954283,-1600.15843,10922.799499,8095.160531,-2827.638968,42595.99543,32276.114075,-10319.881355,32907.445818,21570.871432,-11336.574386,6452.033528,1835.987786,-4616.045742,59322.747355,22318.424799,-37004.322556,164028,91664.540853,-72363.459147,70257.668815,25821.587362,-44436.081453,1612.831887,1809.44698,196.615093,892.009517,2000.471263,1108.461746,4602.302531,1204.282682,-3398.019849,0.1445,0.439007,0.294507,25080.771902,19975.233182,-5105.53872,0,0.031861,0.031861,17515.223528,12300.880893,-5214.342635,246.041191,311.848169,65.806978,38.871003,17.411082,-21.459921,169.261906,229.022745,59.760839,314.587974,329.934965,15.3469909999999,149.243787,70.258709,-78.985078,303.650409,357.815845,54.165436,30.667819,224.009099,193.34128,2.387726,37.522472,35.134746,29.156908,189.088246,159.931338,0,24.837971,24.837971,31.116507,220.230781,189.114274,1.417699,32.474701,31.057002,0.601292,53.878783,53.277491,46.978252,76.791067,29.812815,430.04662,510.566547,80.519927,0.041513,4.089642,4.048129,3.076919,53.511395,50.434476,3.731957,7.649081,3.917124,0.373177,11.887322,11.514145,0.0027,0.703321,0.700621,0.103053,7.502394,7.399341,1.246499,16.116159,14.86966,0.123353,5.487332,5.363979,0.365228,11.216813,10.851585,3.358864,38.871568,35.512704,569.175641,144.921124,-424.254517,50.220682,152.112511,101.891829,,,,,,,216.186723,32.278808,-183.907915,0.135024,7.233154,7.09813,16.923781,2.575577,-14.348204,758.232646,631.550628,-126.682018,2800.006148,932.177958,-1867.82819,7.318042,17.225592,9.90755,16.509492,21.234137,4.72464500000001,0.033319,1.039747,1.006428,638.472299,206.900517,-431.571782,487.348141,290.264838,-197.083303,29.704054,18.245458,-11.458596,792.223957,534.696416,-257.527541,2367.338643,1709.462254,-657.876389,6.772353,78.60358,71.831227,36.136426,41.718271,5.58184500000001,321.964409,429.991121,108.026712,1.645363,0.202631,-1.442732,20.502318,23.553121,3.050803,1122.296074,359.100444,-763.19563,0.000855,4.274701,4.273846,459.800146,217.153828,-242.646318,416.057335,266.816645,-149.24069,0.242671,0.201066,-0.0416049999999999,519.200215,193.054187,-326.146028,4660.341954,3748.325334,-912.016619999999,2178.568055,642.554076,-1536.013979,1322.609392,2731.127564,1408.518172,1283.634899,1964.504297,680.869398,44.787605,38.346849,-6.440756,0.046009,0.605663,0.559654,10.44088,0.318102,-10.122778,3316.321903,2136.204052,-1180.117851,7383.229966,3883.871081,-3499.358885,997.39133,238.121338,-759.269992,,,,201.458703,100.625663,-100.83304,143.879243,59.045593,-84.83365,235.358501,111.781551,-123.57695,20.189293,0.897747,-19.291546,1641.699187,1319.223088,-322.476099,40.473763,17.820374,-22.653389,7.718701,22.267189,14.548488,31.741813,56.610571,24.868758,169.26006,188.489912,19.229852,,,,1383.133717,406.835834,-976.297883,55.863464,4.76143,-51.102034,174.371839,72.647468,-101.724371,5.290796,10.963229,5.672433,125.585977,45.149861,-80.436116,1.468488,24.519459,23.050971,98.834202,48.694662,-50.13954,0.267473,13.381127,13.113654,2.709564,2.664157,-0.0454070000000004,0.032568,0.902745,0.870177,3.122185,11.055128,7.932943,0.497796,10.608054,10.110258,907.111379,643.92273,-263.188649,234.785298,80.775949,-154.009349,0.110769,58.063831,57.953062,28.434772,12.116519,-16.318253,0.455421,0.32656,-0.128861,0.019872,1.096099,1.076227,2855.724084,1056.563979,-1799.160105,,,,33.466961,10.216202,-23.250759,51.960378,16.847874,-35.112504,2.389881,2.577349,0.187468,2.903095,1.598959,-1.304136,5.067321,15.065824,9.998503,,,,,,,,,,1.042234,1.573881,0.531647,69.424281,186.890653,117.466372,88.214189,50.764224,-37.449965,54.134455,9.832537,-44.301918,492.716623,437.467409,-55.2492140000001,1.055865,8.093663,7.037798,62.29791,37.346345,-24.951565,6.031234,113.456865,107.425631,797.951055,119.769751,-678.181304,11.67877,7.300355,-4.378415,389.4,423.1,33.7,0.021583,0.229831,0.208248,0.564207,0,-0.564207,126.487284,51.252207,-75.235077,435.051854,154.032666,-281.019188,,,,2366.948664,683.060438,-1683.888226,24.15348,121.932832,97.779352,109.816945,1046.331639,936.514694,28.786242,36.183354,7.397112,163.678243,201.248283,37.57004,57.922611,51.762388,-6.16022300000002,2.191798,48.141181,45.949383,2034.198163,860.343707,-1173.854456,331.510589,160.152767,-171.357822,7.28911,1.207727,-6.081383,310.09259,27.783241,-282.309349,188.052629,13.620539,-174.43209,0,0.787613,0.787613,2084.288526,597.440063,-1486.848463,826.177006,167.544391,-658.632615,0.471967,0.562252,0.0902849999999999,198.018683,6.891379,-191.127304,3294.930105,966.957116,-2327.972989,1643.919386,1984.66539,340.746004,1226.538722,297.258513,-929.280209,0,1.782684,1.782684,38.585035,3.402066,-35.182969,876.645325,671.914938,-204.730387,86.958492,14.889581,-72.068911,0.023707,0.306294,0.282587,0.014318,2.050222,2.035904,29388.601739,4885.264175,-24503.337564,9.005406,1.411104,-7.594302,0,0,0,3964.97084,2632.267897,-1332.702943,746.092468,1485.859175,739.766707,3407.130019,2059.161821,-1347.968198,13787.730476,5346.8199,-8440.910576,621.265329,1630.58898,1009.323651,0.014506,0.353087,0.338581,0.110719,0.00416,-0.106559,0.028604,0.105395,0.076791,0,0.025252,0.025252,10.79225,2.849227,-7.943023,228.587169,336.52602,107.938851,0.15713,0.054606,-0.102524,0.3972,2.120359,1.723159,0.000455,0.011412,0.010957,0.256078,2.610887,2.354809,0.888468,0.485568,-0.4029,0.711667,0.197201,-0.514466,0.03461,0.022085,-0.012525,0.156277,0.109846,-0.046431,0.035,0.02745,-0.00755000000000002,2.4003,2.832578,0.432278,0,0.02,0.02,7.572099,10.607063,3.034964,1.629513,1.337355,-0.292158,0.084714,2.224281,2.139567,0.047943,0.948328,0.900385,0.064226,0.319337,0.255111,16.093368,5.375119,-10.718249,0.743992,0.656034,-0.0879580000000001,52.782607,46.3674,-6.41520699999998,1340.590784,56.266183,-1284.324601,60.733464,20.740169,-39.993295,226.251717,52.716477,-173.53524,131.907617,439.203173,307.295556,0.985,1.308892,0.323892,,,,0,0,0,103.475188,36.377113,-67.098075,0.060789,30.238082,30.177293,4.870009,4.055007,-0.815002,0.254702,4.968407,4.713705,1.141029,0.82216,-0.318869,9.538441,5.783304,-3.755137,2.560589,4.30658,1.745991,33.533919,16.111835,-17.422084,7.429743,23.506466,16.076723,0.005733,1.565693,1.55996,0.982303,7.644394,6.662091,0.058923,22.245778,22.186855,2016.329636,210.125604,-1806.204032,0.553321,6.321485,5.768164,85.006681,11.467681,-73.539,157.627763,3.282288,-154.345475,0.016763,0.063621,0.046858,0.074727,0.496055,0.421328,0.034712,13.391386,13.356674,1047.924602,125.920475,-922.004127,173.513887,10.413168,-163.100719,0.008119,0.110799,0.10268,0.243119,1.208736,0.965617,0.032916,0.530747,0.497831,11.393859,7.930484,-3.463375,11.57498,6.28847,-5.28651,0.370042,0.286842,-0.0832,2.018775,0.571557,-1.447218,0.017653,0.466032,0.448379,2.2,3.2,1,0.0034,0.998439,0.995039,0.860487,5.750302,4.889815,2.133161,4.180987,2.047826,30.941137,63.657807,32.71667,0.793513,1.126287,0.332774,0,0.000107,0.000107,3.507498,21.034075,17.526577,19.534249,3.000905,-16.533344,0.542332,4.865571,4.323239,20.170025,1.612783,-18.557242,0,0.000074,0.000074,0.007554,0.014823,0.00726900000000001,0.495346,0.249696,-0.24565,0.090758,0.004255,-0.086503,742.265706,490.163078,-252.102628,5.311406,7.016467,1.705061,17.304475,3.028417,-14.276058,1.843276,6.442175,4.598899,14.0066,0.838046,-13.168554,9.803167,2.612364,-7.190803,6.528954,4.1223,-2.406654,51.721781,0.018611,-51.70317,0,63.877536,63.877536,,,
2006-11-01,10419.244881,3238,-7181.244881,28399.5,18577.1,-9822.4,154406,89566,-64840,10919.067523,0,-10919.067523,13203.879389,7027.5,-6176.379389,27205,22093,-5112,9162.574469,8344.193477,-818.380992,10129.220496,8442.860697,-1686.359799,42488.567914,31466.269603,-11022.298311,32403.883577,21355.686197,-11048.19738,5347.649446,1782.34871,-3565.300736,55834.658337,21692.065708,-34142.592629,157288,90044.409643,-67243.590357,65874.505159,25177.967335,-40696.537824,1558.288095,1727.830261,169.542166,1043.342954,1781.903126,738.560172,4050.682704,1163.242226,-2887.440478,1.236278,0.128113,-1.108165,25242.014932,19730.011013,-5512.003919,0.071044,0.002909,-0.068135,17246.552982,11736.25859,-5510.294392,244.583205,312.009394,67.4261889999999,8.874827,18.050095,9.175268,160.136401,178.053988,17.9175869999999,334.576267,295.956967,-38.6192999999998,120.319758,79.232983,-41.086775,331.464005,359.739991,28.2759859999999,30.981635,208.327832,177.346197,1.555283,38.458793,36.90351,43.515786,186.574694,143.058908,0,36.057663,36.057663,44.448252,186.18766,141.739408,1.118106,32.340881,31.222775,0.949261,48.587033,47.637772,46.984731,67.376917,20.392186,367.208459,502.836938,135.628479,0.099963,3.540448,3.440485,7.313905,12.614932,5.301027,4.485853,8.290321,3.804468,0.440534,14.088813,13.648279,0.214162,0.364091,0.149929,0.239999,5.530457,5.290458,1.081405,19.962422,18.881017,0.111674,5.558516,5.446842,0.362147,5.306025,4.943878,2.749359,49.102595,46.353236,627.790815,142.42877,-485.362045,81.110253,166.899805,85.789552,,,,,,,220.758445,52.753976,-168.004469,0.025048,5.77021,5.745162,0.183853,2.563838,2.379985,596.379579,622.431796,26.0522169999999,2541.666438,913.442494,-1628.223944,6.859081,16.732679,9.873598,8.539118,25.335204,16.796086,0.022724,5.85276,5.830036,526.615145,276.685096,-249.930049,503.598564,314.565728,-189.032836,30.799238,20.635938,-10.1633,545.658323,902.174933,356.51661,2285.140727,1762.48248,-522.658247,8.159649,84.184302,76.024653,37.359725,50.81668,13.456955,353.39865,402.320569,48.921919,1.340144,0.63299,-0.707154,18.645132,17.733945,-0.911187000000002,1167.808798,364.649776,-803.159022,0.01682,0.074528,0.057708,479.800571,216.882796,-262.917775,412.617459,247.666555,-164.950904,0.57772,0.164163,-0.413557,459.049411,193.427228,-265.622183,4593.638679,3875.231385,-718.407294,2514.9661,738.371376,-1776.594724,1355.152974,2845.085875,1489.932901,1046.889979,1957.526361,910.636382,43.554387,36.030624,-7.52376299999999,1.355525,0.633458,-0.722067,1.491257,1.136752,-0.354505,3146.979381,1892.883506,-1254.095875,7819.43924,3560.520161,-4258.919079,844.043051,261.365694,-582.677357,,,,180.181851,95.254786,-84.927065,199.881918,18.600885,-181.281033,192.93922,102.408201,-90.5310189999999,21.236099,0.955498,-20.280601,1338.44017,1318.428004,-20.012166,13.531083,17.71946,4.188377,7.40544,22.516107,15.110667,9.675124,55.918766,46.243642,183.786133,160.871683,-22.91445,,,,1061.351345,446.695925,-614.65542,19.727124,5.762152,-13.964972,119.2407,60.37227,-58.86843,4.195006,5.249862,1.054856,143.514068,18.690527,-124.823541,20.821375,24.231966,3.410591,107.042798,50.356789,-56.686009,0.120148,16.336438,16.21629,2.587441,1.952426,-0.635015000000001,0.025402,9.381569,9.356167,1.831302,17.415462,15.58416,57.706313,3.467153,-54.23916,861.755538,732.101724,-129.653814,302.761078,151.7424,-151.018678,0.044301,0.58432,0.540019,34.404455,11.176748,-23.227707,0.139036,0.223277,0.084241,0.00285,2.851843,2.848993,2867.685327,1027.077737,-1840.60759,,,,40.728179,9.074437,-31.653742,48.509803,22.705746,-25.804057,1.767498,1.921727,0.154228999999999,2.661621,1.968117,-0.693504,5.86114,12.602763,6.741623,,,,,,,,,,0.607971,2.117269,1.509298,90.418746,174.263767,83.845021,84.031221,41.073837,-42.957384,31.5541,28.622812,-2.931288,437.230215,461.676943,24.4467280000002,2.453954,11.930618,9.476664,25.256178,39.485864,14.229686,11.182677,90.620824,79.438147,729.507298,81.413982,-648.093316,12.64987,5.099122,-7.550748,453.6,309.2,-144.4,0.000374,0,-0.000374,0.156819,0.082251,-0.074568,113.083005,45.544109,-67.538896,392.924005,149.606148,-243.317857,,,,2417.654264,610.865408,-1806.788856,23.246724,116.161677,92.914953,90.025224,718.220525,628.195301,28.960967,26.058473,-2.90249399999999,11.499435,62.88024,51.380805,44.040618,41.539798,-2.50082000000001,2.827771,46.203229,43.375458,1798.149604,753.993223,-1044.156381,283.281502,128.732886,-154.548616,7.193422,1.081134,-6.112288,245.7636,29.908733,-215.854867,162.870021,15.163173,-147.706848,0,0.463501,0.463501,2046.053379,1162.82267,-883.230709,719.504977,105.977084,-613.527893,0.513179,0.381305,-0.131874,191.962149,6.422071,-185.540078,2947.932215,1033.49649,-1914.435725,1494.770848,2193.751823,698.980975000001,1073.425068,247.777418,-825.64765,0,1.339464,1.339464,32.571902,2.765731,-29.806171,764.125439,652.006036,-112.119403,76.00084,20.443571,-55.557269,0.088028,0.010777,-0.077251,0.13935,1.269599,1.130249,27775.079221,4595.822622,-23179.256599,5.429609,1.853262,-3.576347,0,0,0,3836.742727,2615.626266,-1221.116461,625.270938,1545.952264,920.681326,3205.789956,1988.863124,-1216.926832,12987.179619,5045.287544,-7941.892075,787.851603,1552.041351,764.189748,0.02909,0.245188,0.216098,0.086704,0.003706,-0.082998,0.034985,0.02905,-0.005935,0,0.001429,0.001429,8.063757,3.171802,-4.891955,219.854204,195.059666,-24.794538,0.107624,0.167947,0.060323,0.40334,1.763156,1.359816,0.022184,1.773257,1.751073,0.230043,1.24731,1.017267,0.105373,0.653271,0.547898,0.131795,0.498928,0.367133,0.00586,0.032954,0.027094,0.105005,0.235047,0.130042,0.000314,0.001554,0.00124,7.072973,7.14565,0.0726769999999997,0,0.016132,0.016132,3.671923,8.251345,4.579422,0.720762,2.223977,1.503215,0.132795,2.089627,1.956832,0.026636,0.600939,0.574303,0.014031,0.249837,0.235806,14.126226,3.348171,-10.778055,0.503208,0.896357,0.393149,33.684376,49.345904,15.661528,795.637109,115.20643,-680.430679,53.305946,46.572134,-6.73381200000001,228.309528,51.646981,-176.662547,176.721951,325.136396,148.414445,0.515,12.27161,11.75661,,,,0,0.015801,0.015801,47.189011,23.800497,-23.388514,0.026117,8.569996,8.543879,23.280749,11.751579,-11.52917,8.209337,12.004053,3.794716,0.417901,7.197679,6.779778,5.358579,6.552715,1.194136,3.928172,5.573939,1.645767,31.355549,11.519564,-19.835985,7.654988,34.497005,26.842017,0.006458,1.453272,1.446814,0.059193,3.374793,3.3156,0.045915,5.496482,5.450567,1883.389488,198.564413,-1684.825075,0.225716,5.535768,5.310052,106.986993,10.807569,-96.179424,139.634946,12.525655,-127.109291,0.065466,0.149974,0.084508,0.034406,1.287255,1.252849,0.006155,11.026203,11.020048,768.972604,258.633036,-510.339568,272.941363,6.550654,-266.390709,0.017843,0.091751,0.073908,0,0.364599,0.364599,0,0.179707,0.179707,11.562846,7.034069,-4.528777,12.241929,11.503515,-0.738414000000002,0.001559,0.054737,0.053178,1.495264,0.416792,-1.078472,0,0.415177,0.415177,3.9,5,1.1,0.103643,0.250136,0.146493,0.028819,1.365379,1.33656,0.72943,5.060129,4.330699,28.592157,75.147466,46.555309,0.753337,1.44889,0.695553,0.00482,0.023825,0.019005,3.758686,6.86868,3.109994,13.777051,2.734214,-11.042837,0.005406,3.794657,3.789251,21.639626,2.761903,-18.877723,0,0,0,0.315871,0.000246,-0.315625,0.581221,1.024302,0.443081,0.000652,0.009181,0.008529,564.905184,365.902103,-199.003081,15.615864,8.187111,-7.428753,14.083673,2.642635,-11.441038,1.74049,5.209232,3.468742,10.936635,0.573044,-10.363591,2.758156,3.445626,0.68747,8.436935,2.030897,-6.406038,32.442561,0.003708,-32.438853,0,37.242953,37.242953,,,
2006-12-01,11192.718221,3787.4,-7405.318221,27643.4,18616.4,-9027,158312,89984,-68328,9640.768772,0,-9640.768772,12184.53173,6550.1,-5634.43173,25105,22070,-3035,8747.963665,9218.474301,470.510636000003,10092.508845,7893.313619,-2199.195226,38961.484282,28022.044697,-10939.439585,31846.345621,21622.822028,-10223.523593,6519.250897,1727.857772,-4791.393125,51376.823577,22700.734505,-28676.089072,148952,87839.198022,-61112.801978,60448.080819,26808.411416,-33639.669403,1464.626471,1592.214348,127.587876999999,1082.905335,1757.823203,674.917868,4846.147853,1111.457412,-3734.690441,1.372847,0.268806,-1.104041,23889.411366,17980.933748,-5908.477618,0.051598,0,-0.051598,15072.072916,10041.110949,-5030.961967,231.390854,281.176289,49.785435,6.143315,17.5199,11.376585,158.280909,176.999056,18.7181469999999,297.760735,310.710126,12.9493909999999,119.127757,53.19736,-65.930397,291.882221,332.074379,40.1921580000001,26.519439,230.920319,204.40088,0.847707,33.188637,32.34093,37.911864,186.649527,148.737663,0,24.132126,24.132126,47.216912,222.56079,175.343878,1.077153,36.917854,35.840701,0.860467,51.544714,50.684247,38.123888,66.619196,28.495308,366.183995,438.057138,71.8731430000001,0.277651,3.874746,3.597095,0.870032,10.108307,9.238275,3.88106,9.162936,5.281876,0.229707,27.91398,27.684273,0.060884,0.188635,0.127751,0.142942,5.194103,5.051161,1.067301,11.206183,10.138882,0.97294,8.723863,7.750923,0.296129,7.421083,7.124954,2.333715,37.603851,35.270136,723.556845,136.01429,-587.542555,103.880225,135.65018,31.769955,,,,,,,208.796239,41.688605,-167.107634,0.173293,11.46828,11.294987,0.078522,4.914524,4.836002,561.174804,661.890336,100.715532,2727.09163,760.53692,-1966.55471,8.353327,18.18513,9.831803,26.45753,19.15601,-7.30152,0.021394,0.928727,0.907333,553.340798,249.858927,-303.481871,480.581911,272.521567,-208.060344,30.301777,25.271273,-5.030504,811.466334,472.12039,-339.345944,1857.539138,1969.449403,111.910265,5.32488,64.823051,59.498171,31.056616,38.635114,7.57849800000001,329.849706,426.448264,96.5985580000001,0.004299,0.08753,0.083231,17.306412,38.204972,20.89856,1166.56011,342.724728,-823.835382,0,0.023258,0.023258,660.154225,181.403922,-478.750303,357.479648,203.204761,-154.274887,0.660904,0.683388,0.0224839999999998,427.811823,198.499876,-229.311947,4226.052009,3543.205364,-682.846645,2275.577855,645.760993,-1629.816862,1507.260146,2729.291012,1222.030866,954.678375,1974.292205,1019.61383,34.204318,50.620445,16.416127,1.154188,0.45396,-0.700228,1.639303,1.006995,-0.632308,3166.307375,1952.174372,-1214.133003,7922.936671,3737.629902,-4185.306769,875.812231,235.658216,-640.154015,,,,185.42564,106.24051,-79.18513,170.360753,15.759807,-154.600946,204.225159,122.570413,-81.654746,40.090271,1.58351,-38.506761,1124.275621,1555.943958,431.668337,29.996212,24.432667,-5.56354500000001,6.639017,21.951889,15.312872,9.572041,55.485856,45.913815,164.009176,498.861507,334.852331,,,,1457.456716,417.31021,-1040.146506,49.535767,11.59046,-37.945307,134.115217,72.711266,-61.403951,5.005716,9.507273,4.501557,147.050514,13.53886,-133.511654,4.645219,61.272921,56.627702,18.529421,56.622035,38.092614,0.127173,8.531716,8.404543,2.233013,4.074238,1.841225,0.031104,1.84164,1.810536,3.298882,1.816662,-1.48222,1.919086,4.171551,2.252465,840.177945,696.495837,-143.682108,269.364767,159.807024,-109.557743,0.004431,39.657296,39.652865,25.508852,10.660995,-14.847857,0.190148,1.01457,0.824422,0.642655,1.337359,0.694704,2719.259816,1136.086224,-1583.173592,,,,27.135993,25.004932,-2.131061,45.496901,19.605752,-25.891149,1.913921,1.0848,-0.829121,1.761166,1.480798,-0.280368,6.111244,12.824665,6.713421,,,,,,,,,,0.37079,5.690541,5.319751,47.263689,127.391482,80.127793,88.561492,45.791556,-42.769936,34.296384,14.180915,-20.115469,372.743139,416.079847,43.336708,11.404977,7.970117,-3.43486,34.85959,17.85989,-16.9997,7.794602,43.447631,35.653029,644.270934,183.849915,-460.421019,12.778923,7.006409,-5.772514,363,395.2,32.2,0.026217,0,-0.026217,0.060861,0,-0.060861,116.774347,64.122206,-52.652141,254.175186,330.149437,75.974251,,,,2301.169472,786.777181,-1514.392291,20.746621,130.402167,109.655546,76.596375,1036.919841,960.323466,0.397641,19.601253,19.203612,6.952711,51.843367,44.890656,52.15855,35.585323,-16.573227,1.890336,35.561372,33.671036,1758.767123,931.687537,-827.079586,259.74084,293.546752,33.805912,6.526426,0.999457,-5.526969,237.524851,25.444768,-212.080083,170.893803,18.25032,-152.643483,0,0.419007,0.419007,1753.659058,742.396219,-1011.262839,621.017747,102.884071,-518.133676,1.259926,0.141897,-1.118029,176.003553,7.917945,-168.085608,3142.682415,912.191612,-2230.490803,1395.154038,2530.559773,1135.405735,1066.528891,262.622042,-803.906849,0,1.033708,1.033708,28.386106,8.983162,-19.402944,728.661387,614.357705,-114.303682,72.505712,21.907643,-50.598069,0.183677,0.242356,0.058679,0.244193,1.994714,1.750521,24109.185573,5015.788165,-19093.397408,6.212255,1.790694,-4.421561,0,0,0,3713.000968,2955.622445,-757.378522999999,526.882537,1659.748688,1132.866151,3112.926122,2072.543395,-1040.382727,12418.596058,4917.34811,-7501.247948,775.061932,1542.053447,766.991515000001,0.000302,0.366708,0.366406,0.034093,0.004166,-0.029927,0.014457,0.129657,0.1152,0,0.131083,0.131083,5.908666,5.171873,-0.736793000000003,281.343172,181.836445,-99.506727,0.149571,0.053061,-0.09651,0.238013,2.200646,1.962633,0,0.44619,0.44619,0.398151,2.598058,2.199907,0.027954,1.395964,1.36801,0.095458,0.367967,0.272509,0,0.265504,0.265504,0.100569,0.128061,0.027492,0,0.02262,0.02262,6.66035,3.794547,-2.865803,0,0.01136,0.01136,2.900739,8.825096,5.924357,0.557624,1.39037,0.832746,0.152571,2.842113,2.689542,0.071747,1.089126,1.017379,0.002879,0.22365,0.220771,8.616386,1.743052,-6.873334,0.533733,0.693885,0.160152,64.02122,75.679207,11.657987,1216.615245,84.629677,-1131.985568,14.344808,41.652852,27.308044,150.291633,55.201913,-95.08972,237.716741,391.491484,153.774743,0,16.394358,16.394358,,,,0,0.000262,0.000262,122.213296,27.816055,-94.397241,0.005666,20.938079,20.932413,13.31237,14.806501,1.494131,1.187704,11.437855,10.250151,0.603703,5.24158,4.637877,5.120693,3.306766,-1.813927,3.83538,2.480018,-1.355362,115.087302,8.824876,-106.262426,24.276237,22.708531,-1.56770599999999,0.006594,1.074402,1.067808,0.046483,8.488458,8.441975,0.221421,21.791882,21.570461,2209.288492,181.873201,-2027.415291,0.068403,1.181363,1.11296,125.786566,7.073297,-118.713269,170.427109,6.109593,-164.317516,1.008135,0.056324,-0.951811,0.011291,1.726031,1.71474,0.021683,16.164503,16.14282,1037.251803,58.244339,-979.007464,176.800949,23.676205,-153.124744,0.008575,2.525004,2.516429,0,0.373687,0.373687,0.021528,0.197083,0.175555,11.337137,6.156869,-5.180268,8.87467,6.257697,-2.616973,0.35457,0.504998,0.150428,0.891873,0.449828,-0.442045,0.011555,0.429835,0.41828,2,1.7,-0.3,0.006896,0.102245,0.095349,0.084359,8.197263,8.112904,1.398953,4.620541,3.221588,26.076968,82.196507,56.119539,0.937809,1.148795,0.210986,0,0.013392,0.013392,3.679675,19.361773,15.682098,14.889478,5.464557,-9.424921,6.229721,8.852611,2.62289,23.487619,0.900492,-22.587127,0.004087,0.234726,0.230639,0.051252,0.0096,-0.041652,0.004153,0.195445,0.191292,0,0.007357,0.007357,622.025437,426.192072,-195.833365,15.403233,39.382212,23.978979,16.806675,2.674283,-14.132392,3.106337,3.769829,0.663492,19.743486,0.660189,-19.083297,21.968831,5.164957,-16.803874,9.248404,2.126857,-7.121547,30.271532,0.798035,-29.473497,0,6.656481,6.656481,,,
2007-01-01,11588.603365,2968.4,-8620.203365,26094.340693,19237.506334,-6856.834359,156000,90847,-65153,9266.59103,0,-9266.59103,12312.288634,5736.3,-6575.988634,25367,20398,-4969,9544.10564,8014.782561,-1529.323079,10163.194628,7949.18056,-2214.014068,40488.215775,28487.060089,-12001.155686,29619.221314,21651.233875,-7967.98743900001,6770.653073,1497.930684,-5272.722389,52540.611241,20939.157022,-31601.454219,150833,85127.8451940001,-65705.1548059999,62788.416497,23775.869629,-39012.546868,1267.730351,1680.954779,413.224428,1002.635885,1766.251102,763.615217,4987.846896,914.391103,-4073.455793,0.712608,0.319255,-0.393353,25114.800993,17803.555238,-7311.245755,0,0,0,15373.414782,10683.504851,-4689.909931,230.14491,336.345056,106.200146,5.830802,16.080378,10.249576,153.409581,163.354836,9.945255,254.361797,312.963923,58.6021260000001,117.447542,61.081045,-56.366497,269.552957,387.895737,118.34278,23.71759,208.83086,185.11327,1.979411,78.68266,76.703249,64.744124,158.422313,93.678189,0,23.123868,23.123868,57.605283,169.190479,111.585196,0.755097,32.954319,32.199222,4.181234,43.555275,39.374041,26.152208,54.134949,27.982741,242.813564,419.314182,176.500618,0.440031,3.126303,2.686272,0.367547,10.994198,10.626651,3.951022,8.122212,4.17119,1.010899,21.74501,20.734111,0.00092,0.274372,0.273452,0.113146,6.665935,6.552789,1.365442,11.308803,9.943361,0.045062,5.13789,5.092828,0.257858,6.434945,6.177087,2.686977,32.311704,29.624727,694.728944,138.695647,-556.033297,85.573334,120.892315,35.318981,,,,,,,278.032804,51.61234,-226.420464,0.202982,14.61301,14.410028,0.202915,9.305167,9.102252,736.297482,603.23023,-133.067252,2463.278621,696.446659,-1766.831962,6.860999,14.412425,7.55142600000001,10.845439,21.163224,10.317785,0,0.322317,0.322317,564.564445,238.401497,-326.162948,441.228417,270.46198,-170.766437,40.311793,19.025533,-21.28626,941.010838,493.035935,-447.974903,2045.625431,2175.901602,130.276171,5.089539,73.481851,68.392312,50.098087,36.911662,-13.186425,336.307554,399.190508,62.882954,0,0.025406,0.025406,18.562368,27.357222,8.794854,1070.226689,341.846604,-728.380085,0,0.084847,0.084847,546.052556,214.706848,-331.345708,396.992006,217.893291,-179.098715,0.580236,0.119425,-0.460811,395.713557,173.044035,-222.669522,4063.137708,3622.017089,-441.120619000001,2657.39232,685.944051,-1971.448269,1164.076162,3016.182563,1852.106401,1136.203813,1822.939572,686.735759,49.700184,41.453596,-8.246588,0.112935,0.786735,0.6738,1.653025,2.451672,0.798646999999999,2960.541485,2272.98178,-687.559705,6853.538936,3618.648074,-3234.890862,644.853571,391.626391,-253.22718,,,,184.330094,109.450864,-74.87923,115.88441,56.933354,-58.951056,198.176528,104.578799,-93.597729,17.805199,1.178151,-16.627048,1092.894171,1070.023973,-22.8701979999996,37.026723,16.381542,-20.645181,6.258115,32.171318,25.913203,36.324022,55.337846,19.013824,162.833691,262.277227,99.443536,,,,999.451038,383.216713,-616.234325,41.557785,10.437647,-31.120138,103.763482,71.800324,-31.963158,1.894078,4.58203,2.687952,151.110582,10.006178,-141.104404,0.646077,23.376739,22.730662,112.049164,50.315415,-61.733749,0.201767,3.538853,3.337086,1.587841,3.611507,2.023666,0.022164,1.061199,1.039035,21.360486,2.747428,-18.613058,1.017285,5.18565,4.168365,797.274739,689.85163,-107.423109,272.521917,182.907732,-89.614185,0.06095,65.269139,65.208189,20.617771,24.715985,4.098214,0.235467,0.33449,0.099023,0.036079,0.966582,0.930503,2640.800791,1130.206975,-1510.593816,,,,22.620414,9.943974,-12.67644,44.112742,19.377918,-24.734824,1.983195,1.268783,-0.714412,7.562943,1.44304,-6.119903,,,,,,,,,,0.258797,2.065609,1.806812,1.36053,1.547336,0.186806,71.044637,283.460995,212.416358,89.392662,40.816111,-48.576551,23.626687,17.746009,-5.880678,373.400838,440.317297,66.9164589999999,1.738733,6.714983,4.97625,51.443916,25.713509,-25.730407,7.506527,74.355105,66.848578,910.310027,161.435349,-748.874678,21.192074,5.294961,-15.897113,450.1,355.5,-94.6,0.019416,0,-0.019416,0.034333,3.2719,3.237567,96.482509,42.837936,-53.644573,247.258548,212.025955,-35.232593,,,,2498.92817,562.855813,-1936.072357,45.015932,104.675136,59.659204,109.876266,544.033059,434.156793,0.863595,13.412284,12.548689,12.76221,43.142678,30.380468,45.552005,44.182095,-1.36991,3.499227,34.804306,31.305079,1992.246987,897.659428,-1094.587559,296.289001,72.334703,-223.954298,7.37365,1.032386,-6.341264,313.473903,23.198211,-290.275692,197.487103,12.004497,-185.482606,0,0.494368,0.494368,1810.691392,656.207313,-1154.484079,743.854424,94.771875,-649.082549,0.980682,0.50812,-0.472562,216.607983,7.401438,-209.206545,2781.485983,932.255877,-1849.230106,1571.79751,2022.990419,451.192909,1290.932422,278.480118,-1012.452304,0.179852,0.857539,0.677687,54.685028,61.041404,6.35637599999999,756.561337,611.688162,-144.873175,83.146063,21.091031,-62.055032,0.001821,0.01237,0.010549,0.344604,1.076899,0.732295,25640.562672,4389.534621,-21251.028051,5.595809,0.843827,-4.751982,0,0,0,4220.107523,2691.192374,-1528.915149,528.6519,1548.106733,1019.454833,3223.548707,1752.493035,-1471.055672,11405.55833,4888.515046,-6517.043284,701.877893,1421.338216,719.460323,0,0.489688,0.489688,0.079603,0.024753,-0.05485,0.006107,0.108598,0.102491,0,0.007419,0.007419,18.228324,2.809889,-15.418435,263.467549,317.620097,54.152548,0.057146,0.188637,0.131491,0.733359,1.01599,0.282631,0,0.263273,0.263273,0.27855,0.798399,0.519849,0.081579,0.971671,0.890092,0.043196,0.314209,0.271013,0,0,0,0.136197,0.047882,-0.088315,0,0.008365,0.008365,2.498638,4.810098,2.31146,0,0.015595,0.015595,5.541763,6.510146,0.968382999999999,0.769335,1.662461,0.893126,0.259736,2.360464,2.100728,0.000643,1.764011,1.763368,0.007146,0.602158,0.595012,7.87464,1.562196,-6.312444,0.677626,0.855084,0.177458,47.837337,65.652638,17.815301,1374.928981,96.11268,-1278.816301,26.995512,36.063883,9.068371,56.755145,53.234764,-3.52038100000001,174.845207,354.731159,179.885952,1.043862,2.40727,1.363408,,,,0,0,0,263.787937,27.060888,-236.727049,0.004195,39.191523,39.187328,29.292781,3.884096,-25.408685,2.69603,10.354617,7.658587,0.308643,2.587576,2.278933,10.991212,4.451918,-6.539294,2.166463,1.161205,-1.005258,56.669561,12.837211,-43.83235,8.084645,20.804698,12.720053,0.0011,0.681845,0.680745,0.53128,3.414343,2.883063,3.344609,18.917325,15.572716,2160.022706,167.413863,-1992.608843,0.742977,1.160015,0.417038,279.093544,12.936829,-266.156715,103.007913,5.66148,-97.346433,0.014044,0.103113,0.089069,0.564772,2.813012,2.24824,0.022327,14.218851,14.196524,1036.064412,109.073359,-926.991053,206.884354,8.363151,-198.521203,0,0.356253,0.356253,0.096549,0.315588,0.219039,0.019379,0.56122,0.541841,7.554907,6.440174,-1.114733,2.6182,6.272486,3.654286,0.221812,0.023427,-0.198385,0.600586,0.26482,-0.335766,0.00036,0.347238,0.346878,2.4,1.6,-0.8,0.007231,0.111954,0.104723,0.203827,4.557086,4.353259,2.878561,2.190653,-0.687908,23.883157,28.54986,4.666703,0.687827,0.61149,-0.076337,0,0.040464,0.040464,3.273733,6.814462,3.540729,16.444552,2.277936,-14.166616,0.629704,9.359861,8.730157,27.683349,0.832488,-26.850861,0,0.003896,0.003896,0.229066,0.000159,-0.228907,1.021913,0.321188,-0.700725,0,0.00012,0.00012,633.762065,336.042375,-297.71969,11.940945,18.091092,6.150147,23.039477,3.416784,-19.622693,3.980616,5.547739,1.567123,12.100308,2.050953,-10.049355,2.859074,1.643049,-1.216025,7.698106,3.184511,-4.513595,37.342323,0.028588,-37.313735,0,0,0,,,
2007-02-01,9336.611302,2890.2,-6446.411302,25379.174648,18811.204232,-6567.970416,155097,88931,-66166,9605.736653,0,-9605.736653,11957.207488,6229.2,-5728.007488,23455,18755,-4700,8276.271663,7582.621863,-693.649799999999,9092.540352,7366.091774,-1726.448578,38821.61162,28314.515116,-10507.096504,28794.991014,21396.651985,-7398.339029,5551.019125,1807.931329,-3743.087796,48327.382133,20195.297066,-28132.085067,139793,83797.2218970001,-55995.7781029999,56777.545156,23316.321142,-33461.224014,1464.209059,1676.272617,212.063558,754.054928,1595.523838,841.46891,4065.955306,1112.249997,-2953.705309,1.435193,0.186713,-1.24848,23678.810656,18334.478229,-5344.332427,0,0,0,15142.800964,9980.036887,-5162.764077,239.755918,268.572695,28.816777,12.054445,17.891861,5.837416,154.171118,167.470027,13.298909,294.931422,330.769599,35.838177,113.537002,54.35264,-59.184362,308.33619,365.629881,57.2936910000001,27.441726,221.558443,194.116717,0.781278,30.667822,29.886544,41.425868,174.028082,132.602214,0.202151,22.02421,21.822059,47.96016,176.695067,128.734907,0.86188,27.260235,26.398355,1.610197,45.662039,44.051842,43.293136,53.095651,9.802515,353.477409,489.477775,136.000366,0.553243,3.745184,3.191941,0.87465,12.100946,11.226296,4.417273,9.543683,5.12641,1.348104,18.321432,16.973328,0.008003,0.451267,0.443264,0.16648,8.463903,8.297423,1.385351,11.724696,10.339345,0.186248,4.671385,4.485137,1.741755,8.510678,6.768923,2.065785,37.343981,35.278196,676.503038,136.45987,-540.043168,45.425356,114.185926,68.76057,,,,,,,186.820493,43.507825,-143.312668,0.464493,10.048526,9.584033,0.019983,23.404191,23.384208,652.017947,621.58651,-30.4314370000002,2237.819684,678.592576,-1559.227108,10.63573,18.672562,8.036832,6.935365,17.428515,10.49315,0.003079,0.855412,0.852333,397.197632,284.429199,-112.768433,399.20454,281.461966,-117.742574,24.106773,19.238221,-4.86855200000001,770.748352,553.626406,-217.121946,1645.163841,1540.295947,-104.867894,4.150347,68.410054,64.259707,49.751559,38.766747,-10.984812,332.952348,355.072417,22.120069,0.033,0.015722,-0.017278,18.066437,29.208869,11.142432,1054.129711,332.441029,-721.688682,0.228752,0.015897,-0.212855,524.543754,203.31012,-321.233634,386.996993,212.33627,-174.660723,0.441444,0.214971,-0.226473,447.548689,171.247839,-276.30085,3839.635271,4052.019807,212.384535999999,2452.677065,749.726565,-1702.9505,996.775675,2530.916357,1534.140682,1094.000021,1866.098604,772.098583,44.457474,42.811674,-1.6458,0.075237,1.197469,1.122232,1.474801,3.614155,2.139354,2976.38964,2158.645323,-817.744317,6991.008328,3662.237869,-3328.770459,797.292348,225.83831,-571.454038,,,,164.586202,75.789901,-88.796301,115.407451,79.948494,-35.458957,213.648925,109.994894,-103.654031,21.796844,1.405032,-20.391812,1119.506239,1110.782577,-8.72366200000033,30.92492,11.757991,-19.166929,21.76134,22.357273,0.595932999999995,34.044918,53.409543,19.364625,154.649588,152.836576,-1.81301199999999,,,,1127.333031,437.423714,-689.909317,54.450868,14.256947,-40.193921,61.843359,103.311356,41.467997,3.513797,3.288706,-0.225090999999999,1.522048,11.873908,10.35186,5.974684,29.790136,23.815452,86.402281,70.87174,-15.530541,0.006831,2.402104,2.395273,1.678486,2.591242,0.912756,0.03516,0.298116,0.262956,3.614668,47.583146,43.968478,1.973502,2.555751,0.582249,668.611062,700.831809,32.2207470000003,206.840545,174.520507,-32.320038,0.068923,29.170262,29.101339,24.243438,9.996824,-14.246614,0.017453,0.413642,0.396189,0.019746,0.731203,0.711457,2413.422777,1071.964621,-1341.458156,,,,26.854863,19.498747,-7.356116,42.150848,17.548663,-24.602185,1.144406,1.321857,0.177451,4.574701,3.313127,-1.261574,,,,,,,,,,0.133882,3.407868,3.273986,1.148122,1.250516,0.102394,106.78355,245.460697,138.677147,67.5368,50.041878,-17.494922,32.329007,24.524567,-7.80443999999999,344.472002,446.230013,101.758011,1.322062,5.900347,4.578285,3.425909,37.863229,34.43732,5.756942,42.909062,37.15212,568.725849,75.296814,-493.429035,20.460656,5.664346,-14.79631,389.8,351.8,-38,0.534412,0,-0.534412,0.071467,2.311672,2.240205,109.040536,38.118798,-70.921738,252.736141,125.54237,-127.193771,,,,1711.833978,567.927271,-1143.906707,9.87191,146.653596,136.781686,107.87805,638.942705,531.064655,36.505273,31.663831,-4.841442,5.427275,33.428158,28.000883,60.208991,43.243732,-16.965259,5.234203,39.558116,34.323913,1698.221607,834.346008,-863.875599,228.649441,245.961179,17.311738,5.73208,1.291636,-4.440444,239.978462,23.983587,-215.994875,162.697293,14.086075,-148.611218,0,1.692006,1.692006,1607.50462,623.355118,-984.149502,714.052604,100.090457,-613.962147,1.075711,0.274994,-0.800717,182.309161,10.949897,-171.359264,2594.750379,939.364008,-1655.386371,1413.088476,2068.250982,655.162506,1004.988239,241.46125,-763.526989,0.001791,0.737521,0.73573,55.425338,5.483107,-49.942231,702.590687,589.606842,-112.983845,88.446857,16.437024,-72.009833,0.036,0.077333,0.041333,0.450866,1.197774,0.746908,23038.880362,4532.889974,-18505.990388,8.382263,5.877416,-2.504847,0,0,0,3600.482592,2540.912451,-1059.570141,490.104924,1252.542237,762.437313,2772.595671,1720.916193,-1051.679478,11825.371805,4718.04918,-7107.322625,510.913755,1409.227957,898.314202,0,0.060195,0.060195,0.009955,0.00602,-0.003935,0.008637,0.019648,0.011011,0,0.003149,0.003149,5.61975,2.647835,-2.971915,224.123298,157.508026,-66.6152720000001,0.015086,0.044368,0.029282,0.078226,4.425849,4.347623,0,0.305866,0.305866,0.379421,0.75041,0.370989,0.16504,0.25453,0.08949,0.11929,3.610168,3.490878,0.00816,0,-0.00816,0.094186,0.069686,-0.0245,0.08353,0.054835,-0.028695,2.247265,2.870607,0.623342,0,0.015849,0.015849,2.13007,6.542554,4.412484,0.460491,1.478578,1.018087,0.15989,1.621369,1.461479,0,1.075644,1.075644,0.002567,0.125598,0.123031,6.971194,1.220067,-5.751127,0.554007,0.863133,0.309126,42.757481,130.544555,87.787074,1030.306276,90.95601,-939.350266,23.323648,30.603168,7.27952,95.770422,64.205257,-31.565165,132.28285,406.167371,273.884521,0,14.051303,14.051303,,,,0,0.091504,0.091504,118.438117,21.036387,-97.40173,0.020273,3.217335,3.197062,17.03154,10.70227,-6.32927,1.830068,7.413541,5.583473,0.2251,1.551762,1.326662,1.315934,4.781615,3.465681,3.411922,4.225041,0.813119000000001,102.278272,10.58279,-91.695482,4.688873,40.842358,36.153485,0.036621,1.532856,1.496235,0.116631,7.890451,7.77382,0.266567,20.278487,20.01192,2079.87968,207.605141,-1872.274539,0.121661,3.334382,3.212721,66.655841,9.624165,-57.031676,97.319298,5.206018,-92.11328,0,0.222619,0.222619,0.02105,0.505533,0.484483,0.011641,14.845725,14.834084,664.054449,74.844774,-589.209675,75.633188,10.595346,-65.037842,0,0.1623,0.1623,0,0.202495,0.202495,0,0.670099,0.670099,9.842459,5.891898,-3.950561,12.263556,1.540189,-10.723367,0.218231,0.888696,0.670465,0.596879,0.722223,0.125344,0.013645,0.071007,0.057362,1.5,1.2,-0.3,0.006513,0.150248,0.143735,0.019461,0.892901,0.87344,1.75687,1.644237,-0.112633,18.788322,192.555638,173.767316,0.755267,0.810728,0.055461,0.012173,0.006463,-0.00571,2.864243,25.824747,22.960504,14.440172,2.293538,-12.146634,0.268251,7.079303,6.811052,15.38725,0.753711,-14.633539,0,0,0,0.076264,0,-0.076264,0.517334,0.336003,-0.181331,0.01706,0.02445,0.00739,680.677061,346.388888,-334.288173,6.783449,9.058999,2.27555,14.100871,5.024185,-9.076686,1.111759,6.78508,5.673321,10.233702,1.166635,-9.067067,7.242213,4.949636,-2.292577,4.740743,3.195166,-1.545577,26.685288,0.773048,-25.91224,0,0,0,,,
2007-03-01,12058.303276,4067.3,-7991.003276,31283.564401,22717.819802,-8565.74459900001,161806,92877,-68929,11573.23936,0,-11573.23936,13975.764501,7663.3,-6312.464501,27343,23661,-3682,9330.092925,8909.648361,-420.444564000001,10851.648096,8405.472622,-2446.175474,45428.200401,33500.258013,-11927.942388,35527.420045,25657.999324,-9869.42072100001,7458.606545,2080.589431,-5378.017114,50754.766674,23953.367906,-26801.398768,161363,99459.1613389999,-61903.8386610001,61129.809088,27890.594725,-33239.214363,1709.450297,1810.368921,100.918624,966.381377,1919.178049,952.796672,5535.442264,1391.921973,-4143.520291,0.668616,0.079493,-0.589123,27237.591846,22006.797583,-5230.79426300001,0.069492,0.070093,0.000601000000000032,18190.608555,11493.46043,-6697.148125,285.067476,331.989719,46.922243,13.051866,21.825859,8.773993,168.258605,202.645852,34.387247,347.575459,354.770991,7.19553199999984,121.832176,73.137102,-48.695074,390.732017,350.179354,-40.5526630000001,28.15136,303.033643,274.882283,1.203069,42.50563,41.302561,27.865901,173.397114,145.531213,0,21.54889,21.54889,94.630743,178.394266,83.763523,0.862195,28.3394,27.477205,1.410718,54.520682,53.109964,46.203274,67.252619,21.049345,395.984564,497.645903,101.661339,0.411111,11.480295,11.069184,0.420962,13.140525,12.719563,4.186336,8.973122,4.786786,1.19591,15.781839,14.585929,0.037936,0.456063,0.418127,0.235064,6.522269,6.287205,1.582666,17.183555,15.600889,0.311432,6.301882,5.99045,0.855824,8.096555,7.240731,4.060378,44.192262,40.131884,820.958123,154.574375,-666.383748,85.197419,124.19587,38.998451,,,,,,,244.155966,37.987236,-206.16873,0.359427,18.033228,17.673801,0.290899,16.164352,15.873453,642.6338,689.20179,46.5679900000001,2787.367494,854.020806,-1933.346688,8.178036,16.364366,8.18633,11.121085,14.203701,3.082616,0,6.687719,6.687719,428.69601,240.23711,-188.4589,372.287887,273.340443,-98.947444,30.350078,19.358,-10.992078,818.855624,649.403716,-169.451908,2222.909623,1832.711018,-390.198605,2.810172,104.76754,101.957368,43.241733,40.237164,-3.00456900000001,395.145453,480.451409,85.3059560000001,0.962225,0.217388,-0.744837,23.472464,38.296753,14.824289,1276.761357,418.685497,-858.07586,0.000469,0.056603,0.056134,608.776175,271.548616,-337.227559,408.513998,301.067465,-107.446533,0.982299,0.231599,-0.7507,578.193276,294.3737,-283.819576,4675.04036,5102.874764,427.834404000001,3138.897233,766.969841,-2371.927392,1500.670967,3115.454695,1614.783728,1328.873381,2104.665846,775.792465,40.690198,55.388954,14.698756,0.023299,1.785169,1.76187,1.2418,0.933669,-0.308131,3710.739412,2335.541112,-1375.1983,8351.802226,4567.330891,-3784.471335,874.468005,273.172143,-601.295862,,,,208.128763,99.174696,-108.954067,142.958164,53.183019,-89.775145,256.411927,129.676986,-126.734941,26.123738,1.526451,-24.597287,1212.274724,1107.552724,-104.722,9.481694,16.408227,6.926533,19.674591,21.808166,2.133575,43.008539,57.909685,14.901146,181.487279,186.248492,4.76121299999997,,,,1652.193774,558.005171,-1094.188603,35.035446,6.808406,-28.22704,95.078668,141.208199,46.129531,2.351175,16.608584,14.257409,1.74047,14.846535,13.106065,0.789945,21.289977,20.500032,89.489455,67.771789,-21.717666,0.29608,2.362278,2.066198,2.257857,2.273275,0.0154179999999995,0.095398,17.250304,17.154906,2.702466,1.778651,-0.923815,0.769682,6.87289,6.103208,975.114182,858.449531,-116.664651,275.937437,212.594474,-63.3429629999999,0.047704,9.462363,9.414659,25.031519,23.27198,-1.759539,0.610441,1.604511,0.99407,0.001079,0.663604,0.662525,3006.59425,1296.371671,-1710.222579,,,,33.682468,31.848526,-1.833942,43.511454,30.689744,-12.82171,1.915328,1.203305,-0.712023,2.376229,1.846035,-0.530194,,,,,,,,,,1.554745,2.131875,0.57713,0.53029,3.383489,2.853199,80.395943,319.361875,238.965932,97.801422,50.604516,-47.196906,32.175651,18.70257,-13.473081,444.565887,601.697024,157.131137,1.201173,7.839262,6.638089,2.844182,23.079627,20.235445,5.771557,43.709037,37.93748,735.701387,106.022991,-629.678396,22.47357,8.085158,-14.388412,428.5,383.2,-45.3,0.230235,0,-0.230235,0.08196,0.976862,0.894902,111.134194,53.998554,-57.13564,470.346,333.314505,-137.031495,,,,2014.20071,764.381925,-1249.818785,22.385568,162.158983,139.773415,90.383073,1071.72972,981.346647,37.216416,10.801608,-26.414808,7.550433,70.400023,62.84959,72.634088,57.218586,-15.415502,4.269595,42.375873,38.106278,2133.218622,924.625428,-1208.593194,278.560033,238.612937,-39.947096,7.229651,1.55184,-5.677811,317.088307,35.708113,-281.380194,207.845114,17.080854,-190.76426,0,0.402161,0.402161,1975.894639,585.388452,-1390.506187,741.587191,136.073679,-605.513512,2.817484,0.426713,-2.390771,220.920085,8.888588,-212.031497,2754.593438,1049.39583,-1705.197608,1668.381932,2320.162396,651.780464,1200.342108,328.595937,-871.746171,0.115,0.801702,0.686702,33.814532,7.79825,-26.016282,812.745031,690.053281,-122.69175,78.339615,21.451144,-56.888471,0.117316,0.05152,-0.065796,0.219556,2.303682,2.084126,22723.044235,5425.393888,-17297.650347,5.487133,1.308556,-4.178577,0,0,0,4211.723022,2954.611456,-1257.111566,493.179282,1724.124167,1230.944885,2956.808689,1910.750342,-1046.058347,12883.88267,5631.427701,-7252.454969,683.771616,1664.579612,980.807996,0,0.001506,0.001506,0.061786,0.011736,-0.05005,1.842391,0.169381,-1.67301,0,0.183088,0.183088,5.999796,6.978027,0.978231,248.140708,218.045875,-30.094833,0.022526,0.139219,0.116693,0.357497,2.803248,2.445751,0.0332,0.25087,0.21767,0.276211,1.594279,1.318068,0.085351,0.299912,0.214561,0.048662,1.067703,1.019041,0,0,0,0.114799,0.060102,-0.054697,0.000749,0.003081,0.002332,6.944234,2.492535,-4.451699,0,0.033393,0.033393,11.260878,12.719946,1.459068,0.700516,0.952826,0.25231,0.251228,1.746378,1.49515,0.011933,1.19496,1.183027,0.013814,0.117737,0.103923,5.979031,2.476691,-3.50234,0.448488,0.93067,0.482182,50.806103,119.092493,68.28639,1400.494107,93.174604,-1307.319503,25.024865,13.300983,-11.723882,200.261609,72.401304,-127.860305,240.757138,422.231536,181.474398,0,6.114393,6.114393,,,,0,0.176935,0.176935,50.362913,22.277177,-28.085736,0.083555,5.805753,5.722198,10.627118,13.951782,3.324664,1.995696,8.665441,6.669745,0.038158,2.70891,2.670752,7.301457,2.982752,-4.318705,4.356216,2.955152,-1.401064,68.412701,16.588147,-51.824554,14.999212,36.475714,21.476502,0,1.075567,1.075567,0.068452,6.04399,5.975538,0.069425,22.193516,22.124091,2632.28491,219.978302,-2412.306608,0.23144,1.72654,1.4951,151.534412,331.042331,179.507919,96.546632,10.278452,-86.26818,0,0.161908,0.161908,0.108059,0.934568,0.826509,0.10094,17.113794,17.012854,1248.329888,85.87431,-1162.455578,268.641292,9.804536,-258.836756,0.009017,0.151143,0.142126,0.362534,0.331675,-0.0308590000000001,0.051406,1.476858,1.425452,9.592719,7.761594,-1.831125,36.112413,6.0804,-30.032013,0.166426,0.561613,0.395187,0.386604,0.737904,0.3513,0.043429,0.706746,0.663317,3.8,2.6,-1.2,0.171686,0.183193,0.011507,0.789945,3.274647,2.484702,1.222795,5.251836,4.029041,27.77707,19.144114,-8.632956,0.805527,0.878146,0.0726189999999997,0,0.012887,0.012887,3.384902,12.529231,9.144329,14.150747,1.785875,-12.364872,0.479681,7.3039,6.824219,25.967251,2.1813,-23.785951,0,0,0,0.00625,0.028526,0.022276,0.012422,0.601502,0.58908,0.429087,0.000406,-0.428681,699.143621,448.541733,-250.601888,72.867671,6.582849,-66.284822,7.485523,8.684956,1.199433,0.732944,6.244245,5.511301,14.254258,15.840343,1.58608500000001,5.9743,2.750266,-3.224034,5.801305,1.886063,-3.915242,46.68627,1.438825,-45.247445,0,4.919589,4.919589,,,
2007-04-01,12614.837675,3408.1,-9206.737675,29325.262453,19819.033563,-9506.22888999999,159655,92573,-67082,9983.108884,0,-9983.108884,13108.460169,7440.1,-5668.360169,25219,20165,-5054,9060.782802,8601.931638,-458.851164,10765.227483,8069.115808,-2696.111675,42338.80166,31113.033108,-11225.768552,33900.977836,23344.724504,-10556.253332,7239.926794,1609.167271,-5630.759523,51208.982911,21865.845612,-29343.137299,156583,90877.426257,-65705.573743,61315.164123,25087.570459,-36227.593664,1543.099694,1691.624135,148.524441,1022.873665,1634.156922,611.283257,5116.540101,1012.331907,-4104.208194,0.522243,0.178656,-0.343587,26083.916916,20219.834664,-5864.082252,0,0.00647,0.00647,16254.884744,10893.198444,-5361.6863,297.662105,315.098473,17.436368,4.470956,21.935113,17.464157,144.668856,201.315803,56.6469469999999,300.607245,358.813814,58.206569,126.454759,70.187592,-56.267167,324.862376,321.895482,-2.96689400000008,24.82654,279.050276,254.223736,0.929428,35.505253,34.575825,27.605985,198.215321,170.609336,0,49.073661,49.073661,64.724594,157.890356,93.165762,1.54619,32.345314,30.799124,1.484058,67.149885,65.665827,43.18735,56.001383,12.814033,348.844353,424.312971,75.4686179999999,0.661533,8.133829,7.472296,4.314691,13.914339,9.599648,6.010701,8.507374,2.496673,0.65707,14.750834,14.093764,0.040856,0.69926,0.658404,0.169233,5.936406,5.767173,1.278359,10.668275,9.389916,0.090285,6.194587,6.104302,0.745133,5.626176,4.881043,2.489451,33.29032,30.800869,828.58482,124.095274,-704.489546,36.020212,175.445229,139.425017,,,,,,,259.450252,40.913721,-218.536531,0.840734,14.470857,13.630123,0.106364,17.087156,16.980792,594.773803,603.014858,8.24105499999985,3129.716101,820.797047,-2308.919054,10.688743,14.298914,3.610171,13.138525,21.493295,8.35477,0.050699,1.167709,1.11701,425.701546,260.427945,-165.273601,296.128096,257.404536,-38.72356,19.151379,18.443565,-0.707813999999996,832.653127,604.407184,-228.245943,2195.138568,1815.216893,-379.921675,4.066552,84.841605,80.775053,41.715247,65.840747,24.1255,348.96751,433.210104,84.242594,0.003098,0.027072,0.023974,16.164711,40.261996,24.097285,1193.60383,398.610128,-794.993702,0,0.068337,0.068337,627.689726,242.012022,-385.677704,546.755489,242.77452,-303.980969,0.83418,0.100266,-0.733914,474.968171,244.690602,-230.277569,4615.345324,4195.222485,-420.122839000001,2666.340947,551.066341,-2115.274606,1435.998587,2830.038972,1394.040385,1257.98476,1963.868811,705.884051,41.831307,66.687556,24.856249,0.047294,1.343016,1.295722,1.321692,2.176999,0.855307,3495.274145,2067.591816,-1427.682329,7858.304161,3975.351487,-3882.952674,904.982995,238.643016,-666.339979,,,,214.349552,107.563651,-106.785901,120.365286,55.44765,-64.917636,224.675757,104.763422,-119.912335,23.205923,1.081728,-22.124195,1204.529501,1770.260837,565.731336000001,45.37092,17.395355,-27.975565,10.406012,26.808979,16.402967,41.64178,58.581478,16.939698,189.539996,318.562936,129.02294,,,,1901.595741,551.504228,-1350.091513,90.766809,10.189,-80.577809,109.821273,100.738791,-9.082482,2.22674,6.291019,4.064279,69.618113,11.17611,-58.442003,8.931172,18.760846,9.829674,98.607333,66.886021,-31.721312,0.230016,9.474603,9.244587,1.952079,3.60171,1.649631,0.00178,1.225704,1.223924,2.545918,48.569637,46.023719,0.821926,4.586321,3.764395,747.98796,724.673884,-23.314076,237.597637,228.466484,-9.13115300000004,0.113947,26.868806,26.754859,23.458059,9.318471,-14.139588,0.046175,0.886073,0.839898,0,1.489939,1.489939,2717.603805,1110.340941,-1607.262864,,,,27.79947,22.868557,-4.930913,44.363228,20.670639,-23.692589,1.696058,0.957953,-0.738105000000001,3.875893,2.163047,-1.712846,,,,,,,,,,0.788971,1.268919,0.479948,0.696472,1.443357,0.746885,106.674326,145.060776,38.38645,85.400648,45.751251,-39.649397,23.322991,12.540501,-10.78249,376.556635,561.410281,184.853646,1.11478,58.541411,57.426631,3.757149,21.77069,18.013541,6.101458,70.535376,64.433918,895.874254,90.061777,-805.812477,16.276715,7.771075,-8.50564,400.3,488.1,87.8,0.048688,0,-0.048688,0.126912,1.182741,1.055829,108.839644,64.480432,-44.359212,299.460444,132.777933,-166.682511,,,,2652.313256,661.945421,-1990.367835,43.154759,148.576965,105.422206,97.927493,804.181018,706.253525,40.418405,31.209514,-9.20889099999999,52.886523,99.437184,46.550661,79.107711,46.159068,-32.948643,5.022076,31.294375,26.272299,1983.451473,772.755443,-1210.69603,265.146434,112.02044,-153.125994,5.777482,3.934528,-1.842954,268.574671,27.876317,-240.698354,165.252778,23.421882,-141.830896,0,2.633472,2.633472,1737.058182,668.343858,-1068.714324,788.611753,133.003084,-655.608669,2.928249,0.207149,-2.7211,171.051993,12.249075,-158.802918,2524.667372,920.731688,-1603.935684,1518.604315,1910.564269,391.959954,1079.258114,335.907626,-743.350488,0.001146,1.1203,1.119154,18.559106,18.032816,-0.526290000000003,677.322217,631.044881,-46.2773359999999,67.106933,19.489304,-47.617629,0.038924,1.652208,1.613284,0.186829,1.042094,0.855265,24241.522773,4703.951215,-19537.571558,5.438478,1.506702,-3.931776,0,0,0,4046.975313,2989.848586,-1057.126727,499.98876,1463.638976,963.650216,2995.214414,2237.879807,-757.334607,12548.103032,5035.366851,-7512.736181,690.079475,1414.269016,724.189541,0.007065,0.023003,0.015938,0.000553,0.000649,0.0000959999999999998,1.095315,0.09415,-1.001165,0,0.010353,0.010353,2.739354,6.337002,3.597648,298.841733,178.783575,-120.058158,0.067258,0.046764,-0.020494,2.250203,6.124923,3.87472,0.002898,0.044253,0.041355,0.355799,1.488235,1.132436,0.063398,0.394112,0.330714,0.10015,2.847596,2.747446,0,0,0,0.176707,0.181303,0.00459599999999999,0,0,0,12.240345,5.309096,-6.931249,0,0.046842,0.046842,2.763119,8.848906,6.085787,0.571905,3.065139,2.493234,0.391768,1.542551,1.150783,0.017104,0.727202,0.710098,0.16791,0.153942,-0.013968,10.55676,2.023971,-8.532789,0.371213,1.02306,0.651847,49.571268,91.404703,41.833435,1519.149069,97.298549,-1421.85052,61.045064,17.494681,-43.550383,346.168085,62.303979,-283.864106,259.925864,356.299345,96.373481,0.3,13.363824,13.063824,,,,0,0.002912,0.002912,48.945953,19.517621,-29.428332,0.245115,3.736574,3.491459,4.619173,3.381633,-1.23754,1.642083,12.588929,10.946846,0.426795,2.933702,2.506907,2.17043,6.17449,4.00406,4.408872,2.856015,-1.552857,55.269073,13.552974,-41.716099,7.510946,28.848713,21.337767,0.00165,1.297783,1.296133,0.28465,8.536785,8.252135,0.417192,41.497966,41.080774,2178.237735,198.774415,-1979.46332,0.076075,0.996277,0.920202,284.194523,12.386751,-271.807772,165.191408,3.979211,-161.212197,0.846887,0.167609,-0.679278,0.027576,3.084677,3.057101,0.201416,17.479426,17.27801,1124.499788,76.051209,-1048.448579,288.316324,11.854127,-276.462197,0,0.006334,0.006334,0.036712,0.080366,0.043654,0.149035,0.336586,0.187551,8.862519,6.683832,-2.178687,35.056732,1.539935,-33.516797,0.003249,0.079022,0.075773,1.126585,1.138504,0.011919,0.028412,0.056701,0.028289,2.1,2,-0.1,0.011709,0.197468,0.185759,1.059164,1.53231,0.473146,1.868502,6.881717,5.013215,25.11953,44.447137,19.327607,0.714641,0.73191,0.017269,0.002922,0.032548,0.029626,3.293727,6.390323,3.096596,13.914608,3.558593,-10.356015,0.512218,16.248287,15.736069,22.625755,7.31559,-15.310165,0,0,0,0.013129,0.027814,0.014685,0.0161,0.161888,0.145788,0.002584,0.062429,0.059845,734.882466,395.410403,-339.472063,16.158163,5.181551,-10.976612,12.287217,8.134287,-4.15293,7.472806,7.418131,-0.0546750000000005,12.537257,1.262158,-11.275099,4.292713,3.418908,-0.873804999999999,8.160591,4.220525,-3.940066,32.899916,0.054345,-32.845571,0,19.473059,19.473059,,,
2007-05-01,13950.720756,3506.8,-10443.920756,29714.407679,20837.103099,-8877.30458000001,161050,94330,-66720,11455.82523,0,-11455.82523,13454.076559,7951,-5503.076559,25358,21767,-3591,9832.208712,8382.069698,-1450.139014,11328.449549,8596.942652,-2731.506897,44938.93689,33748.590188,-11190.346702,34518.611868,24598.227531,-9920.384337,7978.283934,1573.323379,-6404.960555,51904.261708,22515.075595,-29389.186113,163323,96726.306297,-66596.693703,63439.976247,26197.803237,-37242.17301,1693.569953,1829.61094,136.040987000001,1118.710603,1992.903004,874.192401,5552.366329,1031.321271,-4521.045058,0.147132,0.756912,0.60978,26920.072184,21792.557749,-5127.514435,0.357816,0.012,-0.345816,18018.864706,11956.032439,-6062.832267,278.366836,353.599771,75.2329349999999,3.41801,20.539742,17.121732,160.508523,179.404636,18.896113,359.349685,393.042575,33.6928899999999,130.820735,69.690695,-61.13004,383.349972,356.22036,-27.1296119999999,35.331085,324.873282,289.542197,2.120431,56.893276,54.772845,40.778712,192.834167,152.055455,0,28.960331,28.960331,50.713116,176.75355,126.040434,1.006187,32.361353,31.355166,1.712757,56.595438,54.882681,41.427076,54.574897,13.147821,381.174202,477.652903,96.4787010000001,0.55897,5.688196,5.129226,18.383638,19.176999,0.793360999999997,4.492846,8.167575,3.674729,0.704543,16.866473,16.16193,0.285173,0.57931,0.294137,0.273743,9.212786,8.939043,1.707214,12.995785,11.288571,0.212445,6.186242,5.973797,1.17968,6.798578,5.618898,3.69977,34.841267,31.141497,660.973861,135.240252,-525.733609,74.575663,153.313038,78.737375,,,,,,,325.922202,48.956655,-276.965547,0.266138,11.735395,11.469257,0.250758,18.141388,17.89063,706.413149,652.043289,-54.36986,3428.72331,897.887217,-2530.836093,10.99799,18.412255,7.41426500000001,12.194238,20.5783,8.384062,0,1.773412,1.773412,512.904717,239.484955,-273.419762,388.096461,305.864806,-82.231655,39.275178,14.442449,-24.832729,800.011854,720.755918,-79.2559359999999,2037.840306,1833.240577,-204.599729,4.489192,104.09717,99.607978,47.467291,43.550363,-3.91692800000001,376.471892,482.717492,106.2456,0,0.197534,0.197534,18.608512,141.94818,123.339668,1117.28519,374.253365,-743.031825,0,0.031043,0.031043,756.001184,279.979248,-476.021936,557.5006,256.122962,-301.377638,0.826248,0.500677,-0.325571,468.990344,285.088795,-183.901549,5135.423402,4726.99734,-408.426062,2779.050992,631.382196,-2147.668796,1360.521615,2610.364299,1249.842684,1368.535231,2211.54839,843.013159,42.073756,53.213637,11.139881,0.016032,0.474986,0.458954,2.109656,2.007719,-0.101937,3207.737552,2280.222748,-927.514804000001,7702.587951,3989.239403,-3713.348548,848.332253,260.736772,-587.595481,,,,198.258501,171.960024,-26.298477,93.032781,48.857823,-44.174958,218.663305,102.571788,-116.091517,23.313731,1.974262,-21.339469,1269.265266,1776.341822,507.076556,36.241049,36.197257,-0.0437920000000034,6.598235,31.145568,24.547333,62.064757,63.39562,1.33086300000002,189.490045,166.569646,-22.920399,,,,1819.77158,616.890009,-1202.881571,98.449818,3.388219,-95.061599,58.139461,102.072288,43.932827,2.512632,18.401227,15.888595,137.680812,11.592865,-126.087947,19.473305,34.163121,14.689816,85.063982,96.28021,11.216228,0.056942,1.524968,1.468026,2.504844,2.41753,-0.0873140000000001,0.034905,1.094291,1.059386,15.647109,3.332465,-12.314644,38.51087,4.744199,-33.766671,909.639743,812.520912,-97.118831,272.438396,217.593587,-54.844809,2.503477,51.206799,48.703322,34.127331,27.07417,-7.053161,0.040786,0.957297,0.916511,0.011812,1.362287,1.350475,2841.291731,1180.737056,-1660.554675,,,,30.389585,10.831119,-19.558466,37.034175,30.926777,-6.107398,1.975746,2.775035,0.799288999999999,5.979281,7.590114,1.610833,,,,,,,,,,0.009141,1.444329,1.435188,1.4713,1.142307,-0.328993,123.69838,170.804822,47.106442,72.259439,55.272999,-16.98644,29.684613,24.511122,-5.173491,408.864999,576.780302,167.915303,1.846312,17.794021,15.947709,3.476738,12.232599,8.755861,12.729623,96.647863,83.91824,728.244047,123.247997,-604.99605,14.530345,5.025452,-9.504893,428.6,485.9,57.3,0.005225,0,-0.005225,0.220321,0.007689,-0.212632,95.692187,92.744344,-2.94784300000002,263.454923,184.434992,-79.019931,,,,3220.653326,761.639608,-2459.013718,42.375282,174.305732,131.93045,104.362051,670.099953,565.737902,50.148062,30.883721,-19.264341,114.347231,122.447331,8.1001,82.4952,39.947011,-42.548189,8.456448,43.495301,35.038853,1992.890597,1199.081008,-793.809589,325.027978,186.864256,-138.163722,8.978278,4.777409,-4.200869,267.674227,31.26854,-236.405687,143.298401,15.937327,-127.361074,0,0.992926,0.992926,1908.942929,597.610089,-1311.33284,833.258017,133.302028,-699.955989,3.177705,0.421032,-2.756673,164.109074,11.497472,-152.611602,2574.379971,924.004228,-1650.375743,1747.722034,1978.968741,231.246707,1164.879764,301.901884,-862.97788,0,1.437716,1.437716,38.673416,8.843985,-29.829431,709.41787,662.074137,-47.3437329999999,87.77173,22.013368,-65.758362,0.076009,0.096306,0.020297,0.09167,1.336408,1.244738,25290.574442,5129.43674,-20161.137702,3.934871,2.51707,-1.417801,0,0,0,4273.214007,2733.519092,-1539.694915,573.290542,1509.377705,936.087163,3237.982129,2160.20416,-1077.777969,11122.314069,5125.608915,-5996.705154,779.954014,1626.252235,846.298221,0.011269,0.205024,0.193755,0.112779,0.131489,0.01871,0.207527,0.714837,0.50731,0,0.01204,0.01204,7.470995,4.568275,-2.90272,296.616725,328.30213,31.685405,0.292442,0.040449,-0.251993,0.339439,3.594713,3.255274,0,0.059728,0.059728,0.571111,1.614694,1.043583,0.095059,0.332432,0.237373,0.052407,2.481266,2.428859,0,0,0,0.125952,0.181281,0.055329,0,0.042271,0.042271,8.093578,7.692835,-0.400743000000001,0,0.060367,0.060367,7.488443,7.149776,-0.338667,3.050911,2.18451,-0.866401,0.488122,2.152406,1.664284,0.021177,1.383922,1.362745,0.021889,0.036959,0.01507,13.256046,2.114889,-11.141157,0.440718,1.309316,0.868598,42.126542,85.344326,43.217784,1844.590778,86.526766,-1758.064012,29.764507,33.789053,4.02454600000001,125.589256,53.542619,-72.046637,273.045822,294.663724,21.617902,0.440125,7.090919,6.650794,,,,0,0,0,81.76383,23.641211,-58.122619,0.0149,3.570185,3.555285,27.796687,19.94955,-7.847137,1.640547,6.076275,4.435728,0.729713,2.604561,1.874848,4.137084,5.482282,1.345198,2.801525,6.016322,3.214797,74.885437,14.866581,-60.018856,20.621432,30.571696,9.95026399999999,0.00236,1.731034,1.728674,0.080056,12.681235,12.601179,0.106305,5.658548,5.552243,2554.968727,165.013694,-2389.955033,0.279795,1.115441,0.835646,243.314005,10.787774,-232.526231,126.335181,7.098418,-119.236763,0.006057,0.188102,0.182045,0.222092,4.481028,4.258936,0.045746,18.195428,18.149682,1000.010123,95.732349,-904.277774,346.554924,9.188815,-337.366109,0,0.151897,0.151897,0.111702,0.376052,0.26435,0.016422,0.506108,0.489686,6.810565,5.150075,-1.66049,12.446443,5.676088,-6.770355,0.034569,1.155114,1.120545,1.520423,1.584067,0.0636439999999996,0.022719,4.391513,4.368794,2.2,1.8,-0.4,0,0.066377,0.066377,0.295627,3.567722,3.272095,3.689781,11.038655,7.348874,26.07379,35.029436,8.95564599999999,0.662022,0.343337,-0.318685,0,0.018553,0.018553,5.210571,8.734598,3.524027,16.224257,2.59415,-13.630107,0.466478,5.644499,5.178021,28.576897,2.119717,-26.45718,0,0,0,0.005858,0.033223,0.027365,0.454476,0.476194,0.0217179999999998,0.024136,0.041721,0.017585,871.58731,441.221078,-430.366232,4.255618,11.909204,7.653586,17.897344,3.466705,-14.430639,4.277652,3.388271,-0.889381000000001,7.634474,0.979131,-6.655343,8.450298,3.957663,-4.492635,5.645796,3.911423,-1.734373,34.38636,0.23027,-34.15609,0,17.747394,17.747394,,,
2007-06-01,13194.484783,3870.2,-9324.284783,30372.474137,20515.694741,-9856.77939599999,163137,95344,-67793,11299.712995,0,-11299.712995,14156.057899,7866.1,-6289.957899,27631,23443,-4188,9245.819101,9589.34952,343.530418999997,10690.266269,8693.440048,-1996.826221,45814.850044,33328.684232,-12486.165812,34613.030813,24335.016931,-10278.013882,7576.208214,1867.212006,-5708.996208,53818.430299,24157.026853,-29661.403446,164462,97885.6889359999,-66576.3110640001,64722.962209,27812.587887,-36910.374322,1597.524838,1765.38311,167.858272,1043.601532,1832.403479,788.801946999999,5411.262046,1160.578889,-4250.683157,0.76006,0.656146,-0.103914,27837.403194,21767.480813,-6069.92238100001,0.214297,0.001108,-0.213189,17977.44685,11561.203419,-6416.243431,250.268982,328.869793,78.6008110000001,20.696674,16.796976,-3.899698,173.81302,193.260482,19.4474620000001,344.317652,342.703674,-1.61397800000009,123.181705,68.65152,-54.530185,359.111614,344.875775,-14.235839,28.499899,342.474727,313.974828,5.332311,47.250995,41.918684,27.586918,191.590091,164.003173,0,28.817751,28.817751,74.192147,176.410051,102.217904,0.596013,31.071581,30.475568,2.562615,49.461649,46.899034,42.970847,54.836616,11.865769,346.831865,487.021866,140.190001,0.329325,6.564006,6.234681,9.16489,12.192394,3.027504,3.70723,8.968987,5.261757,0.543682,28.384999,27.841317,0.053402,0.31973,0.266328,0.114627,6.288005,6.173378,1.481651,26.857689,25.376038,0.076493,4.606861,4.530368,0.917307,7.711376,6.794069,2.75916,36.966504,34.207344,819.383121,126.821616,-692.561505,25.128044,86.471738,61.343694,,,,,,,252.80534,36.490842,-216.314498,0.254474,13.884513,13.630039,0.147494,15.679529,15.532035,732.028235,703.387571,-28.640664,3041.237426,1017.289658,-2023.947768,9.96098,15.187926,5.226946,8.542314,24.624715,16.082401,0.00465,0.663827,0.659177,428.852853,226.187225,-202.665628,460.250064,353.687783,-106.562281,16.324189,24.964241,8.640052,554.444372,724.784353,170.339981,2203.4249,1867.826791,-335.598109,3.95123,105.718317,101.767087,40.434595,54.479502,14.044907,273.489719,452.259058,178.769339,0.49224,0.076745,-0.415495,16.841029,47.239123,30.398094,1228.344182,422.316483,-806.027699,0,0.0623,0.0623,653.34396,297.499211,-355.844749,476.218716,302.996368,-173.222348,0.548792,0.129156,-0.419636,421.405195,205.952736,-215.452459,4953.197936,4368.920129,-584.277806999999,2365.726769,595.526005,-1770.200764,1707.877651,2591.490212,883.612561000001,1593.176962,2205.579717,612.402755,44.517087,50.771539,6.25445199999999,0.015138,2.292712,2.277574,1.563745,2.48453,0.920785,3541.208986,2273.592951,-1267.616035,7734.185951,4274.627741,-3459.55821,867.988863,259.269311,-608.719552,,,,207.267372,94.514745,-112.752627,96.273162,18.210199,-78.062963,210.186756,102.076341,-108.110415,28.161985,1.728823,-26.433162,1140.79828,1896.681375,755.883095,21.421864,17.654306,-3.76755800000001,73.977674,29.619157,-44.358517,42.363851,73.583815,31.219964,193.370409,192.96611,-0.404299000000009,,,,1474.772146,646.819323,-827.952823,130.277099,5.91426,-124.362839,83.66389,106.384703,22.720813,2.584562,3.958935,1.374373,171.09389,13.350608,-157.743282,9.500192,62.902293,53.402101,111.65884,72.686167,-38.972673,0.0566,6.55755,6.50095,1.774858,3.961473,2.186615,0.017033,8.010418,7.993385,4.734528,2.696797,-2.037731,1.62049,13.402361,11.781871,1060.746052,766.20376,-294.542292,256.074641,210.352816,-45.721825,0.04789,8.780677,8.732787,24.474193,14.171094,-10.303099,0.013827,0.262685,0.248858,0.00759,1.428094,1.420504,3043.746101,1196.757526,-1846.988575,,,,25.003445,21.940352,-3.063093,39.077174,22.513499,-16.563675,1.726587,0.835068,-0.891519,0.733564,1.917586,1.184022,,,,,,,,,,0.413061,5.011094,4.598033,1.005513,10.037766,9.032253,66.310901,129.420492,63.109591,78.873135,58.945492,-19.927643,22.823783,29.341413,6.51763,373.645985,560.739561,187.093576,1.638771,8.320784,6.682013,2.402874,10.912841,8.509967,8.202164,70.085406,61.883242,1019.823938,78.662059,-941.161879,6.499205,8.040527,1.541322,410.4,335.7,-74.7,0.01847,0,-0.01847,0.249497,0.058305,-0.191192,101.101921,57.226887,-43.875034,477.810521,170.567012,-307.243509,,,,2691.864854,717.705156,-1974.159698,59.97234,138.98637,79.01403,126.428229,881.915832,755.487603,0.698725,28.901482,28.202757,9.602912,61.193227,51.590315,33.808432,44.636457,10.828025,5.709751,41.535089,35.825338,1902.402037,1060.74678,-841.655257000001,340.541238,150.90269,-189.638548,7.593437,2.393502,-5.199935,281.645629,41.843626,-239.802003,175.671783,13.733332,-161.938451,0,0.430601,0.430601,1914.09994,639.344405,-1274.755535,876.382943,148.055728,-728.327215,2.109317,0.500595,-1.608722,195.598912,10.399757,-185.199155,2548.444933,964.410211,-1584.034722,1451.602599,2275.237489,823.63489,1184.090403,389.132867,-794.957536,0,0.865511,0.865511,35.067189,6.679334,-28.387855,785.154808,640.088152,-145.066656,104.112582,21.429093,-82.683489,0.016476,1.610827,1.594351,0.111986,1.540807,1.428821,27070.961198,5561.77325,-21509.187948,7.166142,3.08438,-4.081762,0,0,0,3997.220215,3062.575876,-934.644339,610.599835,1766.364786,1155.764951,3186.396452,2485.171369,-701.225083000001,11827.319868,5190.625342,-6636.694526,725.477766,1596.210707,870.732941,0.016244,0.040505,0.024261,0.198263,0.227277,0.029014,0.327176,0.143705,-0.183471,0.009899,0.026381,0.016482,5.989347,4.417231,-1.572116,285.993104,192.911146,-93.081958,0.111129,0.197582,0.086453,0.180291,7.199783,7.019492,0,0.533176,0.533176,0.842129,1.621521,0.779391999999999,0.050843,0.276779,0.225936,0.062392,0.990822,0.92843,0,0,0,0.153677,0.098314,-0.055363,0,0.002393,0.002393,8.368509,4.455038,-3.913471,0.00385,0.023273,0.019423,3.34615,13.603904,10.257754,0.605021,1.236025,0.631004,0.337235,3.528174,3.190939,0.073073,1.080943,1.00787,0.005843,0.51492,0.509077,10.977823,1.88481,-9.093013,0.47222,1.134712,0.662492,48.111234,67.561387,19.450153,1511.273912,97.254438,-1414.019474,38.728849,18.993018,-19.735831,213.005554,46.680686,-166.324868,288.413598,494.040159,205.626561,0.745,3.58789,2.84289,,,,0,0,0,176.581023,18.046814,-158.534209,0.025457,1.642789,1.617332,10.711182,12.602665,1.891483,5.2216,12.276346,7.054746,0.155197,2.466038,2.310841,27.675695,3.17349,-24.502205,4.463035,4.268094,-0.194941,8.282617,16.407462,8.124845,38.816022,43.987216,5.17119400000001,0.00546,1.961953,1.956493,0.200092,5.607053,5.406961,0.040229,49.395472,49.355243,2332.279785,260.857066,-2071.422719,0.01413,1.529202,1.515072,215.167658,13.063242,-202.104416,203.498603,8.801759,-194.696844,0.007082,0.047008,0.039926,0.017153,4.197758,4.180605,0.04249,24.253687,24.211197,1220.083374,81.565727,-1138.517647,241.473544,10.906357,-230.567187,0,0.138672,0.138672,0.660975,0.36678,-0.294195,0.048258,0.422001,0.373743,12.597468,5.930344,-6.667124,14.305143,5.723311,-8.581832,0.110354,1.623216,1.512862,1.223397,4.573595,3.350198,0.02582,2.182976,2.157156,2.2,4.1,1.9,0.002131,0.163455,0.161324,0.341262,1.987588,1.646326,2.116585,8.20039,6.083805,24.583678,17.257196,-7.326482,0.772294,2.24422,1.471926,0,0.146837,0.146837,5.349065,10.4166,5.067535,15.679647,3.269671,-12.409976,0.692362,12.236799,11.544437,30.120443,3.32138,-26.799063,0,0.004854,0.004854,0.094742,0.020622,-0.07412,0.053147,0.215051,0.161904,0,0.138777,0.138777,722.447552,461.100236,-261.347316,6.014213,7.303313,1.2891,17.509144,1.963137,-15.546007,4.069771,2.674787,-1.394984,12.188775,0.899317,-11.289458,9.102964,2.893991,-6.208973,2.558641,9.028619,6.469978,32.017205,0.23281,-31.784395,0,15.687099,15.687099,,,
2007-07-01,13987.106829,3823.2,-10163.906829,31395.51189,18695.416884,-12700.095006,163679,95773,-67906,10699.70111,0,-10699.70111,11384.293982,6458.2,-4926.093982,27121,21268,-5853,9775.775036,8668.040293,-1107.734743,11570.962671,8878.970536,-2691.992135,41506.506171,29960.695328,-11545.810843,36320.639297,21808.465942,-14512.173355,7871.229999,1806.163299,-6065.0667,57080.083731,21669.426754,-35410.656977,166765,90650.34175,-76114.65825,68377.666986,26428.87818,-41948.788806,1645.723142,1851.56555,205.842407999999,1115.924154,1744.645343,628.721189000001,5346.358935,1213.171051,-4133.187884,1.720833,0.312326,-1.408507,24609.579092,18771.96771,-5837.611382,0.276128,0,-0.276128,16896.927079,11188.727618,-5708.19946099999,272.578768,321.715261,49.136493,8.843614,20.618103,11.774489,192.654521,217.82874,25.1742190000001,343.793482,445.790006,101.996524,145.595291,72.184502,-73.410789,328.260536,294.161643,-34.0988929999999,28.765332,291.042007,262.276675,1.262335,43.948256,42.685921,28.687426,171.625918,142.938492,0,44.584849,44.584849,66.2421,218.34926,152.10716,0.116969,36.005986,35.889017,1.130123,50.547138,49.417015,38.318154,53.615537,15.297383,362.840544,499.885398,137.044854,0.424027,7.305848,6.881821,5.630275,12.861561,7.231286,4.37018,8.444358,4.074178,0.278064,15.816856,15.538792,0.022817,0.460558,0.437741,0.135687,5.926343,5.790656,1.393784,12.894328,11.500544,0.03253,6.592313,6.559783,0.817334,9.272256,8.454922,3.523923,33.710566,30.186643,846.127528,138.310358,-707.81717,50.935915,193.149523,142.213608,,,,,,,239.871432,38.451704,-201.419728,0.122232,9.97236,9.850128,1.057047,13.619395,12.562348,924.466081,696.764817,-227.701264,3208.377103,907.412446,-2300.964657,10.081839,14.596513,4.514674,15.996137,19.466918,3.470781,0.028529,8.059436,8.030907,491.391201,190.498234,-300.892967,398.437084,335.690075,-62.7470090000001,26.784887,25.114551,-1.670336,817.043834,680.404393,-136.639441,2253.627541,2027.389655,-226.237886,4.435012,108.727296,104.292284,58.840147,46.496082,-12.344065,387.619721,529.591298,141.971577,0.001585,0.067891,0.066306,14.157293,56.408948,42.251655,1018.223546,314.00659,-704.216956,0,0.215586,0.215586,782.961398,247.793453,-535.167945,390.179524,247.260783,-142.918741,0.018778,0.174919,0.156141,687.883157,309.456497,-378.42666,5022.525716,3698.716789,-1323.808927,2299.028475,503.501841,-1795.526634,1545.410163,2471.375353,925.96519,1340.47835,2004.57011,664.09176,59.481224,42.503703,-16.977521,0.028135,1.403112,1.374977,2.856762,1.379921,-1.476841,3966.233731,2076.986378,-1889.247353,8384.582614,3835.80698,-4548.775634,824.117248,230.593184,-593.524064,,,,209.005093,90.760917,-118.244176,134.679726,53.492535,-81.187191,229.403309,107.421788,-121.981521,24.239202,1.672729,-22.566473,1281.381818,1426.128493,144.746675,10.756004,19.178789,8.42278499999999,62.102315,37.094727,-25.007588,21.615247,54.627867,33.01262,181.036737,313.203925,132.167188,,,,1961.552105,537.353614,-1424.198491,44.098124,6.459898,-37.638226,143.232428,102.729685,-40.502743,2.374656,5.626895,3.252239,127.193125,15.490821,-111.702304,19.912548,20.834695,0.922146999999995,46.384858,47.966672,1.581814,0.24047,1.384582,1.144112,1.263452,4.804022,3.54057,0.003964,0.795246,0.791282,43.784981,8.188044,-35.596937,1.243715,24.614667,23.370952,966.275651,708.699782,-257.575869,304.417928,191.067865,-113.350063,0,49.42096,49.42096,32.491974,18.39143,-14.100544,0.014122,0.144855,0.130733,0.02643,1.7042,1.67777,3409.53847,1139.237813,-2270.300657,,,,31.145175,9.01456,-22.130615,39.93309,25.019995,-14.913095,1.856321,1.037076,-0.819245,7.458976,1.313189,-6.145787,,,,,,,,,,0.063556,2.784308,2.720752,0.405965,1.34993,0.943965,131.208782,122.292703,-8.91607900000001,81.140107,47.053317,-34.08679,42.359255,23.413942,-18.945313,382.766177,524.760779,141.994602,1.404454,9.681281,8.276827,2.22699,32.388047,30.161057,8.062895,58.045035,49.98214,933.004368,94.900459,-838.103909,10.864972,7.315861,-3.549111,467.9,503.6,35.7,0.030569,0.234839,0.20427,0.359924,0.066001,-0.293923,113.986681,86.037378,-27.949303,277.877333,171.981101,-105.896232,,,,3342.662359,658.188855,-2684.473504,36.448886,116.559901,80.111015,82.283617,1015.077214,932.793597,51.311248,22.491004,-28.820244,39.398351,69.437151,30.0388,33.892319,36.907271,3.01495200000001,8.100166,46.340223,38.240057,1779.890901,1742.190832,-37.7000690000004,321.298227,147.005898,-174.292329,7.49509,2.480796,-5.014294,285.564604,30.419598,-255.145006,173.632724,19.139647,-154.493077,0,0.50618,0.50618,1847.154782,666.21357,-1180.941212,972.645406,143.999765,-828.645641,2.102834,1.018179,-1.084655,224.362499,10.077509,-214.28499,2719.957723,888.9653,-1830.992423,1536.493868,2022.12674,485.632872,1197.156922,333.595587,-863.561335,0,1.521484,1.521484,44.523108,7.66014,-36.862968,786.019138,572.081454,-213.937684,102.205467,16.884188,-85.321279,0.029357,0.040454,0.011097,0.055758,1.46453,1.408772,28601.170814,4665.937256,-23935.233558,7.057932,1.709635,-5.348297,0,0,0,4259.646125,2788.834479,-1470.811646,635.119564,1558.659642,923.540078,3344.515479,2298.419432,-1046.096047,12768.564701,4810.052998,-7958.511703,772.742915,1511.690297,738.947382,0,0.058229,0.058229,0.119166,0.175544,0.056378,0.303236,0.495586,0.19235,0,0.014494,0.014494,9.827446,4.893893,-4.933553,302.140461,189.625348,-112.515113,0.231871,0.517688,0.285817,0.285698,4.599935,4.314237,0.015847,0.151443,0.135596,0.611496,2.365853,1.754357,0.168124,0.425964,0.25784,0.076866,0.399521,0.322655,0,0,0,0.087306,0.178895,0.091589,0,0,0,6.616711,4.138685,-2.478026,0,0.103621,0.103621,5.061624,9.232003,4.170379,0.692537,2.537444,1.844907,0.589273,8.273221,7.683948,0.010515,0.875683,0.865168,0.061754,0.346906,0.285152,15.779117,1.870683,-13.908434,0.486702,1.673394,1.186692,69.8725,65.842426,-4.03007400000001,1735.511299,114.913687,-1620.597612,87.983866,17.024515,-70.959351,160.295633,36.528444,-123.767189,239.981855,364.331294,124.349439,1.5322,5.542906,4.010706,,,,0,0,0,311.55909,15.091843,-296.467247,0.012393,10.694746,10.682353,9.753415,8.098186,-1.655229,0.929774,16.382915,15.453141,0.336524,3.004103,2.667579,10.351338,5.974048,-4.37729,3.899564,3.852778,-0.0467859999999996,11.68963,8.835902,-2.853728,9.264401,32.310737,23.046336,0.070436,2.132469,2.062033,0.095087,6.967608,6.872521,0.06058,6.064157,6.003577,2652.965493,246.819422,-2406.146071,0.067043,1.06616,0.999117,158.655782,16.524447,-142.131335,230.655125,4.19784,-226.457285,0.103231,0.043067,-0.060164,0.064158,2.723695,2.659537,0.047341,28.877088,28.829747,824.453626,126.380716,-698.07291,217.980369,12.520425,-205.459944,0.020024,0.306981,0.286957,0.314215,0.403202,0.0889869999999999,0.000428,1.761973,1.761545,9.491699,6.455057,-3.036642,9.253423,10.857642,1.604219,0.226411,0.276858,0.050447,1.000032,0.462224,-0.537808,0.002719,0.760635,0.757916,2.8,3,0.2,0.0236,1.621224,1.597624,0.252033,5.663398,5.411365,1.529308,4.257089,2.727781,32.684344,25.480725,-7.20361900000001,0.925072,0.872585,-0.0524869999999998,0,0.008997,0.008997,4.131239,11.779614,7.648375,14.622689,2.745712,-11.876977,0.265176,8.040962,7.775786,28.479517,2.394569,-26.084948,0.000291,0.000081,-0.00021,0.000293,0.133209,0.132916,0.102725,0.7515,0.648775,0.049016,0.035069,-0.013947,698.122426,525.112639,-173.009787,11.038468,9.457355,-1.581113,18.332103,3.486244,-14.845859,3.636268,5.067029,1.430761,13.508813,0.792455,-12.716358,2.323256,6.155857,3.832601,4.583886,7.864639,3.280753,38.32486,0.076399,-38.248461,0,22.210796,22.210796,,,
2007-08-01,15134.98254,4421.7,-10713.28254,30192.762315,20125.88107,-10066.881245,163444,97552,-65892,12632.873458,0,-12632.873458,13515.098594,7497.3,-6017.798594,27897,22567,-5330,9273.260724,9135.861624,-137.399100000001,12072.95756,9379.333161,-2693.62439899999,46018.03926,33661.889574,-12356.149686,34743.128897,23852.089045,-10891.039852,8546.008595,2197.464702,-6348.543893,56020.017522,23749.791927,-32270.225595,170766,99866.609462,-70899.390538,68226.606971,28691.461969,-39535.145002,1721.307664,1931.535343,210.227679,1157.864402,2040.417138,882.552736,5943.770753,1301.694277,-4642.076476,0.937494,0.239793,-0.697701,26902.750915,21378.957853,-5523.793062,0.372557,0.003935,-0.368622,19115.288345,12282.931721,-6832.356624,265.173363,345.606145,80.4327820000001,4.330205,20.485595,16.15539,205.617758,206.444999,0.827241000000043,369.798096,367.493061,-2.30503499999998,155.22338,86.748461,-68.474919,334.587364,360.952531,26.365167,32.181106,338.354388,306.173282,3.864991,60.426291,56.5613,23.573407,191.739341,168.165934,0.06,54.053806,53.993806,62.484388,182.328063,119.843675,1.784236,36.720105,34.935869,2.081859,56.151613,54.069754,42.846897,50.550279,7.70338200000001,390.907703,564.290146,173.382443,0.187502,12.425885,12.238383,0.630172,10.984471,10.354299,5.113018,9.703211,4.590193,0.431892,28.119884,27.687992,0.002613,0.31045,0.307837,0.12303,5.552677,5.429647,1.29597,11.695864,10.399894,0.05069,4.616382,4.565692,0.537759,6.329785,5.792026,2.737943,36.562974,33.825031,722.556988,154.251551,-568.305437,48.228915,174.418537,126.189622,,,,,,,210.156081,38.884773,-171.271308,0.443421,11.384372,10.940951,0.948191,21.004405,20.056214,939.218317,807.946611,-131.271706,3518.759964,899.835076,-2618.924888,11.427954,18.938094,7.51014,3.070013,30.428613,27.3586,0,5.232623,5.232623,568.537315,231.518092,-337.019223,472.754575,356.108672,-116.645903,21.142023,23.978948,2.836925,854.482347,734.379138,-120.103209,2387.103728,2143.247088,-243.85664,8.894032,119.627665,110.733633,42.163545,58.714298,16.550753,355.135213,500.716098,145.580885,2.309596,0.0721,-2.237496,13.446161,51.408201,37.96204,839.660522,330.087059,-509.573463,0,0.058587,0.058587,544.98999,222.191267,-322.798723,393.589401,306.669851,-86.91955,0.023026,0.442601,0.419575,589.972919,216.299143,-373.673776,4704.258402,3806.683193,-897.575209000001,2529.64262,556.623298,-1973.019322,1701.386378,2726.559345,1025.172967,1148.464884,2155.517,1007.052116,38.655763,239.997906,201.342143,0.006119,0.657978,0.651859,3.213825,12.044893,8.831068,3436.947095,2049.072686,-1387.874409,8480.113806,4325.007453,-4155.106353,733.270372,259.957257,-473.313115,,,,194.962285,92.268749,-102.693536,113.383473,47.616841,-65.766632,239.039097,106.529309,-132.509788,23.827557,1.492759,-22.334798,1252.983419,1623.918331,370.934912,29.526246,28.491947,-1.034299,46.883079,28.231515,-18.651564,41.962734,57.421677,15.458943,186.988798,360.271731,173.282933,,,,1800.540766,912.544858,-887.995908,72.95609,11.13847,-61.81762,171.12761,116.890452,-54.237158,2.245651,5.445541,3.19989,102.613452,14.004343,-88.609109,33.443709,19.78971,-13.653999,31.538407,49.912023,18.373616,0.079704,2.684795,2.605091,2.02822,6.814386,4.786166,0.017347,1.609712,1.592365,52.198357,2.651608,-49.546749,55.264349,2.141185,-53.123164,983.930372,944.236616,-39.6937559999998,256.453267,174.183197,-82.27007,0.294258,104.969803,104.675545,23.652093,10.64665,-13.005443,0.017683,6.268526,6.250843,0.011281,2.119458,2.108177,3148.213132,1034.644605,-2113.568527,,,,19.883099,29.745942,9.862843,42.085843,29.678781,-12.407062,2.237444,2.740392,0.502948,1.760797,1.474837,-0.28596,,,,,,,,,,0.104727,3.892729,3.788002,0.669199,2.214016,1.544817,124.820736,145.480767,20.660031,93.204022,55.357289,-37.846733,70.437368,27.809975,-42.627393,355.600656,506.920146,151.31949,1.257608,10.53723,9.279622,3.41865,6.651541,3.232891,15.780071,53.589232,37.809161,1069.009229,135.617054,-933.392175,9.046017,6.63026,-2.415757,430.3,432.8,2.5,0.112465,3.002308,2.889843,0.287215,0,-0.287215,136.609676,128.116454,-8.493222,304.032897,196.430433,-107.602464,,,,3347.877725,888.360146,-2459.517579,57.90603,271.934052,214.028022,104.104595,1107.891438,1003.786843,72.159883,85.199572,13.039689,120.636773,78.540966,-42.095807,64.756528,38.039702,-26.716826,9.442932,46.861785,37.418853,2180.305904,1597.299825,-583.006078999999,341.135309,137.162879,-203.97243,7.486766,3.660346,-3.82642,388.883485,64.92766,-323.955825,192.716224,37.995053,-154.721171,0,0.135983,0.135983,1993.976642,736.955711,-1257.020931,1022.251916,154.537856,-867.71406,1.52065,0.228619,-1.292031,249.881919,10.077048,-239.804871,2855.260766,929.50519,-1925.755576,1535.129346,2175.112149,639.982803000001,1361.975162,376.126162,-985.849,0.01496,1.660045,1.645085,36.115814,4.01603,-32.099784,862.977108,665.794831,-197.182277,101.140021,19.823062,-81.316959,0.136301,0.081886,-0.054415,0.099285,1.58688,1.487595,28424.501435,5552.797567,-22871.703868,9.864575,1.685242,-8.179333,0,0,0,3792.010614,2910.229742,-881.780871999998,600.750005,1657.458586,1056.708581,3345.370759,2393.061147,-952.309612,11975.587117,5059.682869,-6915.904248,862.661014,1737.604518,874.943504,0.004704,0.028595,0.023891,0.050565,0.273969,0.223404,0.014898,0.184475,0.169577,0,0.000738,0.000738,11.362347,6.415427,-4.94692,255.176014,262.164647,6.98863299999991,0.033907,0.183675,0.149768,0.390911,5.307293,4.916382,0.063494,0.009568,-0.053926,0.427035,1.528704,1.101669,0.143165,0.562438,0.419273,0.064388,0.15025,0.085862,0,0,0,0.049728,0.103452,0.053724,0.004926,0,-0.004926,5.727755,2.607442,-3.120313,0,0.100865,0.100865,3.846419,9.727168,5.880749,0.554415,3.151809,2.597394,0.298058,3.878411,3.580353,0.056128,1.323093,1.266965,0.006369,1.451859,1.44549,16.425807,2.267576,-14.158231,0.501623,1.325072,0.823449,52.181198,101.036514,48.855316,1983.525809,164.520518,-1819.005291,37.378181,35.854621,-1.52356,354.837062,52.505485,-302.331577,161.484349,564.797122,403.312773,0.63101,1.855964,1.224954,,,,0,0.03339,0.03339,83.06171,14.713048,-68.348662,0.016875,10.644794,10.627919,27.401363,12.615419,-14.785944,0.212456,23.178688,22.966232,0.631884,2.599755,1.967871,7.224175,5.937994,-1.286181,6.443582,8.997716,2.554134,24.660254,13.938032,-10.722222,8.952292,34.082696,25.130404,0.002539,2.081767,2.079228,0.031387,3.901969,3.870582,0.187941,40.198159,40.010218,2878.116862,231.322289,-2646.794573,0.336535,2.240238,1.903703,226.637976,12.961842,-213.676134,288.67626,4.245041,-284.431219,1.321605,0.049108,-1.272497,0.002197,8.635219,8.633022,0.055224,26.449276,26.394052,927.756393,113.84682,-813.909573,283.433935,16.124615,-267.30932,0,0.555097,0.555097,0,0.707484,0.707484,0.065064,0.263415,0.198351,9.324785,5.803677,-3.521108,4.769523,15.631226,10.861703,0.005719,0.409575,0.403856,0.577951,2.050619,1.472668,0.012475,1.256509,1.244034,1.6,25.5,23.9,0,2.422056,2.422056,0.155019,4.162407,4.007388,2.567688,2.279599,-0.288089,32.595944,22.974993,-9.62095100000001,0.718331,0.456254,-0.262077,0,0.033221,0.033221,6.001024,18.051228,12.050204,18.223593,3.337273,-14.88632,0.232785,13.562185,13.3294,36.961057,3.412323,-33.548734,0,0.003787,0.003787,0.030117,0.009674,-0.020443,0.034677,0.188275,0.153598,0.002319,0.03332,0.031001,955.319549,559.818357,-395.501192,6.724988,12.242659,5.517671,20.704164,5.096314,-15.60785,3.402008,7.604259,4.202251,13.176463,1.615421,-11.561042,7.243844,4.082535,-3.161309,3.114575,4.173697,1.059122,41.797425,0.429788,-41.367637,0,43.710145,43.710145,,,
2007-09-01,14626.263572,4103.9,-10522.363572,27175.240998,20445.456238,-6729.78476,164883,98065,-66818,11504.750392,0,-11504.750392,13421.232698,7527.8,-5893.432698,28072,22160,-5912,8827.995156,8683.243298,-144.751857999998,11347.223607,8989.71038,-2357.513227,44200.785526,32419.592447,-11781.193079,31312.084194,23659.004556,-7653.07963799999,7640.504228,2350.188451,-5290.315777,55472.485648,22884.421008,-32588.06464,162772,96865.821058,-65906.178942,67386.685588,27446.868781,-39939.816807,1515.60227,1762.274837,246.672567000001,883.432029,1943.576173,1060.144144,5651.722147,1363.990286,-4287.731861,1.219596,0.547636,-0.67196,26390.724246,21054.952666,-5335.77158,0.001197,0.060363,0.059166,17810.06128,11364.639781,-6445.421499,235.345448,283.666158,48.32071,3.750634,14.376985,10.626351,192.271991,175.257722,-17.014269,312.322376,361.579362,49.2569859999999,126.240691,117.540499,-8.700192,298.66424,387.695062,89.0308219999999,29.824661,281.600036,251.775375,1.04631,44.39138,43.34507,70.403172,164.5321,94.128928,0,31.68156,31.68156,26.613405,176.843414,150.230009,1.25933,33.582266,32.322936,1.145058,47.694219,46.549161,40.726212,55.020538,14.294326,350.757524,436.536034,85.7785099999999,0.489032,14.529525,14.040493,0.73179,12.789768,12.057978,3.46833,8.118772,4.650442,0.21772,17.321619,17.103899,0.005388,0.293225,0.287837,0.038409,6.873701,6.835292,1.077442,10.871368,9.793926,0.044145,5.918067,5.873922,0.286741,4.169331,3.88259,2.911326,31.881885,28.970559,543.228662,148.77485,-394.453812,117.837911,178.88629,61.048379,,,,,,,276.075344,30.942279,-245.133065,0.365728,14.550954,14.185226,0.098699,15.132633,15.033934,830.557385,756.048782,-74.508603,3454.075904,858.419315,-2595.656589,9.430546,11.160316,1.72977,16.602961,26.033002,9.430041,0.011954,0.751302,0.739348,672.958357,205.445649,-467.512708,493.94423,443.081043,-50.8631869999999,22.795323,28.024877,5.229554,643.71794,658.006748,14.2888079999998,2213.105513,2139.015876,-74.0896370000005,7.758953,118.209705,110.450752,33.532631,53.750017,20.217386,311.354953,578.641739,267.286786,0.129238,0.070407,-0.058831,15.63042,56.247759,40.617339,956.379134,392.90519,-563.473944,0,0.037286,0.037286,458.245063,235.065215,-223.179848,412.669909,237.237533,-175.432376,1.254406,0.174792,-1.079614,488.553986,194.657576,-293.89641,4651.794632,4101.05988,-550.734752,2007.484459,727.991219,-1279.49324,1722.007492,2563.521804,841.514312,1055.73095,2249.356783,1193.625833,43.335393,39.92718,-3.40821300000001,0.000347,1.426886,1.426539,2.027278,1.537276,-0.490002,3400.238874,2242.630983,-1157.607891,7205.396156,4346.112624,-2859.283532,647.848623,298.055574,-349.793049,,,,222.604018,83.993163,-138.610855,86.151563,18.034336,-68.117227,206.169939,103.333168,-102.836771,24.187492,0.746772,-23.44072,1112.379301,1421.26695,308.887649,35.994571,19.828129,-16.166442,30.606458,31.276722,0.670264,45.811397,55.332697,9.52130000000002,197.966304,197.665586,-0.300718000000046,,,,1364.387865,600.40764,-763.980225,79.31049,11.717589,-67.592901,103.831616,105.570167,1.738551,2.455613,10.988221,8.532608,174.061243,19.745104,-154.316139,30.145324,22.114498,-8.030826,236.565292,49.289226,-187.276066,0.213353,1.654926,1.441573,2.873061,7.37385,4.500789,0.006349,9.561349,9.555,32.888753,2.010911,-30.877842,61.695774,13.842487,-47.853287,766.913437,915.794724,148.881287,202.431475,237.560099,35.1286240000001,0.00738,66.386088,66.378708,21.248937,8.43203,-12.816907,0.188556,0.250578,0.062022,0.001116,1.071019,1.069903,2544.963616,1139.619191,-1405.344425,,,,29.816696,25.427133,-4.389563,35.454879,26.679276,-8.77560299999999,2.041978,2.455844,0.413866,8.358669,2.894511,-5.464158,,,,,,,,,,0.979353,0.900731,-0.0786220000000001,0.512024,1.685611,1.173587,68.551684,121.027179,52.475495,74.016044,66.01346,-8.002584,43.52095,17.489631,-26.031319,389.006283,531.700878,142.694595,1.396118,9.920501,8.524383,2.909203,61.159275,58.250072,8.491391,89.449029,80.957638,1324.807203,97.035257,-1227.771946,12.478197,20.851769,8.373572,401.6,372.1,-29.5,0.11205,0.84518,0.73313,0.205626,0.021658,-0.183968,146.222268,65.151687,-81.070581,367.834923,221.646384,-146.188539,,,,2999.339681,923.308175,-2076.031506,19.932329,183.130978,163.198649,72.479797,842.771996,770.292199,0.754368,83.861476,83.107108,286.984285,129.221755,-157.76253,58.149586,48.11072,-10.038866,6.136528,46.719034,40.582506,1928.095114,1468.583866,-459.511248,308.521862,178.993277,-129.528585,8.107395,2.512241,-5.595154,296.714805,42.333575,-254.38123,182.94918,15.548198,-167.400982,0,0.246393,0.246393,1960.823133,838.976881,-1121.846252,1016.99027,186.534949,-830.455321,0.586244,0.273059,-0.313185,233.333264,12.652667,-220.680597,2698.217506,1013.480317,-1684.737189,1463.00238,2155.324445,692.322065,1300.73947,272.607681,-1028.131789,0,0.932742,0.932742,31.569452,5.212456,-26.356996,846.574854,601.433918,-245.140936,89.0111,19.41416,-69.59694,0.00343,0.112854,0.109424,0.052252,1.28325,1.230998,29418.96253,5311.870909,-24107.091621,13.948039,1.64343,-12.304609,0,1.72816,1.72816,3517.292892,2581.685314,-935.607578000001,632.354748,1989.593118,1357.23837,3215.345136,1956.640421,-1258.704715,11403.775011,5066.363326,-6337.411685,635.041549,1683.442606,1048.401057,0.003,0.060668,0.057668,0.047908,0.019275,-0.028633,0.087419,0.044208,-0.043211,0,0,0,10.771318,6.611038,-4.16028,209.827702,220.741299,10.913597,0.056932,0.394941,0.338009,0.781314,7.380629,6.599315,0.106605,0.000218,-0.106387,0.346401,1.164773,0.818372,0.043797,0.477621,0.433824,0.11682,0.099353,-0.017467,0,0,0,0.06009,0.067296,0.00720599999999998,0,0,0,4.286105,3.583355,-0.702749999999999,0,0.044493,0.044493,2.786063,9.960436,7.174373,0.531036,2.112639,1.581603,0.303698,2.523034,2.219336,0.025171,1.017606,0.992435,0.283249,0.902615,0.619366,17.479861,1.65751,-15.822351,0.396511,1.075256,0.678745,47.930247,141.615716,93.685469,1485.046915,238.145822,-1246.901093,17.414096,30.086604,12.672508,156.77019,52.502641,-104.267549,173.168105,527.497478,354.329373,0.816717,0.274455,-0.542262,,,,0,0.028557,0.028557,81.096722,18.806988,-62.289734,0.00959,9.522195,9.512605,5.92337,9.971043,4.047673,0.469007,20.712195,20.243188,0.630346,6.152857,5.522511,6.435419,10.363749,3.92833,4.900261,3.33221,-1.568051,40.267219,14.159459,-26.10776,21.21859,45.343234,24.124644,0.001998,1.480852,1.478854,3.431982,3.153439,-0.278543,0.15063,29.138841,28.988211,2659.283094,258.799292,-2400.483802,0.075603,2.322428,2.246825,69.04016,16.72641,-52.31375,180.935135,6.902321,-174.032814,0.032046,1.468073,1.436027,0.356611,1.636974,1.280363,0.107413,26.934726,26.827313,1293.453576,140.050516,-1153.40306,276.230648,14.209507,-262.021141,0,0.048112,0.048112,0.080319,1.67178,1.591461,0.000576,0.253007,0.252431,11.043917,9.234095,-1.809822,8.85268,10.107606,1.254926,0.003079,1.040984,1.037905,0.50986,1.730645,1.220785,0.011375,2.275919,2.264544,2,3,1,0,0.225404,0.225404,0.031689,6.068044,6.036355,1.399803,9.876528,8.476725,27.180742,32.76693,5.58618800000001,0.617837,0.835337,0.2175,0.009262,0.158681,0.149419,2.411602,17.226765,14.815163,16.426805,3.766819,-12.659986,0.070498,18.735099,18.664601,34.97488,3.235158,-31.739722,0,0.000063,0.000063,0.02062,0.009176,-0.011444,0.604214,0.06934,-0.534874,0.0036,0.005152,0.001552,786.264572,544.88976,-241.374812,38.087397,7.03786,-31.049537,11.948102,2.311689,-9.636413,4.40933,7.273137,2.863807,15.910358,0.956699,-14.953659,2.332985,33.971873,31.638888,1.705389,3.058501,1.353112,33.181259,0.106514,-33.074745,0,56.272271,56.272271,,,
2007-10-01,15133.61587,4633.3,-10500.31587,33776.75867,21552.568511,-12224.190159,166868,99509,-67359,12609.494621,0,-12609.494621,14740.864518,8144.3,-6596.564518,31766,24041,-7725,9704.738895,9458.228933,-246.509962,12349.918688,10292.066949,-2057.851739,48570.153209,35629.920474,-12940.232735,38768.612542,24771.907605,-13996.704937,7582.69901,2385.06581,-5197.6332,60770.15462,24400.285356,-36369.869264,182044,104975.619985,-77068.380015,73715.263274,29777.313366,-43937.949908,1640.391428,2133.712221,493.320793000001,1056.703602,1979.462974,922.759372000001,6060.642349,1325.514917,-4735.127432,0.853509,0.511095,-0.342414,28714.357812,23299.689553,-5414.66825899999,0.223537,0.023393,-0.200144,19855.795397,12330.230921,-7525.564476,247.085564,424.099353,177.013789,3.491284,17.132019,13.640735,191.584745,211.357908,19.773163,346.084289,377.725142,31.640853,155.517027,62.01548,-93.501547,328.350501,470.483651,142.13315,32.291603,380.420426,348.128823,1.841721,48.932296,47.090575,86.091586,280.593439,194.501853,0,33.661418,33.661418,64.825439,240.000225,175.174786,0.74807,33.014684,32.266614,2.071472,50.25407,48.182598,45.382188,73.278128,27.89594,371.769302,588.030687,216.261385,0.392563,6.884787,6.492224,0.773302,13.043646,12.270344,5.318869,13.619764,8.300895,0.516253,28.921958,28.405705,0.039269,0.295644,0.256375,0.211208,8.261116,8.049908,1.068071,9.696728,8.628657,0.039479,6.947211,6.907732,0.450178,5.415983,4.965805,4.943717,40.970726,36.027009,768.022759,181.613459,-586.4093,64.426248,266.951521,202.525273,,,,,,,174.709567,51.192272,-123.517295,0.062079,7.728648,7.666569,2.112046,15.054098,12.942052,855.346533,809.009596,-46.336937,3934.945413,945.141965,-2989.803448,12.090211,15.746352,3.656141,12.446414,48.63129,36.184876,0.093107,2.572304,2.479197,602.607349,281.012685,-321.594664,507.103143,501.249946,-5.85319699999997,38.595143,29.252366,-9.342777,701.602346,728.8592,27.256854,2438.657267,2244.014117,-194.64315,10.096537,125.059184,114.962647,34.972481,57.623494,22.651013,301.133313,556.169015,255.035702,0.009032,0.128948,0.119916,17.44967,49.404051,31.954381,1116.664819,437.158615,-679.506204,0,0.076512,0.076512,576.435383,266.098218,-310.337165,475.851566,258.27512,-217.576446,1.049194,0.379381,-0.669813,626.596817,253.064476,-373.532341,5587.468134,4347.459212,-1240.008922,2836.132484,797.195194,-2038.93729,2094.032275,2568.824659,474.792384,1416.514765,2241.208634,824.693869000001,54.33698,209.596479,155.259499,0.062274,0.562933,0.500659,1.562808,11.981505,10.418697,4148.253333,2506.037314,-1642.216019,8486.829091,4522.926974,-3963.902117,1216.193715,238.368937,-977.824778,,,,224.294529,94.063633,-130.230896,175.84658,31.419845,-144.426735,252.262542,102.987758,-149.274784,28.222675,1.203244,-27.019431,1397.772289,1340.475091,-57.297198,18.820475,27.670894,8.850419,16.686789,37.416184,20.729395,19.169872,55.568938,36.399066,215.64037,178.784694,-36.855676,,,,1742.511381,628.086314,-1114.425067,183.404668,8.883843,-174.520825,126.522061,131.874278,5.35221700000005,4.405247,10.691831,6.286584,226.575699,18.144383,-208.431316,3.232084,21.187768,17.955684,196.390268,60.784664,-135.605604,0.22395,2.325252,2.101302,2.127127,6.669447,4.54232,0,7.33404,7.33404,23.903322,4.166819,-19.736503,0.44287,5.204031,4.761161,899.483232,879.164316,-20.3189160000001,273.647006,189.900803,-83.7462029999999,0,44.010823,44.010823,31.410166,32.608557,1.198391,0.045252,0.43982,0.394568,0,1.632316,1.632316,3294.674365,1283.366549,-2011.307816,,,,32.482397,37.717157,5.23476000000001,44.523048,23.481929,-21.041119,1.975717,1.981565,0.00584800000000052,12.65307,4.500223,-8.152847,,,,,,,,,,0.034871,4.413734,4.378863,0.390709,3.060638,2.669929,127.30546,136.844943,9.53948300000002,97.589767,53.499623,-44.090144,25.254431,34.628405,9.373974,405.468184,538.300524,132.83234,1.276059,11.045826,9.769767,5.487395,45.225801,39.738406,8.317652,69.28506,60.967408,1213.100147,161.137149,-1051.962998,14.275144,18.971868,4.696724,504,461.7,-42.3,0.344825,0.552533,0.207708,0.122921,4.291681,4.16876,131.686394,103.016659,-28.669735,392.181725,192.497051,-199.684674,,,,3369.028628,1121.589481,-2247.439147,47.199581,159.603124,112.403543,179.348213,1064.71984,885.371627,0.682519,150.078231,149.395712,144.551516,76.875149,-67.676367,25.119834,67.509657,42.389823,6.396119,32.299284,25.903165,2404.122873,1630.254407,-773.868466,327.784622,125.82181,-201.962812,9.089823,2.228069,-6.861754,297.26427,43.552555,-253.711715,158.418261,22.97964,-135.438621,0,0.210163,0.210163,2119.708467,948.358196,-1171.350271,1023.321454,215.698752,-807.622702,1.018633,0.30934,-0.709293,228.366066,10.927279,-217.438787,2712.873081,1048.093344,-1664.779737,1568.811903,2122.541221,553.729318000001,1316.354374,358.594279,-957.760095,0,0.443525,0.443525,41.106526,5.401194,-35.705332,847.357613,703.579076,-143.778537,99.852157,18.919349,-80.932808,0.002579,0.189324,0.186745,0.10839,1.356533,1.248143,31555.406402,5532.919982,-26022.48642,6.296434,1.831403,-4.465031,0,0,0,3936.965556,3188.70657,-748.258986,751.167778,2048.145927,1296.978149,3447.793658,2098.835215,-1348.958443,13471.795456,5333.826919,-8137.968537,782.888471,1719.8527,936.964229,0,0.020984,0.020984,0.063614,0.326823,0.263209,0.179745,0.189911,0.0101660000000001,0,0.029115,0.029115,7.547886,11.721875,4.173989,230.233759,209.147705,-21.086054,0.042031,0.1257,0.083669,0.316832,4.733132,4.4163,0.115683,0.015,-0.100683,0.440945,1.241735,0.80079,0.039157,0.417807,0.37865,0.056133,0.244241,0.188108,0,0,0,0.109985,0.056701,-0.053284,0,0.018126,0.018126,5.551842,4.886294,-0.665548,0,0.092214,0.092214,11.437766,12.752055,1.314289,0.645849,1.596946,0.951097,0.427777,3.291913,2.864136,0.08911,1.165575,1.076465,0.010716,1.179595,1.168879,16.100546,5.326928,-10.773618,0.371145,1.073967,0.702822,80.024452,162.375615,82.351163,1006.009963,204.227468,-801.782495,19.795134,42.297738,22.502604,114.775929,49.200775,-65.575154,173.569736,605.045095,431.475359,0.653502,3.804717,3.151215,,,,0,0.01097,0.01097,181.287853,25.567296,-155.720557,0.046093,3.452533,3.40644,109.726249,11.878414,-97.847835,1.01231,8.901349,7.889039,3.253486,2.429268,-0.824218000000001,5.677788,10.082214,4.404426,5.787074,5.330243,-0.456830999999999,36.952198,16.020352,-20.931846,29.856587,39.749065,9.892478,0.022103,3.128112,3.106009,3.598862,3.400076,-0.198785999999998,0.075915,41.307824,41.231909,3249.473618,235.018463,-3014.455155,0.268218,1.851475,1.583257,219.766985,9.896158,-209.870827,200.070418,4.07706,-195.993358,1.700301,0.109958,-1.590343,0.016567,2.994104,2.977537,4.335387,26.91695,22.581563,884.696752,127.01406,-757.682692,258.303493,9.906901,-248.396592,0.008569,3.173685,3.165116,0.008707,0.358888,0.350181,0.034459,0.222771,0.188312,9.744478,5.716651,-4.027827,18.244966,20.752962,2.507996,0.003609,0.561854,0.558245,0.866836,1.208322,0.341486,0,5.994051,5.994051,1.3,2.8,1.5,0.199707,0.599132,0.399425,0.436735,9.078508,8.641773,3.140826,14.969711,11.828885,31.343534,34.413214,3.06968000000002,0.684256,0.948417,0.264161,0.015689,0.008664,-0.007025,2.316185,13.78223,11.466045,21.07112,12.889667,-8.181453,0.325008,3.993915,3.668907,37.838429,2.797054,-35.041375,0.011342,0,-0.011342,0.062186,0.09348,0.031294,0.192049,0.695795,0.503746,0,0.004238,0.004238,610.096932,522.467072,-87.62986,5.95831,9.316035,3.357725,13.934659,3.924157,-10.010502,4.829535,7.364136,2.534601,10.91458,1.078604,-9.835976,19.820975,15.027284,-4.793691,1.948127,2.37127,0.423143,62.196625,0.549918,-61.646707,0,139.348319,139.348319,,,
2007-11-01,16418.3327,4937.4,-11480.9327,31182.360344,20734.994703,-10447.365641,171602,100798,-70804,12865.813522,0,-12865.813522,14515.952636,7922,-6593.952636,30024,22652,-7372,9842.538275,8893.779009,-948.759266000001,12018.762543,9957.495892,-2061.266651,47366.639285,34779.313835,-12587.32545,36224.615997,24081.217859,-12143.398138,8524.903695,2146.352917,-6378.550778,57841.073398,23477.640908,-34363.43249,175663,101936.222882,-73726.777118,70575.150875,28959.480058,-41615.670817,1531.778965,2113.976216,582.197251,952.760285,1921.680596,968.920311,6790.066759,1233.634303,-5556.432456,0.142661,0.277441,0.13478,28010.52862,22652.103721,-5358.424899,0.064233,0.042501,-0.021732,19356.110665,12127.210114,-7228.900551,214.856473,344.415832,129.559359,3.319562,21.507077,18.187515,154.964857,194.719599,39.754742,333.657053,377.772934,44.1158809999999,145.001808,76.6852,-68.316608,325.039989,517.755922,192.715933,24.47256,379.305352,354.832792,2.137256,41.188571,39.051315,27.651331,340.718944,313.067613,0,45.218896,45.218896,52.917847,244.172163,191.254316,2.019612,35.298147,33.278535,1.251604,60.686578,59.434974,39.712391,54.603664,14.891273,358.258785,602.626729,244.367944,0.015054,7.328956,7.313902,0.728021,25.627246,24.899225,4.492611,9.521369,5.028758,0.382449,20.262338,19.879889,0.000629,0.233155,0.232526,0.075977,7.115037,7.03906,18.543741,15.616244,-2.927497,0.123027,6.45434,6.331313,0.262551,9.357381,9.09483,2.824027,47.128178,44.304151,605.216541,188.121728,-417.094813,114.766262,285.83698,171.070718,,,,,,,214.665467,63.996996,-150.668471,1.329248,4.354755,3.025507,1.896507,7.964529,6.068022,864.974445,809.337913,-55.6365320000001,4306.922845,883.661478,-3423.261367,10.865933,15.246671,4.38073799999999,8.415584,29.738854,21.32327,0.2103,2.273491,2.063191,513.939878,301.686907,-212.252971,564.613158,335.870759,-228.742399,51.717778,26.391473,-25.326305,522.834231,749.298908,226.464677,1938.748113,2059.9317,121.183587000001,6.666646,121.552123,114.885477,21.278,72.505005,51.227005,556.786253,514.343473,-42.4427799999999,0.206139,0.062297,-0.143842,16.54281,47.888216,31.345406,1106.304914,352.401454,-753.90346,0,0.121462,0.121462,556.432357,299.239015,-257.193342,489.983237,281.976182,-208.007055,0.30819,0.278924,-0.0292660000000001,461.548523,274.242517,-187.306006,5201.28945,4042.46911,-1158.82034,2593.322151,628.541006,-1964.781145,1525.761668,2668.532473,1142.770805,1400.076828,2276.493897,876.417069,33.085718,37.980545,4.894827,0.005454,1.861497,1.856043,1.072696,1.222592,0.149896,3636.035261,2251.776943,-1384.258318,8114.466085,4230.546651,-3883.919434,1163.532304,221.395267,-942.137037,,,,198.124802,115.977712,-82.1470899999999,165.54282,22.565048,-142.977772,241.947873,102.718526,-139.229347,21.060482,1.189449,-19.871033,1379.104849,1101.943013,-277.161836,9.983684,14.674816,4.691132,8.818911,25.006114,16.187203,25.818202,78.765098,52.946896,185.885177,570.920205,385.035028,,,,1983.082937,839.334384,-1143.748553,102.401972,6.373392,-96.02858,83.598117,129.577033,45.978916,2.536444,11.300703,8.764259,341.729137,18.540134,-323.189003,47.408199,57.456017,10.047818,66.529392,59.787375,-6.74201700000002,0.021631,2.603357,2.581726,1.716469,4.401533,2.685064,0.058734,2.398662,2.339928,2.953932,1.593044,-1.360888,0.492937,2.968644,2.475707,1003.014279,784.998837,-218.015442,248.908101,171.604438,-77.303663,0,120.627827,120.627827,38.430726,21.376451,-17.054275,0.010423,1.4701,1.459677,0.025453,3.405897,3.380444,3022.094759,1276.001379,-1746.09338,,,,30.005851,10.061694,-19.944157,38.079037,21.559254,-16.519783,2.18708,1.686693,-0.500387,1.387313,2.489739,1.102426,,,,,,,,,,0.008599,2.506904,2.498305,0.758833,3.09232,2.333487,85.381885,136.755689,51.373804,129.111356,75.413127,-53.698229,54.594687,38.985219,-15.609468,394.044238,600.00568,205.961442,1.217906,11.316745,10.098839,26.648694,56.515625,29.866931,10.633365,58.591631,47.958266,1052.192349,241.740796,-810.451553,11.88955,19.73016,7.84061,478.3,414.6,-63.7,0.000363,0,-0.000363,0.199362,0.752084,0.552722,87.617762,59.864981,-27.752781,412.485317,236.000739,-176.484578,,,,3670.767102,1364.031923,-2306.735179,35.050735,324.317449,289.266714,95.162857,928.674519,833.511662,0.641447,49.214691,48.573244,167.334279,132.280016,-35.054263,27.104463,66.996511,39.892048,6.505524,39.601466,33.095942,2206.973086,1387.141069,-819.832017,282.559992,159.900039,-122.659953,8.301319,1.576117,-6.725202,226.60529,26.632364,-199.972926,144.108316,17.186737,-126.921579,0,0.582212,0.582212,1970.934294,688.925736,-1282.008558,979.539735,212.85586,-766.683875,0.598221,0.917317,0.319096,189.541581,17.744312,-171.797269,2822.133447,1004.652474,-1817.480973,1565.44383,2172.327419,606.883589,1077.466409,323.414018,-754.052391,0.009799,0.425026,0.415227,10.537096,4.307621,-6.229475,849.136758,684.654801,-164.481957,96.089633,15.613452,-80.476181,0.0038,0.067209,0.063409,0.101881,2.235705,2.133824,29780.718791,5581.504999,-24199.213792,6.248711,1.755032,-4.493679,0,0,0,4215.351057,2902.194465,-1313.156592,633.756209,1677.101287,1043.345078,3427.987179,2142.155838,-1285.831341,12450.4463,5097.457636,-7352.988664,652.691952,1656.447536,1003.755584,0.348396,0.313915,-0.034481,0.099172,0.026069,-0.073103,0.080637,0.271183,0.190546,0,0.001648,0.001648,12.577824,5.436996,-7.140828,246.736913,210.372366,-36.364547,0.686388,0.238765,-0.447623,0.94472,4.8035,3.85878,0.042946,0.01336,-0.029586,0.453047,1.717333,1.264286,0.103333,0.606507,0.503174,0.026099,11.315503,11.289404,0,0,0,0.05938,0.047142,-0.012238,0,0.021496,0.021496,11.126225,6.395206,-4.731019,0,0.074549,0.074549,3.268106,9.956096,6.68799,2.616718,1.678981,-0.937737,0.431009,3.438226,3.007217,0.067658,0.98806,0.920402,0.002572,1.52063,1.518058,20.006134,4.897884,-15.10825,0.385196,1.143235,0.758039,37.388376,151.181946,113.79357,1166.731621,149.190953,-1017.540668,15.511682,67.957539,52.445857,66.577067,49.398903,-17.178164,179.068113,480.679654,301.611541,0.626339,6.278893,5.652554,,,,0.04735,0.000174,-0.047176,167.564016,17.640064,-149.923952,0.121747,8.331891,8.210144,8.8315,16.683138,7.851638,0.485571,10.028914,9.543343,1.616026,1.025002,-0.591023999999999,8.890873,7.524966,-1.365907,3.508998,5.540245,2.031247,22.806938,11.157395,-11.649543,23.134452,32.94407,9.80961800000001,0.004041,1.273265,1.269224,0.603804,3.327971,2.724167,0.170735,6.734716,6.563981,3709.907523,295.489675,-3414.417848,0.540075,1.596618,1.056543,153.095094,17.529498,-135.565596,180.809253,3.582581,-177.226672,1.208758,0.572715,-0.636043,0.010717,0.736721,0.726004,0.034003,55.646128,55.612125,1108.410332,108.790198,-999.620134,422.424265,15.684961,-406.739304,0,1.498373,1.498373,0.076185,0.190779,0.114594,0.008038,0.944585,0.936547,8.569863,5.456438,-3.113425,20.683182,12.47702,-8.206162,0.004746,0.215189,0.210443,1.374581,1.026898,-0.347683,0.014183,1.721736,1.707553,1.2,6.3,5.1,0.005141,0.241976,0.236835,0.648564,3.311504,2.66294,2.295467,6.669862,4.374395,27.019348,38.174204,11.154856,2.184577,0.407194,-1.777383,0,0.456228,0.456228,4.110109,28.368678,24.258569,12.335695,3.070702,-9.264993,1.092448,4.439363,3.346915,25.631398,2.016091,-23.615307,0.003869,0.041435,0.037566,0.002387,0.001549,-0.000837999999999999,0.008445,0.334925,0.32648,0,0.002596,0.002596,795.051343,446.121075,-348.930268,3.996308,9.581298,5.58499,18.97945,4.901359,-14.078091,4.029484,5.723395,1.693911,7.678601,1.513707,-6.164894,1.843708,15.845753,14.002045,6.93715,5.336538,-1.600612,28.779118,1.111052,-27.668066,0,90.361783,90.361783,,,
2007-12-01,17607.600378,5854.5,-11753.100378,28517.404076,20673.224455,-7844.179621,169741,101598,-68143,10613.749155,0,-10613.749155,12343.723246,6901.6,-5442.123246,27556,23998,-3558,8545.964007,9831.042702,1285.078695,12564.470561,10202.547932,-2361.922629,42277.989565,29862.730882,-12415.258683,33130.493484,23912.322132,-9218.17135200001,9273.010805,2104.431606,-7168.579199,52102.033101,25729.622015,-26372.411086,162594,100030.457134,-62563.542866,64244.611448,31901.1951,-32343.416348,1412.005486,2146.673124,734.667637999999,1102.303344,2015.396422,913.093078,6895.856961,1235.323412,-5660.533549,0.807147,0.353218,-0.453929,25556.226144,19805.768796,-5750.457348,0,0.00169,0.00169,16721.763421,10056.962086,-6664.801335,209.789172,411.072874,201.283702,21.757523,25.026426,3.268903,151.580111,200.004918,48.424807,305.305469,437.934176,132.628707,142.65429,77.68854,-64.96575,290.692603,422.714498,132.021895,49.669114,318.657902,268.988788,1.214659,129.622441,128.407782,37.445534,230.745778,193.300244,0,64.3118,64.3118,57.536009,218.93171,161.395701,1.323103,36.830436,35.507333,0.760804,57.906123,57.145319,37.547383,53.223799,15.676416,311.983841,597.258118,285.274277,0.126626,5.331616,5.20499,1.039914,19.350972,18.311058,4.02535,8.986198,4.960848,1.448925,14.107044,12.658119,0.056638,0.401222,0.344584,0.101365,7.014209,6.912844,1.209691,13.739136,12.529445,0.034775,5.325638,5.290863,0.153891,5.541284,5.387393,3.522037,47.786516,44.264479,803.32156,152.882601,-650.438959,33.738648,208.273164,174.534516,,,,,,,332.52776,45.827218,-286.700542,0.173673,8.308551,8.134878,0.30632,21.351364,21.045044,954.862203,806.10513,-148.757073,4398.405465,741.002583,-3657.402882,12.158008,14.843433,2.685425,10.242462,29.834897,19.592435,0.008745,0.983398,0.974653,527.648193,236.319159,-291.329034,477.558178,405.551428,-72.00675,32.031999,29.443047,-2.588952,741.387829,851.145299,109.75747,2062.842292,2493.523949,430.681657000001,5.560874,102.239507,96.678633,28.426852,71.897508,43.470656,511.583553,573.490463,61.9069099999999,0.70712,0.011859,-0.695261,16.793131,43.96339,27.170259,1046.320363,358.014001,-688.306362,0,0.097652,0.097652,682.258627,260.844296,-421.414331,330.910357,268.811971,-62.0983859999999,0.20597,0.053488,-0.152482,423.010632,267.534943,-155.475689,4408.42609,3917.051499,-491.374590999999,2119.34482,582.502218,-1536.842602,1648.619551,3143.698217,1495.078666,1141.139985,2156.671441,1015.531456,34.048405,45.217011,11.168606,0.046157,0.671395,0.625238,1.311581,0.922723,-0.388858,3073.111608,2160.889713,-912.221894999999,8001.280336,4071.866995,-3929.413341,1145.999739,212.199395,-933.800344,,,,204.660254,126.824875,-77.835379,145.275162,17.542638,-127.732524,336.938563,115.215131,-221.723432,22.303692,0.984024,-21.319668,1297.316151,1393.886279,96.5701279999998,10.634853,16.639754,6.004901,30.250435,58.455717,28.205282,41.829192,56.367784,14.538592,187.123305,223.121568,35.998263,,,,1487.027606,571.681699,-915.345907,100.354346,5.976441,-94.377905,79.486543,129.941883,50.45534,3.959694,13.425418,9.465724,382.419916,18.836695,-363.583221,32.128013,32.570856,0.442842999999989,90.823952,60.213025,-30.610927,0.094637,12.137775,12.043138,1.38848,4.148364,2.759884,0.015642,2.046532,2.03089,12.490547,1.971552,-10.518995,0.687907,2.636128,1.948221,719.126297,980.682726,261.556429,242.079281,287.729443,45.6501620000001,0.021312,17.77207,17.750758,29.47825,7.210696,-22.267554,0.205321,0.858399,0.653078,0.007911,1.691512,1.683601,2944.685729,1290.375731,-1654.309998,,,,22.095951,18.14143,-3.954521,38.027591,28.694269,-9.33332200000001,4.397265,1.889471,-2.507794,15.923254,2.615879,-13.307375,,,,,,,,,,1.014312,15.477963,14.463651,0.574982,3.757829,3.182847,99.753596,154.235069,54.481473,88.049597,77.818021,-10.231576,25.962162,36.44719,10.485028,352.172961,609.893575,257.720614,1.317923,11.406439,10.088516,2.491196,27.907548,25.416352,6.596622,98.686456,92.089834,944.7761,195.043493,-749.732607,13.146749,31.315875,18.169126,439.5,410.8,-28.7,0,0,0,0.126587,0.068698,-0.057889,90.50089,64.579215,-25.921675,352.978196,306.797931,-46.180265,,,,4106.517041,1403.957007,-2702.560034,57.816024,592.723242,534.907218,167.260616,1216.611394,1049.350778,0.542074,104.369489,103.827415,79.446523,142.776082,63.329559,41.741672,58.374335,16.632663,5.595496,50.398812,44.803316,1871.445081,1454.161442,-417.283639,262.127192,187.996991,-74.130201,6.778591,1.527594,-5.250997,248.612651,64.241444,-184.371207,160.98405,18.033984,-142.950066,0,0.383386,0.383386,1907.870858,686.73986,-1221.130998,920.323818,244.133378,-676.19044,1.081421,0.379823,-0.701598,187.328834,15.975861,-171.352973,3041.740848,1065.343131,-1976.397717,1353.581239,2394.95959,1041.378351,1123.07377,429.839469,-693.234301,0,0.127444,0.127444,4.490676,5.153165,0.662489000000001,772.335572,660.19974,-112.135832,97.882326,13.88227,-84.000056,0.355388,0.058205,-0.297183,0.19931,2.896702,2.697392,25656.56128,6548.881175,-19107.680105,4.074091,2.270135,-1.803956,0,0,0,3491.322447,3057.399564,-433.922883000001,577.024199,1706.541316,1129.517117,3124.036122,2672.142232,-451.893889999999,11780.624197,5202.605983,-6578.018214,816.918136,1737.282503,920.364367,0.000429,0.22518,0.224751,0.037508,0.007411,-0.030097,0.101693,0.108396,0.00670299999999999,0,0.020002,0.020002,10.381235,3.051345,-7.32989,252.061054,232.340532,-19.720522,0.098122,0.275939,0.177817,0.576173,3.433409,2.857236,0.016684,0.015568,-0.001116,0.439855,0.830391,0.390536,0.077696,0.418408,0.340712,0.118381,0.427847,0.309466,0,0,0,0.065079,0.057455,-0.007624,0,0.001217,0.001217,5.673665,8.544263,2.870598,0,0.095849,0.095849,3.295344,17.411493,14.116149,0.509054,1.229658,0.720604,0.131495,3.468663,3.337168,0.013767,1.206801,1.193034,0.002524,1.187452,1.184928,11.421087,2.639556,-8.781531,0.364363,0.826205,0.461842,41.336474,112.504683,71.168209,1758.485236,220.113344,-1538.371892,74.661005,59.533217,-15.127788,226.029692,73.029119,-153.000573,80.165926,388.797096,308.63117,0.688484,14.756781,14.068297,,,,0.00034,0,-0.00034,212.481801,13.000363,-199.481438,0.122301,2.847073,2.724772,35.542185,9.202027,-26.340158,0.396537,13.83547,13.438933,1.10994,1.837821,0.727881,6.982379,6.601727,-0.380652,2.019282,6.885518,4.866236,97.952597,12.657782,-85.294815,11.669801,30.424702,18.754901,0,1.623485,1.623485,0.514867,4.383852,3.868985,0.148523,6.209303,6.06078,3682.812097,290.850462,-3391.961635,0.121841,0.809146,0.687305,114.651559,14.166348,-100.485211,272.313415,2.212082,-270.101333,0.082615,0.146317,0.063702,0.055418,0.396223,0.340805,0.072293,18.485992,18.413699,1175.73765,102.807225,-1072.930425,184.784496,10.876122,-173.908374,0,0.066509,0.066509,0.406661,0.566475,0.159814,0,0.996201,0.996201,11.766024,5.245662,-6.520362,31.844469,16.248248,-15.596221,0.112955,0.094779,-0.018176,2.891481,0.550232,-2.341249,0,0.928587,0.928587,2.6,6.5,3.9,0.003524,0.130339,0.126815,0.251224,14.837941,14.586717,2.240447,7.088526,4.848079,28.398404,29.581186,1.18278199999999,0.804255,0.333699,-0.470556,0,0.055174,0.055174,3.864528,14.04349,10.178962,13.793929,8.203665,-5.590264,0.321472,8.335359,8.013887,23.691855,1.750224,-21.941631,0.00033,0.003698,0.003368,0.002366,0.0096,0.007234,0.376372,0.601463,0.225091,0.024778,0.044079,0.019301,866.761806,494.283207,-372.478599,35.86517,22.072183,-13.792987,11.234865,3.434977,-7.799888,6.82776,4.304718,-2.523042,15.2034,0.847475,-14.355925,1.043114,10.553284,9.51017,6.3384,3.268523,-3.069877,28.76117,2.494149,-26.267021,0,31.478152,31.478152,,,
2008-01-01,20302.1,4377.1,-15925,27757.798182,21151.382151,-6606.41603099999,175412,104441,-70971,10942.093956,0,-10942.093956,13077.62709,6577.4,-6500.22709,25706,21730,-3976,9410.434498,8710.709986,-699.724511999999,13158.564229,9955.983671,-3202.580558,44413.56963,32476.18284,-11937.38679,32571.864871,24540.980426,-8030.88444500001,10095.715627,1962.782842,-8132.932785,53431.534393,23240.127538,-30191.406855,168350.200408,98677.051604,-69673.148804,66923.224167,27931.782255,-38991.441912,1369.994212,1964.032753,594.038540999999,1186.526873,1808.395559,621.868686,7679.778042,1209.86985,-6469.908192,0.672744,0.944011,0.271267,27359.079726,20485.585175,-6873.494551,0.062267,0,-0.062267,17054.489904,11990.597665,-5063.892239,297.650765,339.251839,41.6010740000002,10.606312,21.466395,10.860083,144.237521,197.168963,52.931442,249.705314,418.028281,168.322967,128.221001,70.861761,-57.35924,303.470146,421.866271,118.396125,52.414548,333.489875,281.075327,0.996801,96.975344,95.978543,65.976349,259.093773,193.117424,0,57.775081,57.775081,48.955596,218.933266,169.97767,0.401222,31.080699,30.679477,0.607228,56.561746,55.954518,18.96703,49.611037,30.644007,246.709465,516.855638,270.146173,0.241894,4.699842,4.457948,0.441871,16.319446,15.877575,4.432578,10.936621,6.504043,0.433642,15.246774,14.813132,0.019949,0.268593,0.248644,0.300376,7.114348,6.813972,1.377741,86.5643,85.186559,0.015439,4.064039,4.0486,0.25179,5.665551,5.413761,3.481842,32.513608,29.031766,867.876212,151.821504,-716.054708,139.279447,272.778116,133.498669,,,,,,,273.173946,39.204128,-233.969818,0.33489,19.202025,18.867135,0.105502,21.920092,21.81459,1065.543563,855.41499,-210.128573,4224.855639,820.741795,-3404.113844,12.535806,22.4472,9.911394,8.200869,34.70274,26.501871,0.025934,0.991491,0.965557,918.490253,245.286468,-673.203785,472.718905,453.222488,-19.4964170000001,22.662913,26.417011,3.754098,766.554781,741.570989,-24.9837920000003,2283.882839,2270.041254,-13.8415849999997,5.95236,117.349557,111.397197,19.457171,56.928963,37.471792,496.994591,533.459799,36.465208,0.002188,0.06997,0.067782,20.491211,55.807944,35.316733,968.104117,347.613102,-620.491015,0,0.053316,0.053316,579.754037,329.673032,-250.081005,372.138699,217.680304,-154.458395,0.383333,0.88344,0.500107,362.119821,218.418032,-143.701789,4581.412316,4708.143862,126.731546,2269.983663,634.917117,-1635.066546,1469.755514,3204.466154,1734.71064,1352.909031,2227.502395,874.593364,33.671073,44.825782,11.154709,0.06346,0.447886,0.384426,1.982671,2.417123,0.434452,3342.495182,2145.567325,-1196.927857,7078.525262,4064.462961,-3014.062301,771.021471,212.79213,-558.229341,,,,204.634986,109.560507,-95.074479,111.633664,23.384573,-88.249091,254.903701,98.27373,-156.629971,16.342423,2.644487,-13.697936,1308.070711,1387.592039,79.521328,24.034974,13.148601,-10.886373,11.00187,21.050125,10.048255,52.702,49.251825,-3.450175,188.537756,172.435488,-16.102268,,,,1713.56661,560.210628,-1153.355982,72.548275,8.772177,-63.776098,114.760903,134.891892,20.130989,5.782017,7.363859,1.581842,303.207463,18.228328,-284.979135,24.501812,43.647751,19.145939,224.989773,69.608955,-155.380818,0.231466,4.374051,4.142585,1.079681,4.18793,3.108249,0,4.314068,4.314068,7.239674,2.21534,-5.024334,20.727101,17.38169,-3.345411,800.79235,901.929887,101.137537,231.260608,215.116396,-16.144212,0.039397,89.67547,89.636073,23.529035,37.028525,13.49949,0.02486,0.929149,0.904289,0.007167,0.510085,0.502918,2988.304823,1208.495454,-1779.809369,,,,23.220267,31.951909,8.73164199999999,32.005747,23.289491,-8.71625599999999,1.989024,1.066607,-0.922417,6.444592,3.153814,-3.290778,,,,,,,,,,0.01287,3.046984,3.034114,0.422802,2.960337,2.537535,99.282154,143.451171,44.169017,100.797255,69.495646,-31.301609,31.180446,29.272343,-1.908103,359.542162,592.488639,232.946477,1.060664,9.809225,8.748561,57.970193,47.954486,-10.015707,7.441415,74.839942,67.398527,1368.277919,243.334571,-1124.943348,14.875678,32.090245,17.214567,518.8,414.5,-104.3,0.427188,0,-0.427188,0.111906,0.025806,-0.0861,108.447757,90.08364,-18.364117,707.210991,233.482345,-473.728646,,,,4180.298447,829.025026,-3351.273421,46.033666,149.893324,103.859658,80.476696,953.429488,872.952792,0.524055,33.155207,32.631152,83.900515,93.118535,9.21801999999998,26.121719,37.426814,11.305095,5.845608,42.547995,36.702387,2275.559821,1046.59249,-1228.967331,265.826297,191.77403,-74.052267,5.484478,1.167896,-4.316582,311.379294,20.848198,-290.531096,184.567667,16.076434,-168.491233,0,0.937434,0.937434,1832.852884,738.989178,-1093.863706,979.261681,213.819295,-765.442386,2.205836,2.061445,-0.144391000000001,202.842111,15.510926,-187.331185,2768.164025,1061.435762,-1706.728263,1674.890648,2153.965056,479.074408,1301.565864,425.243998,-876.321866,0,0.138772,0.138772,43.823334,10.042328,-33.781006,738.533912,742.269773,3.73586100000023,101.079218,62.600301,-38.478917,0.002451,0.032529,0.030078,0.503887,3.05155,2.547663,26193.032145,5556.708852,-20636.323293,7.13867,2.119926,-5.018744,0,0,0,3890.436928,2738.731545,-1151.705383,617.110288,1551.395115,934.284827000001,3227.996634,2266.61827,-961.378364,11709.018098,4950.635565,-6758.382533,907.182421,1518.937831,611.75541,0.002572,0.439165,0.436593,0.058253,0.000395,-0.057858,0.041903,0.042015,0.00011199999999998,0,0.000964,0.000964,11.875226,4.120625,-7.754601,246.825652,197.422517,-49.403135,0.117668,0.155589,0.0379209999999999,0.534877,1.346202,0.811325,0.000279,0.090938,0.090659,0.301178,0.914561,0.613383,0.125336,0.228056,0.10272,0.039406,61.060052,61.020646,0.004947,0.568212,0.563265,0.097301,0.15644,0.059139,0,0,0,7.311488,7.375238,0.0637500000000024,0,0.031105,0.031105,3.404753,8.277544,4.872791,0.658331,1.253739,0.595408,0.283431,1.663577,1.380146,0,1.055239,1.055239,0.013083,0.784848,0.771765,7.385526,2.313689,-5.071837,0.264581,0.731347,0.466766,54.457042,121.395468,66.938426,1763.112339,75.462783,-1687.649556,21.786797,63.240979,41.454182,193.77209,72.969035,-120.803055,186.602523,452.235655,265.633132,0.14,19.535003,19.395003,,,,0,0.006254,0.006254,179.277793,15.025251,-164.252542,0.042012,2.981091,2.939079,4.288627,4.319616,0.0309889999999999,6.458483,14.655403,8.19692,0.415329,1.634188,1.218859,20.123583,6.711296,-13.412287,4.070133,2.946637,-1.123496,163.038713,21.325353,-141.71336,7.734568,31.379922,23.645354,0,1.679203,1.679203,0.340362,3.278417,2.938055,0.093186,6.954039,6.860853,3801.75128,235.650938,-3566.100342,0.037503,2.251656,2.214153,188.616219,16.67172,-171.944499,286.39534,3.377701,-283.017639,2.130167,0.040789,-2.089378,0.078167,0.286489,0.208322,0.010535,45.994365,45.98383,1507.880921,93.852608,-1414.028313,563.182326,17.080909,-546.101417,0.14761,0.198312,0.050702,0.06978,0.963701,0.893921,0.023693,0.269066,0.245373,15.249632,5.863445,-9.386187,5.58143,8.578221,2.996791,0.198233,0.19357,-0.004663,0.555901,3.565031,3.00913,0.00226,4.686756,4.684496,1.504686,14.694513,13.189827,0.024496,0.124563,0.100067,0.258442,2.851953,2.593511,32.951002,4.939136,-28.011866,23.491596,19.838488,-3.653108,0.107783,0.490165,0.382382,0.006735,0.736703,0.729968,3.645896,8.115576,4.46968,14.013101,2.476315,-11.536786,1.235227,13.655871,12.420644,23.73655,6.107312,-17.629238,0.002371,0.119806,0.117435,0.128658,0.163228,0.03457,0.05767,0.153915,0.096245,0.485,0.003009,-0.481991,735.379079,530.640964,-204.738115,1.043616,13.639667,12.596051,21.352047,5.654984,-15.697063,5.229822,6.171579,0.941757000000001,12.27409,1.016932,-11.257158,13.901981,1.740845,-12.161136,5.088331,3.173978,-1.914353,26.514927,0.092552,-26.422375,0,0,0,,,
2008-02-01,17616.8,4555.9,-13060.9,30472.96132,23431.009353,-7041.951967,179496,107512,-71984,11170.429318,0,-11170.429318,13588.199594,7236,-6352.199594,25384,21373,-4011,8553.264128,9082.336866,529.072737999999,11759.050005,10277.588913,-1481.461092,45173.550868,33217.697984,-11955.852884,34922.673327,27968.748361,-6953.92496599999,8057.706608,2346.308168,-5711.39844,50476.097585,24521.414915,-25954.68267,165069.697,104740.035375,-60329.6616250003,64229.765736,28855.770396,-35373.99534,1627.047031,2049.062014,422.014983,926.527546,2072.078373,1145.550827,6288.116679,1424.514962,-4863.601717,0.42291,1.84318,1.42027,27499.002252,21255.836612,-6243.16564000001,0,0,0,17674.548616,11961.861372,-5712.687244,279.416356,357.350548,77.9341919999999,7.421412,23.777933,16.356521,174.004181,214.693089,40.688908,326.424703,408.427608,82.0029049999999,150.044535,60.139778,-89.904757,350.706437,488.721051,138.014614,30.716036,424.039415,393.323379,0.654554,35.93645,35.281896,46.277899,222.322857,176.044958,0,67.985758,67.985758,52.645129,198.433308,145.788179,0.775146,29.119279,28.344133,0.550702,53.398725,52.848023,28.076125,67.374875,39.29875,346.450819,519.72994,173.279121,0.242823,5.28016,5.037337,0.26995,26.945364,26.675414,4.994413,11.17577,6.181357,0.297866,14.983361,14.685495,0.126733,0.29405,0.167317,0.298448,5.311035,5.012587,1.571655,8.993915,7.42226,0.015276,7.170043,7.154767,0.347358,4.966219,4.618861,3.098672,44.219357,41.120685,772.751249,157.442386,-615.308863,51.811547,300.4401,248.628553,,,,,,,104.533371,129.016374,24.483003,2.352786,21.95493,19.602144,2.927736,16.560243,13.632507,989.291625,947.55962,-41.732005,3442.384927,851.885798,-2590.499129,10.601999,19.169499,8.5675,11.232187,30.277321,19.045134,0,0.463911,0.463911,645.9327,228.902283,-417.030417,525.122789,361.71356,-163.409229,58.527031,27.663085,-30.863946,868.230453,940.128029,71.8975759999998,2046.976144,2228.421398,181.445254,5.530701,114.617328,109.086627,17.586705,58.24221,40.655505,397.806591,542.308715,144.502124,0.022236,0.032235,0.009999,12.629674,49.109652,36.479978,1086.155615,389.084134,-697.071481,0,0.138051,0.138051,465.631123,235.604749,-230.026374,383.244485,260.712618,-122.531867,0.153049,0.299373,0.146324,446.992312,247.58702,-199.405292,4838.377268,4765.858767,-72.5185010000014,2783.188723,776.258992,-2006.929731,1517.68041,3461.889884,1944.209474,1674.77069,2396.025923,721.255233,43.09821,56.923882,13.825672,0.137914,1.342208,1.204294,1.824414,0.921899,-0.902515000000001,3669.500988,2241.228765,-1428.272223,7978.731575,4631.014933,-3347.716642,1112.595672,269.710727,-842.884945,,,,200.963178,92.543326,-108.419852,131.712499,22.244958,-109.467541,268.558773,117.151257,-151.407516,24.005674,1.830074,-22.1756,1321.093105,2168.11415,847.021045,15.713413,17.087369,1.373956,55.602025,26.658664,-28.943361,62.607431,57.968878,-4.63855299999998,180.062515,614.565006,434.502491,,,,1665.582179,757.372171,-908.210008,131.794924,6.808427,-124.986497,81.929165,121.378046,39.448881,1.912228,10.460264,8.548036,225.382254,14.010163,-211.372091,11.170352,40.88315,29.712798,119.090083,96.492199,-22.597884,0.440273,3.291676,2.851403,0.817108,9.055563,8.238455,0.196427,0.802672,0.606245,2.221305,7.71835,5.497045,37.471197,1.848868,-35.622329,742.406702,1153.176759,410.770057,192.912922,252.385523,59.472601,0.017543,219.00473,218.987187,23.607106,12.09826,-11.508846,0.03284,1.474032,1.441192,0.070833,0.393229,0.322396,2854.032529,1295.255611,-1558.776918,,,,17.469133,44.418001,26.948868,30.761089,16.345729,-14.41536,1.06307,1.258653,0.195583,0.946267,1.893333,0.947066,,,,,,,,,,0.014308,1.563816,1.549508,0.6327,1.168186,0.535486,65.864855,161.736378,95.871523,86.596046,64.706311,-21.889735,26.544236,21.962489,-4.58174699999999,321.733352,719.408747,397.675395,0.680053,8.82719,8.147137,34.192234,43.675563,9.483329,6.57946,99.013012,92.433552,1711.938783,136.083348,-1575.855435,15.382213,7.251526,-8.130687,433.7,421.3,-12.4,0.105305,0.00515,-0.100155,0.093682,0,-0.093682,90.249147,61.518308,-28.730839,619.444535,170.227796,-449.216739,,,,4333.264697,815.889497,-3517.3752,44.242443,212.541738,168.299295,134.68959,1049.350788,914.661198,0.702885,17.082516,16.379631,20.128821,139.353813,119.224992,65.56761,44.009739,-21.557871,7.633241,40.192703,32.559462,2103.569475,1226.223126,-877.346349,241.279235,102.392988,-138.886247,6.531962,2.202877,-4.329085,277.57615,27.514647,-250.061503,169.099631,14.362745,-154.736886,0,0.805298,0.805298,1853.043204,708.213504,-1144.8297,997.20745,232.440412,-764.767038,1.725529,1.899108,0.173579,201.160506,14.826306,-186.3342,2444.764726,1032.736003,-1412.028723,1384.972332,2396.055306,1011.082974,1147.528404,404.78321,-742.745194,0.023548,0.236352,0.212804,9.108647,8.710802,-0.397844999999998,685.718173,687.831092,2.11291900000003,92.702689,41.90756,-50.795129,0.05039,0.258626,0.208236,0.220464,2.039781,1.819317,24095.886455,5698.054777,-18397.831678,6.178362,5.688287,-0.490074999999999,0,0,0,3828.386703,2745.550022,-1082.836681,558.448038,1799.874245,1241.426207,2781.457055,2140.857293,-640.599762,12541.959683,5523.870693,-7018.08899,671.203981,1860.154727,1188.950746,0,0.362352,0.362352,0.054153,0.006368,-0.047785,0.080938,0.026833,-0.054105,0,0,0,9.648087,2.991221,-6.656866,224.312612,178.037964,-46.274648,0.155312,0.086155,-0.069157,1.063662,1.718695,0.655033,0.036959,0.074657,0.037698,0.470681,1.296141,0.82546,0.087238,1.240238,1.153,0.207032,0.161069,-0.045963,0,0,0,0.085532,0.103829,0.018297,0.000552,0,-0.000552,4.671364,5.158626,0.487262,0,0.104601,0.104601,2.839292,10.854903,8.015611,0.85595,1.881851,1.025901,0.227888,1.893303,1.665415,0.003,1.071672,1.068672,0.0723,1.036028,0.963728,10.184332,2.891297,-7.293035,0.259073,1.01128,0.752207,79.538104,161.271504,81.7334,1193.050079,140.931892,-1052.118187,113.446482,49.090448,-64.356034,117.151079,40.591585,-76.559494,121.385297,494.414436,373.029139,0.160498,13.703018,13.54252,,,,0,0.006996,0.006996,200.732943,13.724014,-187.008929,0.006,10.807567,10.801567,66.239376,9.655686,-56.58369,1.391659,9.430699,8.03904,0.515176,3.295,2.779824,7.758749,10.16276,2.404011,5.73237,3.751562,-1.980808,162.815176,11.946279,-150.868897,8.480872,50.10284,41.621968,0.005363,5.075033,5.06967,0.60894,4.625636,4.016696,0.009368,7.195345,7.185977,3063.927127,352.747832,-2711.179295,0.444423,0.786783,0.34236,112.21412,14.358192,-97.855928,257.549907,1.869242,-255.680665,0.108497,0.041363,-0.067134,0.032717,1.219173,1.186456,0.091503,115.276291,115.184788,1003.688118,109.607999,-894.080119,420.355679,5.044521,-415.311158,0.001056,0.19651,0.195454,0.075363,0.682848,0.607485,0.016373,0.293425,0.277052,11.826835,11.62349,-0.203344999999999,15.869498,6.156435,-9.713063,0.132658,1.063032,0.930374,0.937226,2.131178,1.193952,0.003338,2.059709,2.056371,2.323081,8.471025,6.147944,0.003063,0.126108,0.123045,0.640251,2.074563,1.434312,2.876575,14.633989,11.757414,21.139323,28.309969,7.17064599999999,0.54862,1.276428,0.727808,0.505272,0.020188,-0.485084,2.491389,11.893113,9.401724,15.049252,3.258385,-11.790867,0.153814,9.993335,9.839521,22.659431,4.18257,-18.476861,0,0.001989,0.001989,0.000397,0.018846,0.018449,0.244038,0.227485,-0.016553,0.003487,0.051955,0.048468,816.271443,492.240659,-324.030784,7.147959,22.648887,15.500928,16.590268,7.472173,-9.118095,3.922963,8.712214,4.789251,5.922733,0.555551,-5.367182,3.174153,3.714126,0.539972999999999,3.846618,4.85563,1.009012,19.328721,0.414259,-18.914462,0,0,0,,,
2008-03-01,18816.3,4540.3,-14276,31692.061606,23594.560672,-8097.500934,175126,105976,-69150,11702.413845,0,-11702.413845,14271.621079,7795.4,-6476.221079,28038,23942,-4096,8966.816487,10148.729418,1181.912931,12380.229228,10889.598317,-1490.63091100001,47675.163586,34771.330803,-12903.832783,36705.376363,28977.117755,-7728.25860800002,9169.24846,2277.015008,-6892.233452,50190.203736,26903.063105,-23287.140631,171194.029967,110931.661862,-60262.3681050001,64257.10199,31653.59695,-32603.50504,1629.920025,2092.376816,462.456791,1006.611022,2360.704899,1354.093877,7458.747129,1250.457309,-6208.28982,0.299318,2.272959,1.973641,29968.019972,22978.233146,-6989.786826,0,0.025171,0.025171,17707.143614,11793.097657,-5914.045957,291.475703,383.90166,92.4259569999999,7.961985,28.401476,20.439491,180.47692,209.267068,28.790148,328.42428,399.681048,71.2567679999999,136.589606,89.349864,-47.239742,358.950636,427.673184,68.722548,29.968973,423.278357,393.309384,0.481965,52.890238,52.408273,27.2646,226.553438,199.288838,0,42.128063,42.128063,50.92914,231.639365,180.710225,1.276626,37.278617,36.001991,2.252442,57.877131,55.624689,33.133897,74.283557,41.14966,334.00288,582.503992,248.501112,0.463576,6.498503,6.034927,0.148234,22.739833,22.591599,4.475679,9.041557,4.565878,0.322495,11.693352,11.370857,0.010326,0.273361,0.263035,0.267975,11.615078,11.347103,1.304481,12.938432,11.633951,0.116615,5.925234,5.808619,0.516286,6.370975,5.854689,2.249727,39.126918,36.877191,766.318921,177.490848,-588.828073,166.993766,225.517299,58.523533,,,,,,,233.954859,41.632963,-192.321896,0.19825,20.793104,20.594854,0.338298,15.423756,15.085458,912.452197,1082.635942,170.183745,3615.370698,832.25329,-2783.117408,13.426257,17.07201,3.645753,9.250158,30.376815,21.126657,0.000934,2.346173,2.345239,835.992936,265.789659,-570.203277,423.325161,570.244942,146.919781,16.810807,35.185765,18.374958,776.092764,993.777432,217.684668,2344.481123,2409.417944,64.9368210000002,3.853331,129.296631,125.4433,17.296654,71.593057,54.296403,451.007067,575.801238,124.794171,0,0.019148,0.019148,19.406585,48.437553,29.030968,1166.09035,420.556069,-745.534281,0,0.056999,0.056999,640.12612,270.317315,-369.808805,437.718492,318.234909,-119.483583,0.130583,1.158156,1.027573,459.603727,248.1467,-211.457027,4663.986762,4642.866683,-21.1200790000003,2668.386606,789.549853,-1878.836753,1567.727404,3429.246377,1861.518973,1569.839422,2571.243244,1001.403822,44.639666,77.896214,33.256548,0.127524,1.164891,1.037367,1.081043,1.406301,0.325258,3715.516467,2599.917521,-1115.598946,9157.35464,4630.15249,-4527.20215,795.696538,252.485513,-543.211025,,,,232.358377,99.138487,-133.21989,104.065463,49.259359,-54.806104,305.843599,127.696397,-178.147202,22.540061,3.063295,-19.476766,1303.341507,2799.740796,1496.399289,34.966619,21.886383,-13.080236,9.859763,35.830916,25.971153,136.605367,56.034396,-80.570971,254.224671,237.699887,-16.524784,,,,1978.01995,811.421036,-1166.598914,56.312533,10.65831,-45.654223,148.268506,144.381147,-3.88735899999998,3.543619,13.299598,9.755979,346.188605,14.128875,-332.05973,1.095326,46.611322,45.515996,77.19306,93.765461,16.572401,0.120075,3.96456,3.844485,1.319613,6.159554,4.839941,0.547,0.586535,0.0395349999999998,2.594412,6.09608,3.501668,38.609959,184.615907,146.005948,908.389424,1095.152631,186.763207,188.667023,207.39975,18.732727,0,144.446162,144.446162,27.099659,34.023118,6.92345900000002,0.06487,1.389323,1.324453,0.00387,0.556719,0.552849,3029.073616,1373.353766,-1655.71985,,,,21.92024,34.173742,12.253502,46.486871,23.106698,-23.380173,1.400725,6.373429,4.972704,1.201898,4.440398,3.2385,,,,,,,,,,0.073528,2.249349,2.175821,1.335227,1.829722,0.494495,48.345908,101.383125,53.037217,86.455752,96.993384,10.537632,32.140046,43.684838,11.544792,340.437862,715.448481,375.010619,0.919374,11.621964,10.70259,34.645208,14.480709,-20.164499,11.662155,136.572291,124.910136,2349.447061,202.762849,-2146.684212,9.50808,6.617163,-2.890917,513.3,634.4,121.1,0.112258,0,-0.112258,0.124771,0.01257,-0.112201,89.835065,68.570794,-21.264271,540.452956,213.725355,-326.727601,,,,3621.833303,943.701484,-2678.131819,52.396049,173.337295,120.941246,129.008963,836.800343,707.79138,0.613581,42.122882,41.509301,18.727716,173.475462,154.747746,28.45547,64.450143,35.994673,11.522991,38.418909,26.895918,2251.232995,1446.012496,-805.220499,289.675516,311.619731,21.9442149999999,8.258641,3.599873,-4.658768,321.078007,28.337937,-292.74007,183.792279,22.43578,-161.356499,0,0.577598,0.577598,2035.932675,706.466691,-1329.465984,852.93396,353.192117,-499.741843,4.844347,0.438939,-4.405408,233.909086,16.282049,-217.627037,2753.2784,1169.150552,-1584.127848,1433.44905,2654.575105,1221.126055,1212.683563,498.2941,-714.389463,0,0.240487,0.240487,5.934564,11.222048,5.287484,783.856173,805.112281,21.2561080000002,58.357572,25.201665,-33.155907,0.038158,1.603147,1.564989,0.691198,2.792639,2.101441,22440.24177,6294.351708,-16145.890062,3.835961,3.042995,-0.792966,0,0,0,4006.186482,3191.920791,-814.265691000001,534.512703,1768.058442,1233.545739,2992.668252,2534.17508,-458.493171999999,13015.592185,5626.644197,-7388.947988,624.660554,2111.628059,1486.967505,0,0.275529,0.275529,0.030992,0.106041,0.075049,0.30085,0.080201,-0.220649,0,0.41883,0.41883,8.127252,6.044254,-2.082998,320.655216,206.684823,-113.970393,0.043169,0.089469,0.0463,0.336661,4.168617,3.831956,0.000331,0.076878,0.076547,0.365562,0.982392,0.61683,0.082762,1.036128,0.953366,0.161219,0.121319,-0.0399,0,0,0,0.090365,0.042486,-0.047879,0,0.028883,0.028883,2.117953,5.527047,3.409094,0.022031,0.017331,-0.0047,33.917351,11.33972,-22.577631,0.886519,2.143227,1.256708,0.236766,4.874194,4.637428,0,1.010204,1.010204,0.002382,0.526132,0.52375,14.124566,2.687224,-11.437342,0.470552,1.044474,0.573922,98.603355,192.38236,93.779005,1067.62219,184.452026,-883.170164,66.316813,50.975312,-15.341501,124.037635,63.893424,-60.144211,168.794083,563.880834,395.086751,0,17.603008,17.603008,,,,0,0.000114,0.000114,113.913613,9.083952,-104.829661,1.27606,4.17978,2.90372,23.481471,8.455185,-15.026286,0.428592,7.358292,6.9297,0.114668,1.817438,1.70277,10.152478,7.833766,-2.318712,2.065474,5.393968,3.328494,131.802692,12.452364,-119.350328,51.141153,69.3592,18.218047,0,3.542705,3.542705,0.522729,9.533763,9.011034,7.303605,20.981722,13.678117,3630.859448,245.107541,-3385.751907,0.106857,3.259874,3.153017,109.327554,12.34662,-96.980934,233.220435,3.872037,-229.348398,0.85941,0.108795,-0.750615,0.102644,0.964067,0.861423,0.034957,42.427269,42.392312,1442.965188,103.428976,-1339.536212,465.608928,10.477138,-455.13179,0,0.019732,0.019732,0.125307,0.402257,0.27695,0,0.478892,0.478892,0.372738,6.067619,5.694881,19.030808,15.559301,-3.471507,0.960814,0.176898,-0.783916,0.315433,1.211537,0.896104,0.009181,4.050815,4.041634,1.987871,25.836926,23.849055,0,1.245882,1.245882,0.610742,3.071076,2.460334,0.659834,12.108025,11.448191,30.475947,29.643663,-0.832283999999998,0.504147,0.900484,0.396337,0.153096,0.000072,-0.153024,7.567784,13.3534,5.785616,12.766574,2.789503,-9.977071,3.366504,8.625376,5.258872,26.571681,5.603575,-20.968106,0.047413,0,-0.047413,0,0.010098,0.010098,0.001752,0.709367,0.707615,0,0.000862,0.000862,983.449219,496.666538,-486.782681,54.592717,15.513164,-39.079553,6.015264,4.805249,-1.210015,2.072668,5.005971,2.933303,10.627281,1.135689,-9.491592,29.800025,4.918116,-24.881909,2.047931,1.999637,-0.0482940000000001,33.706475,0.009963,-33.696512,0,0,0,,,
2008-04-01,20936,5088,-15848,32752.32345,23664.395966,-9087.927484,182776,110383,-72393,12406.225341,0,-12406.225341,15415.633553,7973.5,-7442.133553,28638,22865,-5773,9267.156541,9594.855393,327.698851999998,13136.734798,11153.517857,-1983.216941,50597.467655,35956.726386,-14640.741269,38446.024645,28650.237311,-9795.78733399997,10599.723582,2279.949375,-8319.774207,54352.613443,24786.76625,-29565.847193,182115.080249,109856.654615,-72258.4256339999,68205.614147,29952.56527,-38253.048877,1746.233979,2310.027957,563.793978000001,1129.509471,1862.773804,733.264333000001,7982.178894,1419.371979,-6562.806915,0.005951,0.868324,0.862373,31232.599736,23463.787147,-7768.81258899999,0,0.016288,0.016288,19364.867919,12492.939239,-6871.92868,343.772329,471.8447,128.072371,6.652523,33.568163,26.91564,181.093998,218.823379,37.729381,343.79656,422.10976,78.3131999999999,148.676571,76.20308,-72.473491,338.607726,462.741369,124.133643,25.630248,356.138253,330.508005,1.767497,68.435172,66.667675,39.682824,209.063688,169.380864,0,83.174994,83.174994,70.951184,266.795881,195.844697,2.241705,37.645342,35.403637,1.066,51.80298,50.73698,37.879766,63.078898,25.199132,390.286795,658.305669,268.018874,0.413846,6.478704,6.064858,0.353575,19.178303,18.824728,6.960481,9.489638,2.529157,0.90539,14.966275,14.060885,0.002522,0.334427,0.331905,0.054179,13.63887,13.584691,1.471607,13.227645,11.756038,0.160463,3.792305,3.631842,1.187181,5.715635,4.528454,4.274706,37.161185,32.886479,808.956278,168.739886,-640.216392,57.849395,216.291444,158.442049,,,,,,,238.205436,68.088053,-170.117383,0.731273,54.568633,53.83736,0.05502,14.534434,14.479414,1170.921009,973.161701,-197.759308,3798.062843,870.36862,-2927.694223,14.124945,19.6366,5.511655,11.640341,37.772899,26.132558,0.002193,1.21224,1.210047,743.715933,292.554328,-451.161605,503.582364,468.707449,-34.874915,65.573929,33.085278,-32.488651,815.438955,1075.141728,259.702773,2382.884005,2452.514529,69.6305240000006,3.86533,133.232935,129.367605,16.000551,94.305086,78.304535,553.935711,575.840924,21.905213,3.299611,0.046775,-3.252836,14.918869,38.350812,23.431943,1149.722032,462.246013,-687.476019,0.003763,0.212248,0.208485,651.52648,281.744386,-369.782094,556.431791,362.217246,-194.214545,0.195262,0.307221,0.111959,397.816803,258.234651,-139.582152,5102.380036,4959.564044,-142.815992,2707.099032,669.227711,-2037.871321,1753.10599,3253.341838,1500.235848,1611.021022,2344.661908,733.640886,52.999352,64.914596,11.915244,0.058557,1.93383,1.875273,1.048983,1.362316,0.313333,3871.17252,2512.483034,-1358.689486,9217.127599,4760.718929,-4456.40867,791.642273,244.700609,-546.941664,,,,215.11455,109.551143,-105.563407,114.810695,55.36285,-59.447845,286.273871,117.152549,-169.121322,24.021702,9.069925,-14.951777,1540.587424,2379.525427,838.938003,57.346958,23.227519,-34.119439,9.366855,29.781484,20.414629,70.907585,78.312729,7.40514400000002,218.278709,285.177829,66.89912,,,,2186.651859,996.605831,-1190.046028,69.365956,14.879625,-54.486331,168.719743,160.678693,-8.04104999999998,1.514832,11.121952,9.60712,208.224417,24.147017,-184.0774,30.210076,47.022747,16.812671,251.548571,75.472654,-176.075917,0.508177,6.065097,5.55692,0.808459,7.987151,7.178692,0.001734,4.99808,4.996346,1.021486,2.908522,1.887036,50.401814,3.336705,-47.065109,815.384927,1011.214356,195.829429,202.646101,274.366876,71.720775,0.002233,175.376649,175.374416,31.656391,78.9338,47.277409,0.085377,2.319815,2.234438,0.128171,0.921501,0.79333,3289.100762,1370.381435,-1918.719327,,,,23.841551,35.008122,11.166571,41.90941,25.085582,-16.823828,2.340836,1.746021,-0.594814999999999,12.321217,2.090407,-10.23081,,,,,,,,,,0.015378,2.48332,2.467942,0.765571,6.540882,5.775311,86.805642,138.736397,51.930755,73.452148,107.467898,34.01575,26.428834,49.803149,23.374315,447.881036,674.163052,226.282016,2.321562,17.529791,15.208229,2.191512,42.78318,40.591668,10.12791,83.431221,73.303311,1960.949665,155.09314,-1805.856525,7.884845,5.747369,-2.137476,388.1,406,17.9,0.2324,0,-0.2324,0.117946,0.006088,-0.111858,95.047321,66.325406,-28.721915,675.33785,191.95249,-483.38536,,,,4418.777955,1012.432648,-3406.345307,40.667554,248.743753,208.076199,110.028922,1108.671398,998.642476,0.536936,86.49468,85.957744,8.086462,111.74058,103.654118,45.992785,129.692835,83.70005,12.069347,42.919336,30.849989,2127.083642,1104.586185,-1022.497457,280.445627,149.93859,-130.507037,8.710505,1.816878,-6.893627,287.203063,58.675877,-228.527186,147.059155,21.243236,-125.815919,0,0.49294,0.49294,1893.749039,791.194699,-1102.55434,832.743832,287.466211,-545.277621,2.808442,0.801312,-2.00713,176.810276,22.349046,-154.46123,2853.112423,1063.470445,-1789.641978,1396.474221,2492.086069,1095.611848,1312.232361,545.272581,-766.95978,0,0.214914,0.214914,6.424561,7.506982,1.082421,744.696724,657.663368,-87.0333559999998,71.208561,19.601206,-51.607355,0.035412,0.082681,0.047269,0.160862,2.325236,2.164374,25951.666996,5651.24836,-20300.418636,3.411142,4.016669,0.605527000000002,0,0.056469,0.056469,4403.455086,3145.240587,-1258.214499,450.134096,1810.095801,1359.961705,3017.093138,2147.432936,-869.660202,13045.250703,5431.191919,-7614.058784,836.525928,1608.845271,772.319343,0.024559,0.433194,0.408635,0.186892,0.389388,0.202496,0.139341,0.196638,0.057297,0,1.52596,1.52596,9.843575,3.267005,-6.57657,254.49507,203.84372,-50.65135,0.056814,0.110977,0.054163,0.252961,2.412695,2.159734,0.014841,0.053863,0.039022,0.155724,1.230101,1.074377,0.075254,0.311494,0.23624,0.124791,0.197608,0.072817,0,0,0,0.046539,0.112476,0.065937,0.010741,0.014041,0.0033,9.409243,15.407676,5.998433,0,0.000849,0.000849,2.655562,14.184763,11.529201,0.95539,2.810365,1.854975,0.230755,3.478753,3.247998,0.002781,1.141949,1.139168,0.016491,0.349742,0.333251,13.750019,2.659139,-11.09088,0.544801,1.279792,0.734991,65.845834,119.444013,53.598179,2017.980292,152.390775,-1865.589517,97.099721,22.893174,-74.206547,0.082278,13.767341,13.685063,157.238704,483.295725,326.057021,1.0975,7.038674,5.941174,,,,0,0,0,155.425732,14.507719,-140.918013,0.012657,30.262486,30.249829,18.298013,4.311134,-13.986879,0.396986,9.016621,8.619635,0.594805,1.977392,1.382587,8.847093,6.736896,-2.110197,2.02491,5.442441,3.417531,53.827662,20.460334,-33.367328,17.658085,42.236225,24.57814,0.005193,1.471045,1.465852,0.144882,5.645103,5.500221,0.218054,9.556001,9.337947,3742.132152,239.858135,-3502.274017,0.119262,1.972965,1.853703,301.292052,11.958152,-289.3339,424.899956,8.357384,-416.542572,1.317148,0.042285,-1.274863,0.011098,1.732061,1.720963,0.051107,100.398882,100.347775,1830.303948,183.887419,-1646.416529,411.95138,17.49803,-394.45335,0,0.057166,0.057166,0.010288,2.382419,2.372131,0.009371,0.210553,0.201182,13.866078,10.774955,-3.091123,23.8399,10.516907,-13.322993,0.538983,0.106232,-0.432751,0.616668,2.182622,1.565954,0.005626,3.468028,3.462402,3.746899,7.489987,3.743088,0,6.366085,6.366085,0.734951,5.716823,4.981872,1.88673,10.410469,8.523739,25.467813,41.485733,16.01792,0.527524,1.087834,0.56031,0.11632,0.01862,-0.0977,6.268203,14.003184,7.734981,14.198721,3.772074,-10.426647,0.242481,6.690689,6.448208,24.540052,4.221364,-20.318688,0,0,0,0.040424,0.007983,-0.032441,0.018557,1.408815,1.390258,0.005,0.044,0.039,812.707233,486.703011,-326.004222,10.259866,12.074019,1.814153,17.870722,3.692152,-14.17857,2.443342,7.557168,5.113826,8.374445,1.693065,-6.68138,3.027478,3.150179,0.122701,3.281302,6.88404,3.602738,25.187662,0.025196,-25.162466,0,0,0,,,
2008-05-01,22902.1,4804.6,-18097.5,32658.059058,23797.264352,-8860.79470599999,183767,110828,-72939,12785.184264,0,-12785.184264,14809.890497,8479.3,-6330.590497,27821,23228,-4593,9172.78262,9907.800307,735.017687,13956.281604,11849.000102,-2107.281502,49107.968921,36684.373369,-12423.595552,38264.52339,28314.875357,-9949.64803300001,10450.630904,2171.717706,-8278.913198,54143.199272,26768.192086,-27375.007186,182956.261112,112626.996057,-70329.2650550002,69927.653947,31334.477741,-38593.176206,1647.278795,2084.717429,437.438634,1248.604982,2271.204435,1022.599453,7564.241677,1422.089531,-6142.152146,0.597364,1.319316,0.721952,30270.778441,24386.503776,-5884.27466499999,0,0.028031,0.028031,18837.19048,12297.869593,-6539.320887,313.094218,366.97765,53.883432,4.828219,36.568541,31.740322,185.858144,212.216935,26.358791,335.981094,405.665994,69.6848999999999,127.201975,78.526511,-48.675464,371.754321,492.565228,120.810907,36.144867,510.931622,474.786755,1.851854,114.663079,112.811225,27.573934,249.629628,222.055694,0.003,52.173294,52.170294,91.240024,246.627439,155.387415,0.769441,44.487762,43.718321,0.868744,80.571843,79.703099,41.580115,71.438326,29.858211,313.389043,528.765111,215.376068,0.524419,10.479364,9.954945,3.175657,22.949098,19.773441,4.081822,8.626633,4.544811,0.255582,12.985317,12.729735,0.002083,1.192354,1.190271,0.138731,8.831768,8.693037,1.69041,20.514576,18.824166,0.005499,11.24998,11.244481,1.150123,6.589207,5.439084,3.971809,43.571715,39.599906,753.945959,210.137188,-543.808771,131.954893,270.959328,139.004435,,,,,,,204.243144,45.536379,-158.706765,0.725166,27.650008,26.924842,0.060574,28.224837,28.164263,1345.745832,905.450056,-440.295776,4822.22626,943.96351,-3878.26275,15.275188,43.816279,28.541091,11.368233,32.865609,21.497376,0,2.881699,2.881699,537.427133,279.549953,-257.87718,440.207959,519.335672,79.127713,30.350986,30.73332,0.38233399999999,713.81814,1277.599167,563.781027,2648.628553,2609.515386,-39.113167,4.891047,163.893153,159.002106,17.622637,93.218232,75.595595,410.345751,724.847481,314.50173,0.309021,0.02387,-0.285151,17.953475,41.832452,23.878977,1172.781304,438.797458,-733.983846,0.0095,0.179143,0.169643,952.348167,300.332535,-652.015632,734.464235,338.405481,-396.058754,0.22092,2.916031,2.695111,594.177484,225.945485,-368.231999,5588.740415,4822.899885,-765.840530000001,2640.000659,527.950822,-2112.049837,2046.833334,3176.014774,1129.18144,1575.160503,2715.724546,1140.564043,48.437102,73.394082,24.95698,0.012003,1.201097,1.189094,2.622133,1.299452,-1.322681,3568.787325,2774.455371,-794.331954,8402.959365,4804.451347,-3598.508018,645.733292,203.360509,-442.372783,,,,222.047771,167.900942,-54.146829,117.382491,37.115517,-80.266974,271.785409,122.178742,-149.606667,23.975677,2.478308,-21.497369,1500.273227,1792.391058,292.117831,8.935282,20.795242,11.85996,10.102183,47.146514,37.044331,78.05106,71.931182,-6.119878,194.093642,238.255929,44.162287,,,,2309.928727,787.147254,-1522.781473,44.024788,12.196572,-31.828216,102.555306,177.598471,75.043165,1.291848,17.589846,16.297998,1.608336,12.96405,11.355714,51.996772,40.783,-11.213772,138.628399,100.111507,-38.516892,0.279011,2.766732,2.487721,0.976651,2.278997,1.302346,2.31527,0.773496,-1.541774,29.378401,3.569507,-25.808894,7.526333,7.455089,-0.0712440000000019,1014.164891,976.168226,-37.996665,250.594704,179.304519,-71.290185,0.033172,196.505833,196.472661,21.000184,8.055017,-12.945167,0.023157,0.630169,0.607012,0.006917,0.91025,0.903333,3228.231243,1462.630997,-1765.600246,,,,22.524652,40.21962,17.694968,40.277603,26.014506,-14.263097,1.828614,3.02383,1.195216,16.586031,3.250123,-13.335908,,,,,,,,,,0.028531,3.112412,3.083881,1.125524,2.756595,1.631071,82.318944,166.587549,84.268605,75.296232,100.184049,24.887817,24.631726,52.553571,27.921845,370.87052,928.86649,557.99597,1.070675,19.04209,17.971415,2.327143,20.131408,17.804265,15.518537,71.053961,55.535424,1981.734709,179.003133,-1802.731576,5.658452,7.585032,1.92658,481.7,608.3,126.6,0.261453,0,-0.261453,0.204087,0.00515,-0.198937,69.319088,73.977086,4.65799800000002,786.077491,204.082885,-581.994606,,,,5645.925787,849.408769,-4796.517018,24.235587,124.956261,100.720674,101.878117,1180.04262,1078.164503,0.870305,21.567719,20.697414,14.890205,78.372413,63.482208,37.05523,61.313125,24.257895,9.133732,60.709369,51.575637,2183.931916,1444.056959,-739.874957,319.442959,155.207205,-164.235754,5.318276,1.244752,-4.073524,278.49052,29.402708,-249.087812,137.088357,15.580685,-121.507672,0,0.318552,0.318552,1933.530151,786.189428,-1147.340723,994.482048,277.129918,-717.35213,2.948428,0.571698,-2.37673,165.473952,17.418001,-148.055951,2777.406583,1102.62271,-1674.783873,1358.1555,2513.099328,1154.943828,1300.534537,431.685916,-868.848621,0,0.551326,0.551326,5.289083,9.330259,4.041176,700.373944,759.892419,59.5184749999997,88.362622,21.153707,-67.208915,0.040525,0.233546,0.193021,0.32296,1.595748,1.272788,27634.532443,6275.672316,-21358.860127,3.604809,5.783406,2.178597,0,0,0,4261.944286,3091.492379,-1170.451907,489.137261,1924.57302,1435.435759,3063.545573,2378.63558,-684.909992999999,11244.36607,6024.576574,-5219.789496,906.013492,2013.990165,1107.976673,0.006918,0.06213,0.055212,0.181936,0.038051,-0.143885,0.005597,0.323681,0.318084,0,0.812867,0.812867,6.76275,4.878579,-1.884171,306.775128,216.589134,-90.185994,0.265774,0.305822,0.0400480000000001,0.318969,3.66994,3.350971,0.01116,0.042397,0.031237,0.303811,0.72956,0.425749,0.045355,0.268526,0.223171,0.124484,0.258092,0.133608,0,0,0,0.105232,0.073298,-0.031934,0.000005,0.037759,0.037754,4.349179,7.551432,3.202253,0,0.085769,0.085769,5.623879,11.231521,5.607642,0.753327,1.641237,0.887909999999999,0.27939,2.408042,2.128652,0,0.894805,0.894805,0,1.370273,1.370273,16.175303,3.809317,-12.365986,0.472957,0.996026,0.523069,62.224614,55.66284,-6.561774,2124.798653,81.508404,-2043.290249,43.999504,42.254325,-1.745179,0.376253,28.854635,28.478382,184.185221,495.882156,311.696935,0,9.57275,9.57275,,,,0,0.004422,0.004422,344.572294,13.530541,-331.041753,0.0515,16.214546,16.163046,43.986351,8.793627,-35.192724,4.738416,15.64284,10.904424,0.916451,1.981006,1.064555,4.772761,11.003328,6.230567,1.554864,3.25471,1.699846,91.724406,13.798187,-77.926219,49.328459,41.232022,-8.096437,0.05702,1.813196,1.756176,40.992891,3.844524,-37.148367,2.97212,11.461393,8.489273,3448.04831,336.64208,-3111.40623,1.468128,0.660496,-0.807632,99.266938,41.571693,-57.695245,149.270607,2.879548,-146.391059,0.452688,0.071727,-0.380961,0.126267,4.512893,4.386626,0.068681,87.245199,87.176518,1653.139235,115.6233,-1537.515935,578.433972,16.920426,-561.513546,0,0.273769,0.273769,0.031587,0.756064,0.724477,0.032314,0.345805,0.313491,14.562928,5.991964,-8.570964,34.251969,13.677427,-20.574542,0.007837,0.140531,0.132694,0.634353,1.54144,0.907087,0.022815,3.452936,3.430121,4.890994,26.710258,21.819264,0.072865,0.371534,0.298669,0.991226,2.833023,1.841797,3.073772,6.73329,3.659518,27.639649,51.722525,24.082876,0.450865,0.505807,0.054942,0.255785,0.005232,-0.250553,5.186374,16.14049,10.954116,18.289154,2.853283,-15.435871,0.303488,9.497989,9.194501,22.378547,6.216244,-16.162303,0,0,0,0.0485,0.00013,-0.04837,0.075666,0.182801,0.107135,0.0026,3.50968,3.50708,801.726425,480.822249,-320.904176,4.583007,10.649168,6.066161,25.966666,4.129697,-21.836969,6.730359,5.212744,-1.517615,13.092013,0.835866,-12.256147,18.602648,3.965938,-14.63671,2.622945,3.253571,0.630626,30.913011,0.490489,-30.422522,0,0,0,,,
2008-06-01,24144.6,5238.2,-18906.4,33387.516572,24834.106038,-8553.410534,186963,115784,-71179,12464.812999,0,-12464.812999,15119.004398,8513.6,-6605.404398,28957,24220,-4737,8665.820882,10644.954944,1979.134062,15704.466816,12523.70136,-3180.765456,50465.202649,37124.622455,-13340.580194,40868.575366,29849.171623,-11019.403743,12347.658399,2325.388413,-10022.269986,54784.06383,27290.818656,-27493.245174,190117.055018,116787.381437,-73329.673581,69291.971012,32655.975086,-36635.995926,1703.05627,2209.218091,506.161821,1438.617965,2297.338422,858.720456999998,9413.70979499999,1462.766716,-7950.94307899999,0.129998,3.176454,3.046456,31285.340255,23741.365339,-7543.974916,0.432813,0.178819,-0.253994,19179.862394,13383.257116,-5796.605278,269.71643,478.8666,209.15017,15.735982,29.493106,13.757124,212.844275,212.171241,-0.673034000000001,376.637974,469.857345,93.219371,146.600733,115.972623,-30.62811,355.476957,448.765944,93.2889869999999,29.495011,449.749553,420.254542,19.229975,106.737406,87.507431,52.824331,295.575181,242.75085,0,49.465389,49.465389,91.57585,227.825175,136.249325,0.09018,36.542538,36.452358,0.435629,59.950474,59.514845,41.80068,68.900721,27.100041,341.779901,483.584338,141.804437,0.171352,5.680093,5.508741,0.628516,16.579481,15.950965,3.994988,10.527526,6.532538,0.372069,15.129032,14.756963,0.002911,0.588952,0.586041,0.461072,5.653406,5.192334,1.407717,11.686084,10.278367,0.087013,4.545888,4.458875,1.013427,5.531678,4.518251,4.687658,32.494301,27.806643,803.932076,160.487729,-643.444347,47.250318,136.036961,88.786643,,,,,,,305.370163,32.605482,-272.764681,0.132144,45.72019,45.588046,0.014678,46.930545,46.915867,1096.126334,906.653291,-189.473043,5821.023781,1168.243439,-4652.780342,13.870655,20.024548,6.153893,9.747923,32.329511,22.581588,0.096084,1.571656,1.475572,843.365155,314.828073,-528.537082,548.379597,626.524689,78.1450919999999,24.181913,37.345364,13.163451,521.071157,1337.340538,816.269381,3154.455281,2800.22382,-354.231460999999,4.558825,160.804811,156.245986,16.847319,104.375649,87.52833,526.155327,949.605815,423.450488,0.817455,0.175174,-0.642281,29.455639,36.966222,7.510583,1124.868022,452.175195,-672.692827,0,0.03099,0.03099,868.548424,325.628381,-542.920043,638.019617,423.118427,-214.90119,2.186439,0.356916,-1.829523,531.454856,238.946022,-292.508834,5271.514487,5101.275384,-170.239103000001,2383.755696,761.199552,-1622.556144,2361.73045,3296.850171,935.119721,1667.044093,2788.585081,1121.540988,38.146194,65.3955,27.249306,0.128738,0.885575,0.756837,2.697224,4.693715,1.996491,3964.018966,2410.938969,-1553.079997,8959.089951,4959.96169,-3999.128261,681.435141,208.716934,-472.718207,,,,208.749041,129.165938,-79.5831029999999,93.088098,53.81215,-39.275948,282.457676,128.836296,-153.62138,22.583218,1.454372,-21.128846,1517.524142,1580.097689,62.573547,65.433203,18.034661,-47.398542,22.624189,29.691366,7.06717699999999,79.771239,64.612661,-15.158578,262.915805,436.188223,173.272418,,,,3471.209037,746.256049,-2724.952988,75.220239,8.958934,-66.261305,255.261721,159.250151,-96.01157,2.323588,11.480912,9.157324,725.072421,18.990992,-706.081429,5.792279,57.012486,51.220207,106.379498,100.250281,-6.12921700000001,0.15974,1.362755,1.203015,0.787893,3.972162,3.184269,0.017421,1.126209,1.108788,19.912984,5.035812,-14.877172,0.411477,7.269829,6.858352,1144.56844,1053.761477,-90.806963,173.569271,227.102822,53.5335510000001,1.196178,461.435153,460.238975,22.03803,9.678238,-12.359792,0.056407,0.671394,0.614987,0,0.234139,0.234139,3178.138559,1623.056501,-1555.082058,,,,18.997271,49.653566,30.656295,39.356248,22.504645,-16.851603,2.243832,6.179587,3.935755,0.945763,5.14554,4.199777,,,,,,,,,,0.023459,1.913933,1.890474,1.21,2.943078,1.733078,76.916579,192.547435,115.630856,93.831793,81.184181,-12.647612,21.874772,42.094272,20.2195,346.463562,1395.948569,1049.485007,1.106156,14.672247,13.566091,5.132481,70.039987,64.907506,6.504173,203.321253,196.81708,2058.028969,223.792073,-1834.236896,6.645842,6.214647,-0.431195000000002,469.1,431.6,-37.5,0.171498,0.007046,-0.164452,0.347079,0,-0.347079,87.593734,75.834835,-11.758899,535.02292,220.893818,-314.129102,,,,4588.662877,900.642076,-3688.020801,54.688107,119.753308,65.065201,96.725568,1174.777852,1078.052284,0.523827,24.276486,23.752659,277.93754,88.198828,-189.738712,31.429373,55.946453,24.51708,11.537117,29.490834,17.953717,1877.384616,1828.305714,-49.078902,296.494504,165.092524,-131.40198,7.983545,1.745697,-6.237848,303.044725,39.610859,-263.433866,158.940464,17.644108,-141.296356,0,0.460416,0.460416,2053.375313,721.274331,-1332.100982,1112.894156,245.355133,-867.539023,7.820506,2.865643,-4.954863,193.368464,11.669778,-181.698686,2616.596907,1256.597517,-1359.99939,1208.109616,2596.087693,1387.978077,1213.453438,487.036006,-726.417432,0,1.84593,1.84593,5.703358,4.615096,-1.088262,708.376991,676.179849,-32.1971420000001,84.069296,19.845279,-64.224017,0.120834,0.196597,0.075763,0.009708,1.562836,1.553128,27930.640534,6188.166337,-21742.474197,4.374568,3.871036,-0.503532,0,16.570957,16.570957,3960.821727,3387.387486,-573.434240999998,512.631942,2301.321221,1788.689279,2984.257597,2360.158544,-624.099053,12144.282136,5752.432922,-6391.849214,1139.869626,2047.744838,907.875212,0,0.207563,0.207563,0.08554,0.011675,-0.073865,0.002578,0.151904,0.149326,0,0.869132,0.869132,4.764461,4.29232,-0.472140999999999,270.486201,208.953548,-61.532653,0.219189,0.204705,-0.014484,0.247288,3.823786,3.576498,0.003365,0.032015,0.02865,0.539929,1.023651,0.483722,0.090112,0.177899,0.087787,0.044768,0.354819,0.310051,0.013916,0,-0.013916,0.090338,0.20184,0.111502,0.000002,0.07213,0.072128,4.010281,7.813201,3.80292,0,0.127453,0.127453,2.277486,10.962205,8.684719,1.029621,1.970229,0.940608000000001,0.182802,2.456668,2.273866,1.115,0.709916,-0.405084,0.014653,0.760918,0.746265,13.026481,3.971102,-9.055379,0.492015,1.463966,0.971951,69.532556,150.248834,80.716278,2149.570227,83.380142,-2066.190085,39.260493,52.614561,13.354068,117.797925,13.88312,-103.914805,170.351228,531.03829,360.687062,0,1.497305,1.497305,,,,0,0.01651,0.01651,342.886187,10.886617,-331.99957,0,2.558755,2.558755,217.26772,11.76935,-205.49837,1.064558,12.149125,11.084567,0.286551,2.499901,2.21335,7.657908,9.800654,2.142746,3.55785,5.192792,1.634942,30.357608,16.50987,-13.847738,10.500253,61.103237,50.602984,0.0021,3.1606,3.1585,0.085227,5.15165,5.066423,0.063205,9.529262,9.466057,3962.079899,376.695381,-3585.384518,0.371661,0.602837,0.231176,255.139876,9.756349,-245.383527,362.989939,4.501494,-358.488445,0.066572,0.315497,0.248925,0.072313,1.950584,1.878271,0.005238,73.025316,73.020078,2310.19942,117.449319,-2192.750101,639.923868,8.924414,-630.999454,0.007363,0.277466,0.270103,0.000292,0.170999,0.170707,0.004443,0.265052,0.260609,11.287536,11.94045,0.652914000000001,29.071029,9.339893,-19.731136,0.07555,0.111941,0.036391,0.207814,0.527154,0.31934,0.033146,3.360501,3.327355,2.175978,13.872919,11.696941,0.015869,0.092129,0.07626,0.861668,7.271314,6.409646,1.052228,5.417183,4.364955,31.453441,30.731246,-0.722195000000017,0.451433,0.259775,-0.191658,0.015455,0.01392,-0.001535,6.877667,9.997466,3.119799,15.414834,3.869421,-11.545413,2.635983,17.500146,14.864163,27.943554,5.821694,-22.12186,0,0,0,0.002319,0.059299,0.05698,0.053096,0.388007,0.334911,0,0.109489,0.109489,1036.224326,555.21792,-481.006406,5.366481,11.455492,6.089011,24.421444,3.339157,-21.082287,5.005801,7.61917,2.613369,9.698968,1.363198,-8.33577,2.231441,5.351599,3.120158,1.772163,4.561757,2.789594,37.144347,0.068039,-37.076308,0,7.828805,7.828805,,,
2008-07-01,29249,5260.6,-23988.4,34822.822053,23664.177423,-11158.64463,194334,118309,-76025,12394.890359,0,-12394.890359,14767.865336,7707.5,-7060.365336,30366,22927,-7439,9821.107223,9887.051264,65.9440409999988,17081.580607,12461.867682,-4619.712925,51446.433883,36126.163839,-15320.270044,42165.003695,29129.914661,-13035.089034,12546.610474,2661.568976,-9885.041498,59583.312212,26518.747076,-33064.565136,202614.391879,114522.29323,-88092.0986489998,78035.76404,31783.020668,-46252.743372,1891.423758,2427.86049,536.436732000001,1338.185315,2358.789119,1020.603804,9879.046867,1745.971133,-8133.075734,0.456095,0.941609,0.485514,32208.397116,22325.368719,-9883.02839700001,0.35777,0.026676,-0.331094,19238.036767,13800.79512,-5437.241647,374.09573,439.914366,65.818636,31.141088,39.194524,8.053436,239.863219,245.535643,5.67242399999998,378.250166,473.39049,95.140324,161.992577,97.686727,-64.30585,358.270467,526.181622,167.911155,31.125748,419.220019,388.094271,3.785402,52.62567,48.840268,24.888134,219.623269,194.735135,0.020648,72.490095,72.469447,50.08841,260.893768,210.805358,0.036881,33.918986,33.882105,1.266276,70.501152,69.234876,50.358071,85.122152,34.764081,378.951599,645.151642,266.200043,0.088874,6.262281,6.173407,0.671261,21.202708,20.531447,4.416241,8.943629,4.527388,0.326766,17.205712,16.878946,0.018627,1.060364,1.041737,0.170138,10.341189,10.171051,1.465459,11.243599,9.77814,0.036465,4.686174,4.649709,0.38647,6.158189,5.771719,4.034444,47.968047,43.933603,824.435338,165.95797,-658.477368,39.846148,211.536475,171.690327,,,,,,,317.626154,31.316313,-286.309841,1.214258,37.904203,36.689945,0.161658,36.228062,36.066404,1334.052819,1058.196817,-275.856002,6438.783124,1093.802886,-5344.980238,9.663455,19.834687,10.171232,9.218971,37.13297,27.913999,0.007168,2.263885,2.256717,1111.152181,294.102091,-817.05009,658.842755,584.521956,-74.3207989999999,19.780212,35.313412,15.5332,795.848092,1221.335981,425.487889,3021.850491,2937.519572,-84.3309189999995,3.753601,171.635393,167.881792,15.919472,68.280999,52.361527,383.258534,638.350818,255.092284,0.417015,0.111175,-0.30584,17.051364,41.253139,24.201775,1001.956021,402.693047,-599.262974,0,0.080242,0.080242,592.351455,248.028681,-344.322774,548.162407,353.907089,-194.255318,1.583411,0.504034,-1.079377,784.787444,206.697182,-578.090262,5650.131643,4803.262387,-846.869256,2649.09606,571.533406,-2077.562654,1987.826935,3602.571979,1614.745044,1806.240222,2628.468322,822.2281,50.248501,228.684962,178.436461,0.063035,1.874872,1.811837,2.821235,1.769308,-1.051927,4051.086813,2359.290873,-1691.79594,9229.935597,4747.065961,-4482.869636,767.214799,186.743438,-580.471361,,,,242.69304,102.166974,-140.526066,145.436754,26.485378,-118.951376,280.330804,119.419825,-160.910979,24.180072,1.218668,-22.961404,1678.767064,2216.514069,537.747005,10.747244,21.973524,11.22628,10.728275,33.004244,22.275969,36.344127,79.626148,43.282021,240.5384,279.253888,38.715488,,,,3156.483964,814.877008,-2341.606956,164.964112,9.163604,-155.800508,312.636891,153.334654,-159.302237,4.372279,12.622046,8.249767,687.654474,14.996959,-672.657515,18.100973,67.361514,49.260541,211.145377,59.480189,-151.665188,0.122905,1.738827,1.615922,1.350573,6.63706,5.286487,0,0.156391,0.156391,34.816775,6.107653,-28.709122,50.551048,18.41667,-32.134378,1070.299999,1152.069605,81.7696060000001,249.800873,218.623141,-31.177732,0.062741,545.902854,545.840113,21.662604,12.505977,-9.156627,0.026835,0.344688,0.317853,0,0.106497,0.106497,3734.818713,1277.198202,-2457.620511,,,,24.343049,36.006651,11.663602,44.90591,25.03722,-19.86869,1.613889,2.113745,0.499855999999999,8.710139,4.084534,-4.625605,,,,,,,,,,0.039514,3.67352,3.634006,1.045659,3.49281,2.447151,78.315582,110.584752,32.26917,103.536558,69.805252,-33.731306,24.778349,33.43705,8.658701,340.524544,1170.103909,829.579365,1.198379,12.067597,10.869218,53.631254,22.90414,-30.727114,8.556482,87.816603,79.260121,2858.480309,238.66003,-2619.820279,6.377729,35.130327,28.752598,543.6,428.4,-115.2,0.105147,0,-0.105147,0.063546,0.022664,-0.040882,101.235232,64.68199,-36.553242,622.938086,251.818704,-371.119382,,,,7313.64544,874.013866,-6439.631574,42.607857,138.353169,95.745312,202.2543,1109.320604,907.066304,0.366303,41.579133,41.21283,172.020461,93.648134,-78.372327,49.975911,48.504094,-1.47181700000001,13.701526,21.495243,7.79371700000001,2066.084866,1823.715154,-242.369712000001,305.165768,235.074653,-70.091115,6.166505,1.759672,-4.406833,343.449764,35.238231,-308.211533,179.243503,14.661582,-164.581921,0,1.195741,1.195741,1968.177719,866.639768,-1101.537951,1126.234466,202.583531,-923.650935,4.457483,0.982868,-3.474615,225.885178,10.888182,-214.996996,2841.416585,1226.154583,-1615.262002,1394.374095,2321.716995,927.3429,1451.44666,500.895472,-950.551188,0,0.453497,0.453497,6.611033,14.583353,7.97232,766.040815,719.033547,-47.007268,100.80837,17.94234,-82.86603,0.048149,1.256699,1.20855,0,1.067291,1.067291,31247.270669,6234.635702,-25012.634967,4.64471,3.445928,-1.198782,0,7.079502,7.079502,4499.984416,3197.30178,-1302.682636,663.513916,1757.44483,1093.930914,3263.234796,2610.587659,-652.647137,12028.965215,5600.92979,-6428.035425,1024.01424,2092.89169,1068.87745,0,0.019092,0.019092,0.043866,0.000608,-0.043258,0.04236,0.3079,0.26554,0,1.247575,1.247575,7.502459,5.753159,-1.7493,288.128943,218.876176,-69.252767,0.064502,0.439666,0.375164,0.139213,3.947493,3.80828,0.003554,0.001685,-0.001869,0.469247,0.839451,0.370204,0.062204,0.429045,0.366841,0.061718,0.270869,0.209151,0.00711,0,-0.00711,0.046427,4.070681,4.024254,0,0.070512,0.070512,1.230681,4.835501,3.60482,0,0.014521,0.014521,3.38728,10.401906,7.014626,0.882945,2.623199,1.740254,0.294618,2.868625,2.574007,0.00999,1.263515,1.253525,0.574216,2.320151,1.745935,10.886234,4.494096,-6.392138,0.340618,2.009231,1.668613,66.505898,89.829031,23.323133,1781.38768,63.644781,-1717.742899,88.688218,54.523602,-34.164616,0.000058,1.673064,1.673006,186.929643,642.242707,455.313064,0.017574,1.270574,1.253,,,,0,0.019912,0.019912,417.890934,12.611794,-405.27914,0.035449,3.550386,3.514937,114.34083,11.182127,-103.158703,0.782105,20.560617,19.778512,0.316906,9.331109,9.014203,8.911899,11.778804,2.866905,2.125859,4.239298,2.113439,156.072445,63.574322,-92.4981229999999,9.381134,52.775711,43.394577,0.217573,2.153826,1.936253,0.623038,3.76613,3.143092,0.061697,8.065428,8.003731,3936.690714,459.078008,-3477.612706,1.101862,4.406298,3.304436,216.51694,11.600021,-204.916919,436.173367,3.022114,-433.151253,0.021516,0.283104,0.261588,0.030822,0.960812,0.92999,0.037908,29.732478,29.69457,2939.554473,138.448227,-2801.106246,340.681676,9.615461,-331.066215,0,0.010295,0.010295,0.019796,1.074778,1.054982,0,0.564992,0.564992,13.254276,17.350365,4.096089,111.756904,6.106335,-105.650569,0.152086,0.008926,-0.14316,0.591695,0.553885,-0.0378099999999999,0.020712,0.860907,0.840195,3.33453,18.796546,15.462016,0,0.036811,0.036811,0.599512,16.311237,15.711725,1.821165,8.110346,6.289181,25.410515,23.698635,-1.71188,0.61904,0.622639,0.00359900000000002,0.0118,0.00032,-0.01148,4.825369,8.793134,3.967765,14.176046,13.534479,-0.641566999999998,1.693536,68.662202,66.968666,28.869872,3.303597,-25.566275,0,0.114919,0.114919,0.106454,0.003886,-0.102568,0.287039,1.712156,1.425117,0.029925,0.020953,-0.008972,971.327418,600.431891,-370.895527,20.124437,70.93295,50.808513,26.908104,7.381793,-19.526311,9.003841,8.338457,-0.665383999999998,11.361976,1.113388,-10.248588,2.025089,13.55005,11.524961,2.810422,2.319891,-0.490530999999999,30.568995,0.020551,-30.548444,0,0,0,,,
2008-08-01,26230.5,6563.5,-19667,29706.63838,23597.592304,-6109.046076,186261,116219,-70042,12554.570465,0,-12554.570465,15632.750617,7788.5,-7844.250617,28114,24077,-4037,8854.459855,9524.213695,669.753839999999,15788.340276,14114.54721,-1673.793066,49517.234473,35825.257775,-13691.976698,36420.40834,28133.553528,-8286.85481200001,11706.143647,3104.715107,-8601.42854,58132.279133,26491.43238,-31640.846753,189874.897507,116417.771256,-73457.126251,75146.026009,32945.757901,-42200.268108,1626.501324,2353.536201,727.034877,1296.254788,2283.431931,987.177143,8788.231617,2118.768228,-6669.463389,0.376189,0.543271,0.167082,29994.422529,22075.576014,-7918.846515,0.113785,0.060418,-0.053367,19522.811944,13749.681761,-5773.130183,280.344142,385.731657,105.387515,18.642883,29.21734,10.574457,184.08657,231.288018,47.201448,345.780575,457.762894,111.982319,159.121963,90.614697,-68.507266,331.661318,521.733245,190.071927,23.600292,572.80644,549.206148,0.80398,58.691807,57.887827,49.94286,212.648528,162.705668,0.009,50.865142,50.856142,64.678123,236.063994,171.385871,0.763773,36.754894,35.991121,0.824737,68.404904,67.580167,36.567185,93.584181,57.016996,325.506756,666.40569,340.898934,0.351189,5.276803,4.925614,0.453639,44.441367,43.987728,3.757059,8.553543,4.796484,0.396684,13.392321,12.995637,0.013398,0.546018,0.53262,0.118709,9.242184,9.123475,9.737659,17.096815,7.359156,0.218214,11.913035,11.694821,1.082118,4.682645,3.600527,2.769371,39.11179,36.342419,823.161049,299.33443,-523.826619,22.907264,468.275829,445.368565,,,,,,,396.407501,98.473412,-297.934089,0.567597,17.554949,16.987352,2.579845,35.871846,33.292001,1421.397362,1187.043791,-234.353571,5810.081373,1201.956201,-4608.125172,10.410155,27.639566,17.229411,9.578967,38.953856,29.374889,0,1.04216,1.04216,1070.301747,347.762453,-722.539294,423.498777,763.04454,339.545763,73.215098,41.322699,-31.892399,763.466287,1039.099625,275.633338,2564.569333,3718.057687,1153.488354,6.437717,165.565693,159.127976,16.580681,77.076817,60.496136,531.943911,719.575486,187.631575,0.003415,0.066218,0.062803,11.754826,43.111276,31.35645,871.423497,489.746917,-381.67658,0.013676,0.202891,0.189215,716.510044,272.822861,-443.687183,427.370843,351.376177,-75.994666,0.750985,0.314602,-0.436383,608.104056,226.165825,-381.938231,5016.706287,4447.461214,-569.245073,2370.545752,529.47075,-1841.075002,1727.699687,3708.336845,1980.637158,1056.122627,2532.980974,1476.858347,46.458452,82.805376,36.346924,0.042674,1.535119,1.492445,1.386384,13.287381,11.900997,3508.400915,2511.164825,-997.236090000001,7968.901311,4676.918798,-3291.982513,530.224332,209.912777,-320.311555,,,,223.364784,116.746291,-106.618493,111.186064,22.355767,-88.830297,194.352749,138.621403,-55.7313460000001,17.518436,1.627294,-15.891142,1485.995731,1370.076595,-115.919136,81.258242,18.593005,-62.665237,9.508677,38.024034,28.515357,67.864568,87.365735,19.501167,217.292205,460.59924,243.307035,,,,2764.049099,976.3067,-1787.742399,110.151311,11.009065,-99.142246,319.135684,202.152562,-116.983122,4.8419,20.871573,16.029673,786.575568,18.733268,-767.8423,4.275516,52.17917,47.903654,62.667016,45.008319,-17.658697,0.210493,1.781361,1.570868,1.150234,7.138189,5.987955,0.313266,4.178636,3.86537,17.344398,10.718176,-6.626222,0.600402,8.111044,7.510642,995.991377,1036.359844,40.3684669999999,212.041789,186.257993,-25.783796,0.002459,281.791932,281.789473,22.449078,15.160513,-7.288565,0.018174,0.252372,0.234198,0.010833,1.954292,1.943459,3188.993837,1293.849182,-1895.144655,,,,16.910819,46.041816,29.130997,36.264782,33.557227,-2.70755499999999,1.784608,2.238712,0.454104,15.660503,2.130734,-13.529769,,,,,,,,,,0.051075,13.599013,13.547938,1.032298,4.004858,2.97256,57.324226,227.601878,170.277652,88.056197,105.822118,17.765921,67.661472,35.772743,-31.888729,366.503082,1103.870139,737.367057,1.070574,14.564853,13.494279,51.384776,44.33893,-7.045846,6.993577,228.941844,221.948267,2639.075904,233.685754,-2405.39015,5.443104,137.616276,132.173172,454.7,444.5,-10.2,0.20667,0.015076,-0.191594,0.222762,0.032744,-0.190018,116.138543,78.924516,-37.214027,733.386395,201.046842,-532.339553,,,,5873.783669,1007.89057,-4865.893099,8.754739,312.877321,304.122582,84.491822,1559.091366,1474.599544,0.330102,41.778464,41.448362,168.338202,112.93773,-55.4004720000001,58.551947,50.170513,-8.38143399999998,2.140994,35.782898,33.641904,2222.55132,1863.886642,-358.664678,351.456579,117.753078,-233.703501,6.464027,2.356255,-4.107772,349.871287,39.742028,-310.129259,166.102735,38.102328,-128.000407,0,0.968881,0.968881,2044.672825,837.859098,-1206.813727,1238.752689,216.32455,-1022.428139,3.925883,1.201513,-2.72437,225.760473,10.68764,-215.072833,2622.968471,1270.683235,-1352.285236,1202.925638,2444.293944,1241.368306,1563.570628,589.531937,-974.038691,0,0.488893,0.488893,5.99945,10.679813,4.680363,773.378273,723.291399,-50.0868740000002,78.992732,17.904605,-61.088127,0.044836,0.053983,0.009147,0.212229,1.630931,1.418702,31823.697889,6201.296378,-25622.401511,5.609431,5.015594,-0.593837,0,10.735725,10.735725,3859.008934,3092.771314,-766.23762,526.688418,1759.692898,1233.00448,3265.836865,2227.455539,-1038.381326,11136.852604,5908.024927,-5228.827677,968.832313,1942.831171,973.998858,0,0.031504,0.031504,0.058234,0.208693,0.150459,0.029589,0.594378,0.564789,0,0.09047,0.09047,7.595213,4.718656,-2.876557,295.931705,298.256564,2.32485899999995,0.008416,0.244075,0.235659,0.462662,3.055117,2.592455,0.003075,0.027852,0.024777,0.274686,0.55426,0.279574,0.156105,0.316824,0.160719,0.058052,0.275134,0.217082,0,0,0,0.082654,2.20431,2.121656,0,0.108587,0.108587,2.581628,8.079077,5.497449,0,0.000566,0.000566,2.467261,9.371469,6.904208,4.669196,1.747197,-2.921999,0.593588,3.132791,2.539203,0.007474,1.490716,1.483242,0.012046,1.730574,1.718528,12.110917,3.602777,-8.50814,0.319974,0.792403,0.472429,104.30905,147.534194,43.225144,2027.919846,81.074336,-1946.84551,30.39223,34.051159,3.65892899999999,2.394974,1.128612,-1.266362,258.239524,661.023737,402.784213,0.41514,26.818755,26.403615,,,,0,0.000326,0.000326,374.709092,14.034227,-360.674865,0.00048,15.194172,15.193692,50.691878,10.596819,-40.095059,0.289043,6.444416,6.155373,0.254278,1.978914,1.724636,7.346126,8.082646,0.736519999999999,1.523152,13.22128,11.698128,43.300572,16.937538,-26.363034,36.330874,39.715499,3.384625,0.041688,1.612064,1.570376,0.082116,2.608294,2.526178,0.04646,9.451319,9.404859,3982.941477,482.753826,-3500.187651,0.269052,3.295745,3.026693,267.860016,56.803504,-211.056512,306.862709,8.592315,-298.270394,0.020522,0.030924,0.010402,0.012155,6.109081,6.096926,11.599974,118.019778,106.419804,1934.790352,347.505951,-1587.284401,392.906752,15.048823,-377.857929,0,0.022883,0.022883,0.007522,0.232438,0.224916,0.002356,0.157096,0.15474,14.508297,15.264905,0.756608,9.1127,9.676946,0.564245999999999,0.009671,0.106222,0.096551,0.255749,1.764422,1.508673,0.027299,21.751112,21.723813,3.112454,28.10482,24.992366,0,5.740991,5.740991,0.018922,15.087219,15.068297,1.277196,10.556588,9.279392,30.636358,83.271931,52.635573,0.352572,11.766587,11.414015,1.018319,0.023442,-0.994877,3.3181,15.456638,12.138538,15.315402,3.249139,-12.066263,2.184313,9.725991,7.541678,31.787988,4.169409,-27.618579,0,0.045877,0.045877,0.092763,0.010819,-0.081944,0.009253,1.527579,1.518326,0,0.000318,0.000318,1045.739356,588.298077,-457.441279,110.395485,58.419557,-51.975928,25.099756,9.230106,-15.86965,1.885378,9.027961,7.142583,15.523352,1.228655,-14.294697,8.340845,18.25574,9.914895,3.809102,7.391312,3.58221,35.928454,0.113684,-35.81477,0,9.904115,9.904115,,,
2008-09-01,18786.5,5734.8,-13051.7,29150.301144,20826.331707,-8323.969437,175833,107172,-68661,11587.882509,0,-11587.882509,14939.682098,7636.8,-7302.882098,29354,21904,-7450,9231.783747,9113.941536,-117.842211000001,14319.670206,11377.765174,-2941.905032,47579.771786,35083.480596,-12496.29119,35121.245039,25372.624601,-9748.62043800002,8323.463931,2121.905103,-6201.558828,59329.570602,24203.727462,-35125.84314,180188.984956,106071.949176,-74117.0357799999,73530.316124,29940.831618,-43589.484506,1654.156803,2065.320858,411.164055,1313.2522,2097.822291,784.570091,6073.224632,1413.005375,-4660.219257,1.265308,20.032981,18.767673,29653.569657,22294.244478,-7359.32517900001,0.000362,0.023958,0.023596,17926.202129,12789.236118,-5136.966011,280.216287,416.554206,136.337919,16.375228,32.110648,15.73542,200.3455,187.049093,-13.296407,359.106618,385.494555,26.3879369999999,160.251615,79.333282,-80.918333,332.538974,528.720452,196.181478,25.580232,358.133481,332.553249,50.591512,59.2053,8.613788,69.886552,218.157391,148.270839,0,57.872644,57.872644,73.754661,211.172051,137.41739,0.289414,36.525336,36.235922,0.747183,59.790647,59.043464,46.343611,120.803771,74.46016,321.697809,468.16927,146.471461,0.695572,5.657016,4.961444,0.590529,12.80348,12.212951,3.982211,9.163595,5.181384,0.444562,18.39178,17.947218,0.005077,1.339479,1.334402,0.108481,9.150949,9.042468,2.117175,16.668362,14.551187,0.03904,5.763053,5.724013,0.433465,6.239445,5.80598,2.151496,41.962276,39.81078,899.036191,194.947213,-704.088978,13.470161,203.906729,190.436568,,,,,,,332.111592,34.933297,-297.178295,0.045065,49.565744,49.520679,0.218337,17.731476,17.513139,1074.675774,932.783691,-141.892083,4532.007417,1095.709682,-3436.297735,12.156613,23.362118,11.205505,19.420354,23.010708,3.590354,0.002448,1.267121,1.264673,859.132171,294.299326,-564.832845,524.249124,508.453117,-15.796007,60.391235,26.352287,-34.038948,604.972151,806.904106,201.931955,2850.521911,2921.433723,70.9118119999994,10.125841,148.5812,138.455359,21.866164,70.111953,48.245789,556.557697,678.109984,121.552287,0.417156,0.070137,-0.347019,46.201149,26.680869,-19.52028,1113.097485,426.401305,-686.69618,0,1.029268,1.029268,525.038255,256.982421,-268.055834,655.613514,371.767951,-283.845563,2.242536,0.349453,-1.893083,709.408791,212.234668,-497.174123,4696.798704,3887.445432,-809.353272000001,2610.623458,608.626876,-2001.996582,1782.583396,2837.337061,1054.753665,1386.101196,2221.377392,835.276196,62.721026,73.122677,10.401651,0.061016,1.615461,1.554445,1.725676,0.41388,-1.311796,3623.126664,2227.020121,-1396.106543,7131.869403,4280.976374,-2850.893029,495.829273,249.663726,-246.165547,,,,228.111333,117.611877,-110.499456,108.25235,26.758944,-81.493406,232.329661,116.190206,-116.139455,20.606671,2.55846,-18.048211,1569.676725,2053.002413,483.325688,11.929046,18.584066,6.65502000000001,42.606123,36.149276,-6.456847,30.334871,78.260734,47.925863,247.21233,250.717752,3.50542199999992,,,,2516.231022,851.377875,-1664.853147,198.449512,9.186423,-189.263089,207.04555,211.791617,4.74606700000001,5.368997,13.799013,8.430016,118.938719,17.190193,-101.748526,8.052161,32.25822,24.206059,173.485641,57.23532,-116.250321,0.074911,7.237346,7.162435,1.330239,9.819255,8.489016,0.000993,1.44886,1.447867,16.245955,3.181966,-13.063989,50.424147,16.729448,-33.694699,959.286539,1021.113618,61.8270790000001,166.424841,225.644047,59.219206,0.019434,123.44172,123.422286,31.34111,9.13457,-22.20654,0.273871,0.596742,0.322871,0.000592,1.891892,1.8913,2526.971483,1158.309892,-1368.661591,,,,27.452011,44.405748,16.953737,44.352187,22.398278,-21.953909,3.731105,2.990915,-0.740189999999999,1.042727,4.317096,3.274369,,,,,,,,,,0.022288,4.309753,4.287465,0.572867,2.07049,1.497623,110.580525,141.936327,31.355802,119.681267,77.987852,-41.693415,22.077944,111.574505,89.496561,471.11625,764.343572,293.227322,1.036624,17.98618,16.949556,70.951742,30.733554,-40.218188,6.318301,105.230966,98.912665,1529.530542,139.671687,-1389.858855,7.695435,139.334215,131.63878,493.3,424.6,-68.7,0.118898,0.00397,-0.114928,0.058596,0,-0.058596,103.562687,88.363402,-15.199285,446.232962,274.801926,-171.431036,,,,4224.476299,1303.818359,-2920.65794,86.499041,195.938705,109.439664,83.73947,1068.723316,984.983846,0.683727,33.436292,32.752565,12.254017,70.221005,57.966988,40.080919,57.099904,17.018985,2.483576,35.848542,33.364966,2393.622988,2030.921128,-362.70186,295.902157,123.737145,-172.165012,7.558934,3.059125,-4.499809,367.11311,52.185492,-314.927618,168.340708,17.040249,-151.300459,0,0.405023,0.405023,2267.82304,860.214697,-1407.608343,1238.896027,200.070863,-1038.825164,3.417523,1.310545,-2.106978,230.13039,10.432416,-219.697974,2513.621067,1029.964125,-1483.656942,1317.81745,2247.307207,929.489757,1387.257821,587.887574,-799.370247,0,0.385502,0.385502,4.207253,5.947405,1.740152,754.256485,715.060353,-39.196132,72.457252,18.824928,-53.632324,0.000442,0.066773,0.066331,0.009359,1.295584,1.286225,33078.730631,5257.646643,-27821.083988,3.965351,6.147865,2.182514,0,0,0,4130.668612,2931.699701,-1198.968911,636.637159,2178.273122,1541.635963,3146.660526,1756.661506,-1389.99902,11008.039313,5434.352187,-5573.687126,1068.437997,1835.61703,767.179033,0,0.360587,0.360587,0.094573,0.011812,-0.082761,0.911275,11.094669,10.183394,0,0.623133,0.623133,6.937026,6.106578,-0.830448000000001,203.84201,198.379103,-5.462907,0.010087,0.265683,0.255596,0.397959,6.519598,6.121639,0.002152,0.005026,0.002874,0.526207,1.418482,0.892275,0.129354,0.186103,0.056749,0.071624,0.267318,0.195694,0,0,0,0.108324,0.037857,-0.070467,0.000054,0.139707,0.139653,1.801267,7.199222,5.397955,0.012054,0.055,0.042946,7.572119,11.574655,4.002536,5.095302,2.15453,-2.940772,0.197178,3.616137,3.418959,0,1.293023,1.293023,0,0.538501,0.538501,16.795575,9.978593,-6.816982,0.317819,1.149647,0.831828,76.678403,82.176143,5.49774000000002,1722.932229,110.23348,-1612.698749,50.87448,33.895245,-16.979235,14.14758,8.057124,-6.090456,222.224472,436.640862,214.41639,0.373028,2.841026,2.467998,,,,0,0,0,283.401277,19.210761,-264.190516,0.274278,6.651751,6.377473,7.695216,7.222801,-0.472415000000002,0.595622,9.742733,9.147111,0.377694,1.507971,1.130277,8.210723,7.063397,-1.147326,2.051381,5.30302,3.251639,89.707261,12.925324,-76.781937,7.173363,39.11807,31.944707,0.007714,3.088372,3.080658,0.167842,1.783231,1.615389,0.260317,7.199511,6.939194,2514.614592,311.03044,-2203.584152,1.670929,2.966683,1.295754,339.612783,13.414936,-326.197847,272.955957,2.390633,-270.565324,0.808396,0.442759,-0.365637,0.019992,1.571201,1.551209,19.07686,31.897346,12.820486,1217.016285,169.283723,-1047.732562,220.572159,15.304981,-205.267178,0,0.180732,0.180732,0.027095,2.570667,2.543572,0.006073,0.051507,0.045434,13.910298,14.645343,0.735044999999996,4.075455,10.869791,6.794336,0.003343,0.108827,0.105484,1.501891,3.843113,2.341222,0.001678,0.149749,0.148071,2.88295,24.752871,21.869921,0.005294,0.310362,0.305068,0.119569,34.021741,33.902172,1.474593,5.223233,3.74864,33.361349,29.041947,-4.319402,0.478541,1.764794,1.286253,0.006019,0.004346,-0.001673,2.126242,12.240097,10.113855,18.705971,3.853469,-14.852502,1.217139,8.964312,7.747173,27.316086,9.51709,-17.798996,0,0.411148,0.411148,0.085014,0.000179,-0.084835,1.313115,1.094276,-0.218839,0,0.308749,0.308749,814.095555,555.259933,-258.835622,42.27984,14.821687,-27.458153,16.140016,3.34564,-12.794376,6.470595,4.056735,-2.41386,14.201173,0.607282,-13.593891,26.624818,12.95427,-13.670548,8.3156,3.776742,-4.538858,36.908279,0.017556,-36.890723,0,57.462854,57.462854,,,
2008-10-01,20430,6469.3,-13960.7,32068.205228,22861.509651,-9206.69557699999,174067,105006,-69061,13390.931924,0,-13390.931924,13868.272582,7699.7,-6168.572582,29751,22242,-7509,9441.172835,8716.301361,-724.871474,13690.564048,12333.695722,-1356.868326,47402.974494,36934.26731,-10468.707184,37922.438208,26693.659503,-11228.778705,9258.332916,2588.182633,-6670.150283,60968.360248,24693.895974,-36274.464274,185882.206942,111238.621109,-74643.5858329998,76478.990545,30352.327599,-46126.662946,1680.095291,2234.800921,554.70563,1128.693885,2248.393141,1119.699256,6730.181987,1868.542888,-4861.639099,0.212846,1.886122,1.673276,27707.276789,22058.748915,-5648.527874,0,0.004413,0.004413,19695.697705,14875.518395,-4820.17931,296.468459,439.3329,142.864441,18.997446,24.721794,5.724348,188.172027,189.288004,1.11597699999999,382.261353,378.16934,-4.09201300000007,141.03444,135.438879,-5.595561,308.638093,526.426164,217.788071,33.341222,440.5326,407.191378,56.721922,56.160017,-0.561904999999989,43.921092,235.380775,191.459683,0,67.21516,67.21516,54.966839,219.756942,164.790103,0.25764,46.495685,46.238045,1.295367,63.3919,62.096533,45.352648,95.566801,50.214153,363.520919,566.145634,202.624715,0.372545,9.785773,9.413228,0.931584,55.689866,54.758282,4.568805,12.093443,7.524638,0.194972,17.530145,17.335173,0.017715,0.968326,0.950611,0.164146,7.173256,7.00911,1.245285,15.210327,13.965042,0.137169,6.272099,6.13493,0.389481,15.723893,15.334412,4.031653,51.452632,47.420979,859.254943,197.862621,-661.392322,49.367819,200.086687,150.718868,,,,,,,291.958197,44.777161,-247.181036,0.295246,56.547457,56.252211,0.180373,27.359412,27.179039,1029.834911,1000.86912,-28.965791,4086.389219,1402.548838,-2683.840381,12.974366,18.563637,5.589271,4.066494,43.914007,39.847513,0,0.754636,0.754636,580.486297,339.849646,-240.636651,540.847315,526.190995,-14.6563199999998,73.28944,35.070398,-38.219042,500.59915,957.101845,456.502695,3086.274358,3017.838932,-68.4354259999996,12.160472,109.82402,97.663548,24.652819,75.481521,50.828702,589.425558,603.028551,13.602993,1.504249,0.103883,-1.400366,18.391402,29.722032,11.33063,1061.598238,444.233912,-617.364326,0,0.124356,0.124356,475.125187,259.498437,-215.62675,459.593829,326.312682,-133.281147,2.705225,6.711258,4.006033,629.224521,229.112601,-400.11192,5154.612825,4330.750537,-823.862288,2995.332143,590.148121,-2405.184022,2073.342698,3215.663099,1142.320401,1414.781244,2410.612101,995.830857,45.651697,74.351833,28.700136,0.00428,1.506078,1.501798,1.401877,5.432847,4.03097,4062.204224,2570.328414,-1491.87581,8084.833821,4763.078356,-3321.755465,692.695232,269.687743,-423.007489,,,,214.604345,124.723016,-89.881329,122.421736,51.058199,-71.363537,266.701724,115.347202,-151.354522,17.198311,1.709484,-15.488827,1665.938273,1459.091733,-206.84654,32.373412,24.031216,-8.34219600000001,29.201789,37.690965,8.48917599999999,40.115717,82.703405,42.587688,198.777896,462.212308,263.434412,,,,2143.355031,797.083163,-1346.271868,62.406027,19.772862,-42.633165,329.366934,181.018424,-148.34851,3.694481,9.957618,6.263137,597.820881,20.325682,-577.495199,21.222944,50.242826,29.019882,28.138178,128.263128,100.12495,0.192033,2.350596,2.158563,1.258331,4.238638,2.980307,0.027608,10.85408,10.826472,2.633365,3.683274,1.049909,0.630749,4.143668,3.512919,930.666594,922.419054,-8.24754000000019,184.614096,180.56103,-4.053066,0.012113,98.972548,98.960435,17.834683,6.051388,-11.783295,0.049135,0.232675,0.18354,0.052607,0.805166,0.752559,3074.378676,1275.086637,-1799.292039,,,,26.767437,50.95085,24.183413,36.562168,20.736337,-15.825831,1.921587,2.258191,0.336604000000001,1.81993,2.118777,0.298847,,,,,,,,,,0.100818,5.835763,5.734945,1.19711,3.573467,2.376357,101.2174,185.153405,83.936005,88.30507,105.477419,17.172349,55.413239,30.477628,-24.935611,444.797799,659.183059,214.38526,1.146211,13.501043,12.354832,10.828626,42.400647,31.572021,7.599163,153.881269,146.282106,1687.765378,101.922657,-1585.842721,7.068444,160.484426,153.415982,449.9,435,-14.9,0.102505,0.023641,-0.078864,0.053244,0.093034,0.03979,123.205358,90.057573,-33.147785,667.172214,246.037405,-421.134809,,,,5318.005737,1228.968267,-4089.03747,49.205492,289.323638,240.118146,108.547554,1329.170527,1220.622973,0.452154,19.546178,19.094024,31.250008,114.387719,83.137711,91.346643,62.666464,-28.680179,4.354754,48.16961,43.814856,2441.815397,1640.411964,-801.403433,356.718917,116.167271,-240.551646,9.278587,4.267456,-5.011131,366.546384,45.816667,-320.729717,167.302337,22.487858,-144.814479,0,0.845021,0.845021,2108.169877,782.088072,-1326.081805,1309.79263,208.995814,-1100.796816,1.851778,2.619349,0.767571,229.579104,10.886815,-218.692289,2498.924546,1096.08469,-1402.839856,1240.13617,2283.288243,1043.152073,1553.273067,497.176654,-1056.096413,0,0.149413,0.149413,9.790435,8.352742,-1.437693,786.248756,733.671027,-52.5777290000003,70.304661,19.322606,-50.982055,0.023285,0.021483,-0.001802,1.134093,0.909272,-0.224821,34032.388283,6083.400135,-27948.988148,7.506176,4.623171,-2.883005,0,7.412295,7.412295,4326.034008,2911.540493,-1414.493515,643.664523,1760.125297,1116.460774,3231.338134,1761.347328,-1469.990806,11475.705942,5338.587364,-6137.118578,883.22061,1965.547093,1082.326483,0,1.02539,1.02539,0.272062,0.160553,-0.111509,0.444081,0.039235,-0.404846,0,0.758245,0.758245,11.873383,7.750249,-4.123134,205.45773,227.702053,22.244323,0.159132,0.097523,-0.061609,1.029465,3.513007,2.483542,0,0.05051,0.05051,0.393152,1.519768,1.126616,0.112489,0.35515,0.242661,0.297618,0.445594,0.147976,0,0,0,0.091819,0.025423,-0.066396,0,0.072642,0.072642,7.639197,8.140228,0.501031000000002,0,0.038337,0.038337,3.344636,11.845639,8.501003,0.915964,3.227571,2.311607,0.535248,4.435622,3.900374,0,1.782931,1.782931,0,0.844001,0.844001,12.488753,8.383989,-4.104764,0.383546,1.352833,0.969287,69.104795,94.028868,24.924073,1628.645553,56.744021,-1571.901532,49.149602,21.260301,-27.889301,7.223937,5.098832,-2.125105,311.316878,472.098226,160.781348,0.693469,9.23235,8.538881,,,,0.0042,0,-0.0042,430.238051,17.863364,-412.374687,0.046296,8.4231,8.376804,38.570118,16.571706,-21.998412,0.424441,11.179538,10.755097,0.289402,1.641524,1.352122,9.327549,9.030338,-0.297210999999999,5.430026,4.082985,-1.347041,33.316666,14.894761,-18.421905,5.742055,76.427495,70.68544,0.265157,1.777938,1.512781,0.381358,3.450717,3.069359,0.053559,9.353155,9.299596,2766.655394,387.484612,-2379.170782,1.336259,0.921514,-0.414745,94.942056,16.199562,-78.742494,284.38429,3.44255,-280.94174,1.22302,0.122031,-1.100989,0.011178,0.820409,0.809231,0.028661,49.197605,49.168944,1509.193409,354.636039,-1154.55737,571.070567,21.704985,-549.365582,0,0.471049,0.471049,0.022072,0.744002,0.72193,0.005502,0.156674,0.151172,15.252079,22.852278,7.60019899999999,11.03963,18.795921,7.756291,0.006313,3.256176,3.249863,2.51517,0.714783,-1.800387,0.002365,3.894057,3.891692,1.812699,29.68472,27.872021,0,0.086549,0.086549,0.900087,10.891151,9.991064,1.550796,4.618886,3.06809,43.133733,35.961026,-7.172707,0.30043,1.219289,0.918859,0,0.080505,0.080505,3.770269,23.140673,19.370404,14.239104,4.403171,-9.835933,0.328662,21.742747,21.414085,38.051667,6.844972,-31.206695,0,0.192348,0.192348,0.178412,0.067478,-0.110934,1.070081,0.248096,-0.821985,0,0.110356,0.110356,722.288892,595.549265,-126.739627,26.959319,15.465511,-11.493808,18.142602,4.546877,-13.595725,5.000732,6.998002,1.99727,13.781815,0.872682,-12.909133,0.84098,12.723061,11.882081,10.375405,2.660207,-7.715198,38.245507,0.023229,-38.222278,0,86.204666,86.204666,,,
2008-11-01,11948.3,6222.1,-5726.2,26550.001488,20658.928463,-5891.073025,150372,97819,-52553,10110.56659,0,-10110.56659,11210.740578,6341,-4869.740578,24807,20393,-4414,8045.980525,7192.264025,-853.7165,9829.301728,10626.508313,797.206584999998,38074.555031,31117.088843,-6957.46618799999,31118.316303,24137.211284,-6981.10501899999,5555.587954,2235.30767,-3320.280284,51469.925466,21270.374207,-30199.551259,147514.986944,97085.4162359999,-50429.5707080001,61884.906599,26927.077483,-34957.829116,1347.666647,1948.423768,600.757121,1051.154074,2020.060711,968.906636999998,4037.736248,1595.987978,-2441.74827,1.092606,0.621304,-0.471302,22602.90802,19172.380696,-3430.527324,0.072649,0.012727,-0.059922,15471.647011,11944.708147,-3526.93886400001,188.847389,326.910284,138.062895,6.955566,28.6277,21.672134,166.056845,180.213489,14.156644,306.985581,351.04667,44.061089,121.705864,117.37619,-4.32967400000003,256.553876,451.17933,194.625454,28.378514,353.573003,325.194489,2.359524,83.668765,81.309241,89.973563,240.624315,150.650752,0,52.766637,52.766637,40.909155,176.729085,135.81993,2.331338,33.325582,30.994244,1.327487,63.881536,62.554049,32.328478,84.332992,52.004514,307.517092,521.697805,214.180713,0.533452,7.669662,7.13621,1.666715,22.456472,20.789757,4.190576,14.528002,10.337426,0.193008,16.815899,16.622891,0.005364,0.8523,0.846936,0.104148,7.547884,7.443736,1.464597,14.714447,13.24985,0.016241,9.947286,9.931045,0.288166,7.789172,7.501006,2.769436,50.503808,47.734372,478.614741,197.174676,-281.440065,61.400617,215.034185,153.633568,,,,,,,196.42627,75.182271,-121.243999,0.375144,15.056772,14.681628,0.923939,13.967297,13.043358,854.900139,784.535848,-70.3642909999998,2552.445819,1236.476712,-1315.969107,7.21948,30.993149,23.773669,14.468105,32.7042,18.236095,0,1.620057,1.620057,497.795085,270.098788,-227.696297,412.395998,384.319851,-28.076147,32.758119,30.934388,-1.823731,468.443374,814.11119,345.667816,2224.986313,2604.504426,379.518113,9.900138,117.526812,107.626674,27.703792,64.07094,36.367148,424.609712,519.357699,94.747987,0.472968,0.060737,-0.412231,14.756842,24.567453,9.810611,876.457227,401.260393,-475.196834,0,0.032265,0.032265,454.698961,227.271202,-227.427759,372.119005,241.593097,-130.525908,2.836365,0.28336,-2.553005,365.910432,214.871261,-151.039171,4104.952972,3546.130205,-558.822767,2296.725911,504.273794,-1792.452117,1633.398332,3319.801146,1686.402814,1118.276887,2112.557136,994.280249,43.292093,60.683121,17.391028,0.025322,1.570323,1.545001,1.663182,8.879335,7.216153,3313.598324,2196.994246,-1116.604078,7158.06143,4366.199877,-2791.861553,593.971475,169.610312,-424.361163,,,,186.860548,102.860145,-84.0004029999999,78.62673,78.173444,-0.453285999999977,200.891953,114.731282,-86.160671,14.681507,0.691615,-13.989892,1444.092836,1412.564726,-31.52811,28.492168,15.408294,-13.083874,12.131409,28.773709,16.6423,57.596111,69.189575,11.593464,193.025177,328.239032,135.213855,,,,1681.528369,677.707714,-1003.820655,41.95786,9.394132,-32.563728,154.530191,128.968551,-25.56164,3.338249,12.424898,9.086649,79.090843,13.640033,-65.45081,21.721524,51.262475,29.540951,98.080146,54.696843,-43.383303,0.018263,5.34121,5.322947,0.640728,1.922202,1.281474,0.019492,20.106753,20.087261,4.054001,3.496307,-0.557694,14.892648,21.908239,7.015591,848.619584,912.018439,63.3988549999998,206.989687,268.45301,61.463323,0.0327,164.681684,164.648984,18.233867,18.291539,0.0576720000000037,0.086524,0.407699,0.321175,0.013874,0.491592,0.477718,2560.259964,1119.914714,-1440.34525,,,,23.937452,37.214255,13.276803,35.481697,47.93002,12.448323,2.273589,2.67306,0.399471,3.113444,2.371415,-0.742029,,,,,,,,,,0.008591,4.546146,4.537555,1.267233,5.061963,3.79473,113.920154,231.167406,117.247252,103.265341,98.112028,-5.15331300000004,28.005861,27.659717,-0.346143999999999,497.237305,573.11932,75.882015,0.837149,64.031521,63.194372,26.366206,18.430267,-7.935939,6.402907,110.313984,103.911077,1128.64761,108.725392,-1019.922218,8.181298,111.092466,102.911168,531.1,434.3,-96.8,0.30212,0,-0.30212,0.069132,0.014126,-0.055006,71.364827,99.771008,28.406181,306.120575,257.782776,-48.3377989999999,,,,2531.754757,1427.134017,-1104.62074,18.160892,263.912856,245.751964,67.88657,1532.501149,1464.614579,1.937864,12.710336,10.772472,11.340815,113.589248,102.248433,39.242514,108.781099,69.538585,1.805852,40.709383,38.903531,1914.16197,1204.383272,-709.778698,297.519796,120.633516,-176.88628,6.957988,1.987096,-4.970892,247.88252,32.217696,-215.664824,143.945106,63.752954,-80.192152,0,0.644205,0.644205,1825.426079,719.902678,-1105.523401,1040.703163,197.162271,-843.540892,2.74687,1.613953,-1.132917,179.789799,7.446119,-172.34368,2121.415918,903.406979,-1218.008939,1128.560042,1858.258756,729.698714,1160.534263,329.001773,-831.53249,0,0.2791,0.2791,6.564625,10.39932,3.834695,685.674565,594.232142,-91.4424230000001,48.656655,22.766122,-25.890533,0.012496,0.101829,0.089333,0.218848,1.193663,0.974815,28265.02503,5180.95014,-23084.07489,1.175982,5.916015,4.740033,0,0.011,0.011,3616.987512,2373.767111,-1243.220401,492.932064,1506.069268,1013.137204,2807.500907,1454.16889,-1353.332017,10108.213172,5058.036817,-5050.176355,772.687064,1758.55162,985.864556,0,0.615793,0.615793,0.065812,0.025162,-0.04065,0.071946,0.095194,0.023248,0,0.683357,0.683357,7.758275,8.813025,1.05475,247.415374,211.952244,-35.46313,0.019731,0.61062,0.590889,0.400264,2.89213,2.491866,0,0.033121,0.033121,0.313446,1.726428,1.412982,0.197707,0.418491,0.220784,0.051118,0.161619,0.110501,0,0,0,0.062105,0.18248,0.120375,0.000001,0.047358,0.047357,2.606145,7.347538,4.741393,0,0.015,0.015,2.977217,11.02888,8.051663,1.363484,2.15771,0.794226,0.194015,3.844108,3.650093,0,1.302481,1.302481,0.030018,0.36176,0.331742,14.61181,6.84631,-7.7655,0.328229,1.016246,0.688017,65.177232,83.529747,18.352515,1086.313795,86.066896,-1000.246899,25.471551,46.807041,21.33549,37.28861,20.633263,-16.655347,214.137194,360.952207,146.815013,1.101117,19.501902,18.400785,,,,0,0.036,0.036,323.594918,13.495122,-310.099796,0.04288,2.847061,2.804181,6.154315,17.516824,11.362509,0.484936,8.55236,8.067424,0.217906,1.692509,1.474603,4.117143,4.66114,0.543996999999999,10.560875,4.459949,-6.100926,33.446831,34.24764,0.800808999999987,6.49494,67.739781,61.244841,0.02812,1.741936,1.713816,0.269835,3.352198,3.082363,0.008421,5.620597,5.612176,1756.550045,408.469025,-1348.08102,0.820126,0.694537,-0.125589,132.80805,20.830773,-111.977277,172.217196,5.783588,-166.433608,3.200621,0.369331,-2.83129,0.049526,1.973097,1.923571,0.004157,90.752518,90.748361,710.528445,129.802586,-580.725859,224.035183,21.270366,-202.764817,0.008,0.120361,0.112361,0.007423,1.255543,1.24812,0.006558,0.389069,0.382511,12.699993,19.821501,7.121508,1.473897,12.163472,10.689575,0.564468,1.281734,0.717266,3.002543,0.825394,-2.177149,0.058519,7.723189,7.66467,1.050542,198.738518,197.687976,0.003828,0.064493,0.060665,0.042737,18.678111,18.635374,1.48601,2.339471,0.853461,19.756021,39.450172,19.694151,0.633365,4.101277,3.467912,0,0.207771,0.207771,2.585653,14.951968,12.366315,11.176742,3.224471,-7.952271,1.674428,18.302688,16.62826,25.236207,8.604573,-16.631634,0,0.068164,0.068164,0.158239,0.03112,-0.127119,0.191837,0.221276,0.029439,0,0.056119,0.056119,489.86918,514.353548,24.4843680000001,10.386128,20.307926,9.921798,13.536078,3.392745,-10.143333,2.456563,3.549043,1.09248,8.466373,0.946103,-7.52027,2.421872,8.746327,6.324455,8.642743,1.067171,-7.575572,29.16373,0.009331,-29.154399,0,21.527901,21.527901,,,
2008-12-01,11216.5,6025.5,-5191,26598.759406,19728.827456,-6869.93195,139234,87992,-51242,8916.894887,0,-8916.894887,9314.676973,5487.1,-3827.576973,24216,21230,-2986,7332.683258,6424.017763,-908.665495,9174.652628,9381.888487,207.235859,33979.151321,27052.697779,-6926.45354200001,30676.905569,23229.020689,-7447.88487999999,5384.731304,2317.85959,-3066.871714,47080.524514,19262.868074,-27817.65644,137762.918962,88486.164773,-49276.754189,57413.942716,24818.053866,-32595.88885,1428.060234,1655.497645,227.437411,1132.961855,1686.108261,553.146406000001,4157.494046,1540.550273,-2616.943773,0.573569,0.442717,-0.130852,19710.03087,16912.203499,-2797.827371,0,0.024294,0.024294,14269.120451,10140.49428,-4128.626171,247.642827,311.626406,63.9835789999999,8.679904,25.507625,16.827721,170.936532,164.238344,-6.69818799999999,307.874231,276.583287,-31.2909440000001,122.153269,82.7433,-39.409969,271.43883,383.251193,111.812363,32.661502,245.361225,212.699723,0.814952,35.692992,34.87804,66.215881,170.868195,104.652314,0.006478,57.588682,57.582204,37.993344,148.496538,110.503194,1.079523,31.238762,30.159239,2.769725,59.762965,56.99324,37.694939,69.893816,32.198877,308.014545,437.055115,129.04057,0.236552,7.264294,7.027742,1.42288,28.579379,27.156499,4.530274,10.814459,6.284185,0.724485,14.181075,13.45659,0.005121,0.84645,0.841329,0.170428,9.779099,9.608671,1.123907,12.166528,11.042621,0.105519,7.36372,7.258201,0.226517,9.004521,8.778004,2.910656,37.304392,34.393736,372.028017,168.816733,-203.211284,27.179788,230.762679,203.582891,,,,,,,285.292694,39.487798,-245.804896,0.054635,17.417757,17.363122,0.117585,14.096377,13.978792,798.262937,802.965597,4.70266000000015,2279.99728,1092.090235,-1187.907045,13.570172,25.959382,12.38921,8.351903,32.361622,24.009719,0,1.617558,1.617558,404.619369,276.99428,-127.625089,339.282099,416.689374,77.4072749999999,33.416747,29.882748,-3.53399899999999,601.436295,653.333176,51.8968810000001,1843.433826,2329.16589,485.732064,7.374599,77.608998,70.234399,32.776624,59.370826,26.594202,500.02373,476.028915,-23.9948150000001,0.001507,0.02618,0.024673,17.686695,33.660818,15.974123,906.068786,343.451189,-562.617597,0,0.065001,0.065001,393.481057,284.29421,-109.186847,318.410988,195.521452,-122.889536,2.65107,0.255954,-2.395116,556.807584,184.690379,-372.117205,3917.769316,3583.411311,-334.358004999999,2971.744938,647.668498,-2324.07644,1201.228175,3213.957564,2012.729389,1075.797033,1953.742847,877.945814,26.771295,85.037428,58.266133,0.147296,0.646134,0.498838,2.007268,20.851398,18.84413,3359.427314,2290.707474,-1068.71984,7129.18377,3820.254014,-3308.929756,578.960141,171.746028,-407.214113,,,,189.176765,106.451454,-82.725311,62.43562,101.532147,39.096527,258.330015,115.354006,-142.976009,17.276374,0.913027,-16.363347,1446.525587,1404.935161,-41.590426,20.852269,12.783371,-8.068898,5.611083,30.166944,24.555861,37.138871,56.002248,18.863377,191.937063,365.261535,173.324472,,,,1196.379608,558.216335,-638.163273,42.664152,13.660133,-29.004019,145.729047,92.593124,-53.135923,4.692214,10.426842,5.734628,281.143698,51.745096,-229.398602,9.630337,57.19946,47.569123,112.040264,105.13418,-6.90608400000004,0.109055,4.013206,3.904151,0.711872,2.840597,2.128725,4.775364,2.082377,-2.692987,2.485349,4.974813,2.489464,19.980702,9.441906,-10.538796,863.325958,954.434006,91.1080479999999,191.914185,210.761167,18.846982,0.000353,139.44881,139.448457,18.195965,12.476961,-5.719004,0.061452,0.080702,0.01925,0.000601,0.49976,0.499159,2482.670936,1003.30337,-1479.367566,,,,23.359121,16.718557,-6.64056399999999,38.158982,23.590216,-14.568766,2.495043,2.190916,-0.304126999999999,8.932874,1.118566,-7.814308,,,,,,,,,,0.07675,6.851492,6.774742,1.170896,3.628672,2.457776,78.046101,130.684913,52.638812,87.404369,70.942992,-16.461377,30.018103,31.151824,1.13372099999999,334.770389,661.727277,326.956888,1.373781,13.742118,12.368337,2.475647,10.991272,8.515625,5.375197,109.416231,104.041034,805.928446,107.054474,-698.873972,9.423199,34.012006,24.588807,431.4,538.1,106.7,0.13727,0.0063,-0.13097,1.148201,0.07807,-1.070131,81.460099,82.212573,0.752474000000007,453.588059,253.493484,-200.094575,,,,2697.019557,1291.323852,-1405.695705,16.762388,486.223565,469.461177,86.506199,1515.518992,1429.012793,0.720409,27.71391,26.993501,32.985139,192.930387,159.945248,25.070013,109.473338,84.403325,2.438117,45.348544,42.910427,1847.383569,1022.98961,-824.393959,291.135066,108.454671,-182.680395,6.18729,3.336082,-2.851208,294.805614,58.464078,-236.341536,156.454557,19.865977,-136.58858,0,3.104562,3.104562,1721.52259,547.524591,-1173.997999,1177.195785,154.908647,-1022.287138,3.694049,1.980312,-1.713737,146.810107,5.777991,-141.032116,1924.405607,737.147543,-1187.258064,1145.066256,1892.876476,747.81022,1195.05716,347.669074,-847.388086,0,0.058294,0.058294,4.796577,10.124697,5.32812,586.171959,480.629922,-105.542037,48.398585,19.672524,-28.726061,0.004142,0.05212,0.047978,0.107754,0.829978,0.722224,25079.514978,5110.706195,-19968.808783,1.337979,7.577482,6.239503,0,10.285282,10.285282,3285.164017,1861.267811,-1423.896206,357.967085,1381.69613,1023.729045,2544.4859,1288.177346,-1256.308554,9803.951911,4492.470169,-5311.481742,786.164546,1461.909579,675.745033,0,0.120541,0.120541,0.03196,0.007463,-0.024497,0.04387,0.028919,-0.014951,0,0.082504,0.082504,12.89092,11.311653,-1.579267,306.489013,167.208955,-139.280058,0.00249,0.180489,0.177999,0.175013,2.268254,2.093241,0,0.02072,0.02072,0.592015,1.071471,0.479456,0.069257,0.278238,0.208981,0.048683,0.181925,0.133242,0,0,0,0.040279,0.13642,0.096141,0.009204,0.029326,0.020122,2.468726,4.685277,2.216551,0,0.044965,0.044965,1.896921,9.25796,7.361039,1.188612,1.538052,0.34944,0.296771,19.831069,19.534298,0,1.049514,1.049514,0.009267,0.617469,0.608202,20.273197,3.382707,-16.89049,0.280315,0.883115,0.6028,66.752154,138.360484,71.60833,791.448132,127.339013,-664.109119,17.57679,30.824716,13.247926,30.738043,36.688641,5.950598,189.033105,408.491297,219.458192,1.0131,14.690653,13.677553,,,,0,0.000598,0.000598,200.638304,30.541467,-170.096837,44.497486,2.933135,-41.564351,23.027606,14.672195,-8.35541099999999,0.894134,12.371054,11.47692,0.829714,1.551911,0.722197,9.178881,8.937801,-0.24108,7.015719,2.071859,-4.94386,102.211052,15.038083,-87.172969,12.201901,37.222177,25.020276,0.01149,1.762402,1.750912,0.112219,2.967511,2.855292,0.036995,11.757927,11.720932,1461.756576,266.869237,-1194.887339,0.84088,1.483388,0.642508,160.918428,58.478341,-102.440087,147.411042,14.426854,-132.984188,0.035956,0.166028,0.130072,0.037845,2.392703,2.354858,0,62.340337,62.340337,852.04839,155.652938,-696.395452,245.000393,25.699798,-219.300595,0,0.2485,0.2485,0,1.011508,1.011508,0.040934,0.086813,0.045879,6.670899,14.491437,7.820538,1.08213,8.878218,7.796088,0.192824,0.724283,0.531459,2.569342,1.5887,-0.980642,0.019044,8.887634,8.86859,1.672944,11.974197,10.301253,0.003388,0.306954,0.303566,1.259726,22.017733,20.758007,2.606325,3.434386,0.828061,31.574844,29.217069,-2.357775,0.414909,0.972687,0.557778,0.006021,0.234125,0.228104,7.136851,21.239832,14.102981,13.028482,3.996591,-9.031891,1.764479,20.02645,18.261971,25.243246,6.16222,-19.081026,0,0.213846,0.213846,0.093187,0.038415,-0.054772,0.001328,0.572622,0.571294,0,0.022803,0.022803,718.943153,594.285756,-124.657397,8.109816,14.396297,6.286481,6.801692,5.187295,-1.614397,1.23412,6.45528,5.22116,10.546633,0.751972,-9.794661,1.00271,3.804667,2.801957,12.329913,2.999989,-9.329924,30.525645,0.054874,-30.470771,0,0.06909,0.06909,,,
2009-01-01,7982.701834,3924.52019,-4058.181644,21187.930735,17666.987484,-3520.94325099999,129116,82415,-46701,7599.395994,0,-7599.395994,7381.364276,4868.66134,-2512.702936,20735.155929,18730.822418,-2004.333511,7550.445784,5896.401407,-1654.044377,8288.522949,8804.49182600001,515.968877000007,30017.868095,24514.722522,-5503.145573,24700.740029,20588.976372,-4111.76365699997,4027.251708,1831.49957,-2195.752138,45112.480988,16953.505927,-28158.975061,122414.556197,78150.5788130001,-44263.9773839999,54326.827331,20834.135861,-33492.69147,1037.935761,1495.376518,457.440757,1053.214555,1575.832352,522.617797,2905.395979,1314.899282,-1590.496697,0.13153,0.88859,0.75706,17552.987776,14733.581576,-2819.4062,0,0.03172,0.03172,12464.880319,9781.140946,-2683.739373,196.601285,242.922053,46.3207680000001,6.573171,16.538304,9.965133,131.049501,169.735035,38.685534,201.281788,239.80393,38.5221420000001,97.234162,38.80872,-58.425442,225.779387,353.549769,127.770382,15.930658,376.324222,360.393564,0.385724,86.320814,85.93509,46.370915,151.590302,105.219387,0,62.833114,62.833114,40.851173,155.261584,114.410411,0.822586,29.142922,28.320336,1.433212,55.277092,53.84388,20.897777,47.427666,26.529889,185.989638,450.557011,264.567373,0.339494,8.181157,7.841663,0.509756,55.207485,54.697729,3.31031,8.457842,5.147532,1.683332,13.879583,12.196251,0.075924,0.779854,0.70393,0.203275,5.406948,5.203673,1.172664,9.284525,8.111861,0.132583,5.954946,5.822363,0.196151,4.391626,4.195475,2.231404,30.401738,28.170334,394.393959,196.346652,-198.047307,47.612538,161.253289,113.640751,,,,,,,173.547793,48.017487,-125.530306,0.291853,8.133105,7.841252,0.003619,13.57378,13.570161,690.138717,709.059429,18.920712,2001.015733,881.089867,-1119.925866,9.85878,14.415315,4.556535,16.49351,29.880729,13.387219,0.000262,2.943479,2.943217,374.755456,274.349311,-100.406145,404.988749,372.069057,-32.9196920000002,30.843489,29.530883,-1.31260600000001,731.490842,747.877239,16.3863969999996,1810.866138,2118.038467,307.172329,4.269984,83.597664,79.32768,23.621846,58.853107,35.231261,393.049344,437.398663,44.349319,0.224467,0.026061,-0.198406,11.785695,27.389077,15.603382,644.854978,346.874763,-297.980215,0,0.117311,0.117311,365.160869,187.033828,-178.127041,373.069797,112.489624,-260.580173,2.098113,0.282043,-1.81607,410.299497,161.392468,-248.907029,3077.434769,3681.49618,604.061411,2331.139993,669.651498,-1661.488495,1186.381695,2399.848733,1213.467038,914.769086,1752.057708,837.288622,34.043906,72.772228,38.728322,0.029818,0.262138,0.23232,1.293904,0.685079,-0.608825,2691.574433,2217.355607,-474.218826,5213.588313,3555.622453,-1657.96586,481.559569,149.465066,-332.094503,,,,158.087986,80.523356,-77.56463,39.888918,16.35249,-23.536428,151.857211,103.119276,-48.737935,9.966551,2.32168,-7.644871,1196.089179,1499.636813,303.547634,26.412424,12.791465,-13.620959,13.975969,19.889227,5.913258,40.391195,35.525902,-4.86529300000001,146.389741,199.692413,53.302672,,,,1303.78561,393.956274,-909.829336,35.09826,7.900085,-27.198175,90.813895,69.283745,-21.53015,2.890835,6.799919,3.909084,42.844144,13.573212,-29.270932,4.273423,36.17498,31.901557,82.146453,43.815217,-38.331236,0.046432,4.636607,4.590175,0.517617,1.212973,0.695356,0.015138,2.046657,2.031519,2.436768,8.988722,6.551954,0.691651,5.536202,4.844551,665.507972,666.5767,1.06872799999996,128.93296,183.721661,54.788701,0.006557,98.704676,98.698119,12.116019,29.627304,17.511285,0.045224,0.2481,0.202876,0,0.030147,0.030147,2210.162043,956.298105,-1253.863938,,,,24.56573,14.507308,-10.058422,32.879517,27.707613,-5.17190399999999,1.380467,2.877029,1.496562,6.009916,1.646133,-4.363783,,,,3.302391,6.297616,2.995225,0.033119,0.131355,0.098236,0.755483,3.833219,3.077736,0.56275,3.050499,2.487749,74.373099,107.240171,32.867072,99.21445,79.305292,-19.909158,27.852761,16.780878,-11.071883,324.163302,479.010244,154.846942,1.172434,12.809303,11.636869,20.957951,28.818749,7.860798,6.739456,117.943382,111.203926,715.554965,119.794704,-595.760261,7.083427,6.290017,-0.793410000000002,537.9,443,-94.9,0.030601,0,-0.030601,0.034258,0.081305,0.047047,89.712603,66.216351,-23.496252,392.910666,141.205121,-251.705545,,,,2097.965277,805.185809,-1292.779468,17.018469,128.256559,111.23809,73.2418,1114.733427,1041.491627,0.480771,23.837839,23.357068,39.584555,85.854706,46.270151,48.713366,58.134035,9.42066899999999,2.472244,105.928269,103.456025,1833.517978,1139.832057,-693.685921,243.385075,88.59826,-154.786815,5.637245,0.984025,-4.65322,351.565995,38.940102,-312.625893,162.003662,22.306607,-139.697055,0,0.34166,0.34166,1483.994781,482.682899,-1001.311882,1085.334314,157.460549,-927.873765,3.984503,0.637187,-3.347316,182.424735,5.100279,-177.324456,1837.628555,635.305481,-1202.323074,1154.668572,1784.768191,630.099619,1208.160067,271.155841,-937.004226,0,0.206775,0.206775,5.320498,9.118729,3.798231,523.77316,444.188084,-79.585076,42.967704,18.234129,-24.733575,0,0.086651,0.086651,0.515835,0.828961,0.313126,24743.457402,4159.649756,-20583.807646,0.688645,8.086427,7.397782,0,0.227975,0.227975,3599.973011,1669.62107,-1930.351941,352.194758,1343.641395,991.446637,2443.609443,1098.370751,-1345.238692,8164.903203,3975.457084,-4189.446119,782.645615,1357.524336,574.878721,0.106495,0.006848,-0.099647,0.146914,0.00109,-0.145824,0.535589,0.002062,-0.533527,0,0.125753,0.125753,6.97328,10.228306,3.255026,246.20572,176.242774,-69.962946,0.005221,0.02579,0.020569,0.061765,1.72956,1.667795,0.00232,0.001076,-0.001244,0.618933,0.474925,-0.144008,0.046559,0.473983,0.427424,0.460491,0.163981,-0.29651,0,0.000609,0.000609,0.048465,0.056174,0.007709,0,0.03133,0.03133,1.823235,6.18587,4.362635,0,0.053863,0.053863,1.597974,9.479499,7.881525,1.270537,1.503954,0.233417,0.220235,5.937812,5.717577,0.020603,1.455585,1.434982,0.014754,0.725959,0.711205,10.094484,2.316892,-7.777592,0.310419,0.68723,0.376811,43.771541,81.830688,38.059147,776.214867,42.295538,-733.919329,24.932546,24.347945,-0.584600999999999,30.693201,30.33817,-0.355030999999997,168.521203,325.327489,156.806286,0.532878,16.800326,16.267448,,,,0,0.021695,0.021695,150.729873,11.665261,-139.064612,0.030695,8.276159,8.245464,18.635979,9.004326,-9.631653,0.249965,7.527456,7.277491,0.437545,2.441106,2.003561,7.183437,11.912725,4.729288,1.46559,2.102855,0.637265,111.367636,25.545553,-85.822083,9.152107,35.884589,26.732482,0.00102,1.646613,1.645593,0.260137,3.788959,3.528822,0.010277,7.74131,7.731033,692.379943,277.16483,-415.215113,0.465243,0.68917,0.223927,103.244887,12.970278,-90.274609,169.282492,2.362906,-166.919586,0.005302,1.35911,1.353808,0.113838,3.128642,3.014804,0.002185,36.046545,36.04436,727.501186,97.852102,-629.649084,181.915269,25.803917,-156.111352,0,0.004034,0.004034,0.006485,0.264733,0.258248,0.000363,0.039515,0.039152,10.569763,9.175502,-1.394261,1.304303,5.005715,3.701412,1.673841,0.538264,-1.135577,2.298485,3.045349,0.746864,0.003371,0.161109,0.157738,1.499459,8.725303,7.225844,0.08516,0.138229,0.053069,0.009056,17.684517,17.675461,1.465591,54.028906,52.563315,27.309476,96.130434,68.820958,0.633649,0.848691,0.215042,0.103385,0.128029,0.024644,5.827589,16.03997,10.212381,14.705267,2.187976,-12.517291,20.839652,10.255118,-10.584534,24.59892,5.720977,-18.877943,0,0.256937,0.256937,0.000287,0.000769,0.000482,1.244469,4.837267,3.592798,0,0.029816,0.029816,504.818956,432.090289,-72.728667,55.643306,15.671434,-39.971872,5.300528,4.653984,-0.646543999999999,1.11109,4.643301,3.532211,12.746485,0.776945,-11.96954,1.003292,6.518151,5.514859,3.214447,4.079447,0.865,27.384931,0.015353,-27.369578,0,0,0,,,
2009-02-01,6362.960453,4315.330876,-2047.629577,21978.447687,18678.815871,-3299.631816,121807,84903,-36904,7520.627675,0,-7520.627675,7622.513201,5116.226966,-2506.286235,20274.264568,18851.264508,-1423.00006,5967.764073,5941.762433,-26.0016400000004,7402.022691,8046.769999,644.747307999998,29641.86085,24770.087131,-4871.773719,25102.168413,21456.691878,-3645.476535,3470.779997,2052.009673,-1418.770324,35170.256644,17990.959012,-17179.297632,109012.184251,80349.277997,-28662.9062539999,42572.828767,22261.392624,-20311.436143,1258.357502,1579.505372,321.14787,821.324654,1762.057672,940.733018,2628.576141,1197.725764,-1430.850377,1.153637,0.266289,-0.887348,17262.059918,15507.576219,-1754.48369899999,0.045242,0.002731,-0.042511,12379.800932,9262.510912,-3117.29002,203.049391,364.979459,161.930068,8.535899,22.660539,14.12464,140.999114,167.834813,26.8356989999999,257.874873,271.813683,13.93881,124.632507,61.790215,-62.842292,256.579705,337.549362,80.9696569999999,24.11441,334.045382,309.930972,0.830112,51.360422,50.53031,72.810261,159.51914,86.708879,0,58.328306,58.328306,24.066627,118.876662,94.810035,0.681295,23.212835,22.53154,0.790026,49.094896,48.30487,40.692035,67.394986,26.702951,275.221912,375.53784,100.315928,0.476522,4.541347,4.064825,0.15469,14.42259,14.2679,3.082366,8.151693,5.069327,0.290599,13.964765,13.674166,0.254147,0.589785,0.335638,0.155853,7.475772,7.319919,1.578282,9.833498,8.255216,0.01542,5.258255,5.242835,0.138503,4.980782,4.842279,1.739062,38.479695,36.740633,396.007619,184.869572,-211.138047,61.387809,166.98484,105.597031,,,,,,,173.550323,57.919386,-115.630937,0.091655,5.098924,5.007269,0,14.25724,14.25724,698.618827,739.12666,40.507833,1793.536489,744.071561,-1049.464928,9.269594,21.97649,12.706896,4.772774,33.855427,29.082653,0,0.689682,0.689682,346.714733,246.816892,-99.8978410000001,254.05392,318.039146,63.9852260000001,24.279101,28.954003,4.67490200000001,601.903076,575.07546,-26.8276160000001,1342.384178,1836.447474,494.063296000001,3.810788,80.516977,76.706189,19.242132,51.569688,32.327556,233.635339,368.801636,135.166297,0.000723,0.002219,0.001496,12.440568,50.458584,38.018016,673.668467,321.675489,-351.992978,0,0.283513,0.283513,299.951842,218.50304,-81.448802,306.503129,129.018617,-177.484512,2.190671,5.889683,3.699012,391.537158,212.229455,-179.307703,4008.925384,3702.165865,-306.759519000001,2347.254048,703.692171,-1643.561877,1286.480475,2703.781751,1417.301276,808.008155,1673.749855,865.7417,15.123336,74.347739,59.224403,0.077856,0.605814,0.527958,0.740693,1.943416,1.202723,2485.91149,2499.840461,13.9289709999994,5640.084573,3798.212512,-1841.872061,534.005066,159.750084,-374.254982,,,,147.526185,72.628832,-74.897353,38.691767,15.006834,-23.684933,223.82218,109.385972,-114.436208,12.776649,1.292412,-11.484237,1142.465021,1326.527289,184.062268,9.157661,14.064634,4.906973,16.285451,25.300567,9.01511600000001,48.129872,50.053517,1.92364500000001,148.291669,187.318359,39.02669,,,,983.847092,340.55252,-643.294572,31.515281,11.899281,-19.616,82.628848,49.836422,-32.792426,4.279104,6.686787,2.407683,89.056827,23.257991,-65.798836,4.703973,20.969882,16.265909,67.111318,71.931447,4.82012900000004,0.792512,2.469477,1.676965,0.354696,1.186443,0.831747,8.06876,10.734899,2.666139,2.597181,17.316959,14.719778,0.671811,2.41414,1.742329,571.568182,908.325335,336.757153,127.015589,104.745227,-22.270362,0.023256,76.494863,76.471607,13.914861,15.540967,1.62610600000001,0.05155,0.195704,0.144154,0.006041,0.094767,0.088726,1979.741495,915.450458,-1064.291037,,,,17.411567,24.126974,6.715407,27.850526,72.289528,44.439002,1.552427,1.647791,0.0953640000000009,5.115328,5.916479,0.801150999999998,,,,5.021048,7.237813,2.216765,0,0.259662,0.259662,0.442364,2.959916,2.517552,0.535123,1.45951,0.924387,48.123795,101.884857,53.761062,64.394303,58.488886,-5.90541699999998,15.640294,36.156622,20.516328,347.291319,492.722529,145.43121,0.792576,13.711277,12.918701,13.753172,21.602966,7.849794,5.645623,118.870537,113.224914,567.027272,148.4899,-418.537372,3.651808,7.743297,4.091489,506.5,531.1,24.6,0,0.0045,0.0045,0.115069,0.090767,-0.024302,79.250169,82.540509,3.29034,219.091366,141.953275,-77.138091,,,,1201.360596,944.286757,-257.073839,33.594286,469.421445,435.827159,110.978759,1142.792365,1031.813606,0.498788,31.277643,30.778855,76.832758,144.029478,67.19672,28.568378,48.830527,20.262149,3.612329,52.158947,48.546618,1579.003524,1046.832434,-532.17109,247.792754,93.793036,-153.999718,4.65825,1.165152,-3.493098,313.129438,31.829822,-281.299616,147.595315,9.781834,-137.813481,0,0.776216,0.776216,1334.517459,545.377874,-789.139585,875.359733,161.262135,-714.097598,2.588445,1.154256,-1.434189,147.285326,10.890508,-136.394818,1544.238812,747.857432,-796.38138,881.238492,1593.414096,712.175604,1008.631827,304.709727,-703.9221,0.04421,0.046515,0.002305,4.875108,6.809901,1.934793,558.775235,379.101649,-179.673586,25.878715,18.570632,-7.308083,0,0.023983,0.023983,0.245216,0.866704,0.621488,18845.49521,4661.681362,-14183.813848,1.041941,1.662182,0.620241,0,0.005,0.005,2863.963651,1975.442186,-888.521465,247.706009,1399.458448,1151.752439,1974.855921,973.447703,-1001.408218,6409.370543,4200.226831,-2209.143712,529.737552,1580.448313,1050.710761,0.053407,0.033778,-0.019629,0.072611,0.040582,-0.032029,0.025806,0.085297,0.059491,0,0.474114,0.474114,7.648801,6.603509,-1.045292,267.840768,143.187223,-124.653545,0.170369,0.140459,-0.02991,0.277396,1.271383,0.993987,0,0,0,0.429013,1.615197,1.186184,0.071839,0.713895,0.642056,0.171611,0.146518,-0.025093,0,0,0,0.076846,0.023788,-0.053058,0.001002,0.055067,0.054065,1.427146,6.142084,4.714938,0,0.111251,0.111251,1.848161,10.03991,8.191749,0.819697,1.104257,0.28456,0.105569,6.130781,6.025212,0,1.266221,1.266221,0.0162,0.299769,0.283569,10.160177,1.895876,-8.264301,0.288155,0.709396,0.421241,31.920305,114.654396,82.734091,552.074703,90.180773,-461.89393,25.806183,23.615719,-2.19046400000001,66.574517,24.285188,-42.289329,123.207463,576.767877,453.560414,0.4661,0.490348,0.0242479999999999,,,,0,0.02136,0.02136,210.560147,39.854043,-170.706104,34.176237,4.210486,-29.965751,12.1872,11.684876,-0.502324000000003,1.734314,9.154723,7.420409,0.067905,1.303846,1.235941,2.019602,6.059286,4.039684,1.566864,4.363966,2.797102,66.69585,16.378478,-50.317372,9.541837,36.713768,27.171931,0.010291,0.969972,0.959681,13.241,2.537998,-10.703002,0.049419,6.370368,6.320949,692.077085,241.134921,-450.942164,0.026773,1.185464,1.158691,123.99147,22.905162,-101.086308,74.671704,7.333835,-67.337869,0.940515,0.050765,-0.88975,0.147611,2.137231,1.98962,0.003796,23.624688,23.620892,735.781444,89.921432,-645.860012,119.244141,31.762549,-87.481592,0,0.072663,0.072663,0.100768,0.189937,0.089169,0.002409,0.109438,0.107029,0.202583,8.375395,8.172812,18.666786,6.136957,-12.529829,0.521441,0.146059,-0.375382,1.666264,0.940558,-0.725706,0.002759,0.333022,0.330263,1.349121,9.800978,8.451857,0.379234,4.048185,3.668951,1.543505,13.064468,11.520963,1.318141,3.490918,2.172777,20.279723,85.877311,65.597588,0.448858,0.844285,0.395427,0.065245,0.119935,0.05469,9.2207,6.386599,-2.834101,11.658612,1.896548,-9.762064,0.513302,9.109841,8.596539,18.122424,3.704795,-14.417629,0.009851,0.312035,0.302184,0,0,0,1.11753,0.182178,-0.935352,0,0.170659,0.170659,330.663958,441.686808,111.02285,66.145769,13.007008,-53.138761,2.741102,3.328373,0.587270999999999,1.111323,4.34658,3.235257,12.466061,1.173625,-11.292436,0.640956,3.378351,2.737395,9.864351,3.165518,-6.698833,17.073061,0.060268,-17.012793,0,0,0,,,
2009-03-01,7301.915503,4950.394347,-2351.521156,24116.070987,19834.155772,-4281.915215,121885,83500,-38385,8214.71581,0,-8214.71581,8380.939387,5639.725878,-2741.213509,23402.984452,20759.25304,-2643.731412,7041.450272,6853.435248,-188.015024,8520.276414,8745.636018,225.359604000001,31824.496562,26949.159052,-4875.33751,27940.68231,23133.291211,-4807.391099,4324.901945,1932.05803,-2392.843915,39705.400484,20414.331937,-19291.068547,121358.70439,87847.9631000001,-33510.74129,47780.284574,25016.295146,-22763.989428,1476.305795,1656.639217,180.333422,965.747685,2070.378542,1104.630857,3365.568738,1149.423631,-2216.145107,2.3149,1.114125,-1.200775,17894.887325,16924.445716,-970.441609000005,0,0.030976,0.030976,13929.609237,10024.713336,-3904.895901,286.269291,361.743598,75.4743070000001,5.548896,19.694751,14.145855,162.013175,180.11806,18.104885,296.942057,291.889367,-5.05268999999998,132.50059,59.294688,-73.205902,284.665777,327.344164,42.678387,18.964503,274.338607,255.374104,0.505823,97.400977,96.895154,43.497782,196.414192,152.91641,0.0055,58.913767,58.908267,32.697464,95.93556,63.238096,0.819858,22.291882,21.472024,0.67186,48.65141,47.97955,44.432994,84.433725,40.000731,313.914905,436.24934,122.334435,0.659471,4.581719,3.922248,0.844501,11.529135,10.684634,3.53188,6.957042,3.425162,1.908208,10.827121,8.918913,0.017025,0.54832,0.531295,0.146974,6.045975,5.899001,1.767805,9.507556,7.739751,0.03493,8.021474,7.986544,0.445355,4.381689,3.936334,3.334523,34.608461,31.273938,426.587249,172.647032,-253.940217,35.316657,178.516273,143.199616,,,,,,,215.857904,33.529185,-182.328719,0.043434,7.96005,7.916616,0.0826,7.304914,7.222314,793.478688,820.914199,27.4355109999999,1890.254319,990.409195,-899.845123999999,9.139369,24.725994,15.586625,14.821959,30.91525,16.093291,0.003099,0.930946,0.927847,400.55592,268.682768,-131.873152,331.589219,369.586329,37.9971099999999,50.71678,37.276572,-13.440208,716.704017,637.947827,-78.7561900000001,1590.651992,1962.589952,371.93796,4.445506,103.410451,98.964945,23.971661,45.716884,21.745223,378.027069,400.724651,22.6975820000001,1.887825,0.124966,-1.762859,21.93551,45.51029,23.57478,764.805992,452.065429,-312.740563,0,0.048145,0.048145,496.872109,232.135489,-264.73662,406.929686,144.265682,-262.664004,4.576815,1.356296,-3.220519,497.958386,174.665523,-323.292863,3577.355593,4374.558595,797.203002,2603.422281,741.460214,-1861.962067,1299.774723,2829.115806,1529.341083,1191.150964,1820.096636,628.945672,21.51065,106.567395,85.056745,0.052583,4.143223,4.09064,1.569586,1.788454,0.218868000000001,3178.147256,2260.58849,-917.558766,5948.773396,3771.236864,-2177.536532,629.972225,194.318599,-435.653626,,,,163.923276,94.569762,-69.353514,48.325201,17.820706,-30.504495,157.601221,112.902029,-44.699192,13.972675,1.545746,-12.426929,1280.166727,1758.007982,477.841255,8.139829,23.795526,15.655697,24.333162,19.061839,-5.27132300000001,37.903784,33.891251,-4.012533,197.054432,229.210421,32.1559889999999,,,,1374.302117,420.527128,-953.774989,73.858984,21.024397,-52.834587,15.168864,97.306671,82.137807,4.656696,10.738907,6.082211,95.673024,19.30764,-76.365384,1.017048,31.945761,30.928713,88.295603,81.417456,-6.878147,0.772839,9.845517,9.072678,0.294868,5.322034,5.027166,0.025578,1.135918,1.11034,1.921775,20.529232,18.607457,14.365391,11.970462,-2.394929,710.879204,925.130035,214.250831,135.958956,116.185476,-19.77348,0.000251,70.297923,70.297672,17.695497,19.049745,1.354248,0.096878,0.068158,-0.02872,0.00689,0.112829,0.105939,2246.285508,1080.793565,-1165.491943,,,,17.123633,14.386127,-2.73750600000001,38.582887,18.138613,-20.444274,1.483556,2.320898,0.837342,8.762658,1.725459,-7.037199,,,,4.349499,7.134107,2.784608,0,0.424849,0.424849,0.073638,3.46257,3.388932,1.210142,1.527175,0.317033,103.04385,171.269978,68.226128,74.220213,66.114057,-8.10615599999998,30.977029,29.016275,-1.96075400000001,302.005386,422.068596,120.06321,1.345786,8.267261,6.921475,18.582872,27.727634,9.144762,4.160707,120.380857,116.22015,614.061697,201.92303,-412.138667,5.651986,45.020643,39.368657,486.4,539.7,53.3000000000001,0,0,0,0.087824,0.052227,-0.035597,73.919439,98.561698,24.642259,123.202619,195.185833,71.983214,,,,1282.667508,926.39991,-356.267598,67.617755,399.121005,331.50325,89.805212,1304.954297,1215.149085,0.410823,49.667795,49.256972,100.085939,103.885299,3.79936000000001,37.679878,57.328647,19.648769,3.516796,131.746853,128.230057,1773.026146,1123.534605,-649.491541,237.400975,141.381264,-96.019711,4.321064,1.721167,-2.599897,355.997986,46.416226,-309.58176,155.639705,51.232535,-104.40717,0,0.432392,0.432392,1535.598641,514.819375,-1020.779266,827.967679,290.911424,-537.056255,4.337385,0.591201,-3.746184,180.668289,10.723109,-169.94518,1635.274421,666.660546,-968.613875,1321.394995,1741.080532,419.685537,1037.928769,397.237915,-640.690854,0.00044,0.016895,0.016455,4.723402,7.534785,2.811383,547.137052,421.221193,-125.915859,21.914684,17.115041,-4.799643,0.080826,0.117353,0.036527,0.376423,0.774004,0.397581,21224.713513,5579.259023,-15645.45449,0.8811,4.094743,3.213643,0,0,0,3185.313261,2030.613157,-1154.700104,285.888023,1827.436524,1541.548501,2248.853993,1254.305035,-994.548958,7245.639873,4439.840461,-2805.799412,682.936836,1833.178214,1150.241378,0.000599,0.126014,0.125415,0.009881,0.101738,0.091857,0.009325,0.080002,0.070677,0.000054,0.729516,0.729462,5.971918,34.10993,28.138012,257.709744,164.739581,-92.970163,0.029487,0.079941,0.050454,0.275539,1.485759,1.21022,0,0.109394,0.109394,0.370089,0.8964,0.526311,0.11476,0.413513,0.298753,0.308066,0.243557,-0.064509,0,0.001132,0.001132,0.300103,0.067362,-0.232741,0,0.061238,0.061238,0.711771,11.808686,11.096915,0,0.011487,0.011487,3.977189,10.755737,6.778548,0.954146,2.006536,1.05239,0.178079,4.490516,4.312437,0,1.138211,1.138211,0.00462,0.109749,0.105129,11.459868,3.499782,-7.960086,0.402885,0.498678,0.0957929999999999,51.432751,128.087498,76.654747,640.936798,90.113064,-550.823734,27.201238,21.448748,-5.75249000000001,244.966079,35.509784,-209.456295,160.637075,477.772438,317.135363,0.4015,1.660675,1.259175,,,,0,0.098257,0.098257,151.91869,14.767844,-137.150846,0.054091,2.859643,2.805552,41.105042,9.49358,-31.611462,0.53456,7.561679,7.027119,0.104826,3.296538,3.191712,2.01247,9.07064,7.05817,1.776751,2.781799,1.005048,75.619137,13.074953,-62.544184,9.102115,37.212955,28.11084,0,2.460512,2.460512,0.872804,2.263879,1.391075,0.122732,5.336062,5.21333,1254.026245,327.173198,-926.853047,0.080812,1.058915,0.978103,151.465466,12.872518,-138.592948,101.985662,3.228948,-98.756714,0.058289,0.043205,-0.015084,0.049455,2.471496,2.422041,0.048917,19.08439,19.035473,854.576435,136.996312,-717.580123,130.115366,17.483228,-112.632138,0,0.054974,0.054974,0.126581,0.260184,0.133603,0,0.129041,0.129041,9.627857,15.482109,5.854252,29.097681,6.73783,-22.359851,0.197656,0.223025,0.025369,1.269303,1.02641,-0.242893,0.006847,2.70286,2.696013,1.770361,9.151998,7.381637,0.01071,0.399314,0.388604,0.047879,22.71695,22.669071,3.313579,3.062915,-0.250664,26.128404,46.673069,20.544665,0.706647,0.927022,0.220375,0,0.176906,0.176906,4.409522,11.274986,6.865464,14.041005,2.31299,-11.728015,0.729912,7.655591,6.925679,22.001127,9.977007,-12.02412,0.000054,0.114762,0.114708,0.174998,0.007296,-0.167702,0.460634,0.357596,-0.103038,0,0.121595,0.121595,415.10351,341.623783,-73.4797270000001,3.429843,7.337279,3.907436,6.145831,5.207285,-0.938546000000001,3.82713,3.183241,-0.643888999999998,11.986637,1.164973,-10.821664,1.052175,3.544547,2.492372,5.452025,2.298517,-3.153508,25.688905,10.170577,-15.518328,0,0,0,,,
2009-04-01,7631.575492,4076.795891,-3554.779601,23216.887789,17764.030375,-5452.85741400001,120572,81088,-39484,8610.134001,0,-8610.134001,8206.106192,5552.947212,-2653.15898,23417.177234,18703.260877,-4713.916357,6837.214367,6556.416464,-280.797903,7887.103519,8010.752857,123.649337999998,30926.872542,25722.489298,-5204.38324400001,27210.148893,20499.457248,-6710.69164500001,4289.684972,1978.779263,-2310.905709,39686.788828,18633.534212,-21053.254616,118895.823827,80822.4531680001,-38073.3706589999,47658.248128,23116.804816,-24541.443312,1323.357364,1483.140466,159.783102,923.202543,1486.769762,563.567219,2955.450992,1263.95477,-1691.496222,0.505051,0.644271,0.13922,17211.156464,16151.087373,-1060.069091,0.058179,0.022057,-0.036122,13715.716078,9571.401925,-4144.314153,272.368852,272.591171,0.22231899999997,9.431972,22.638102,13.20613,121.718748,160.815233,39.096485,228.005429,257.745282,29.739853,127.954823,45.935666,-82.019157,291.498154,324.100691,32.602537,18.910072,247.636879,228.726807,0.62815,53.311373,52.683223,61.522289,168.163997,106.641708,0,54.324153,54.324153,33.376827,108.925651,75.548824,1.06364,21.942857,20.879217,1.238925,46.028834,44.789909,43.610408,67.240041,23.629633,281.811358,421.952423,140.141065,0.685083,5.402634,4.717551,0.474105,17.050699,16.576594,6.13719,9.534924,3.397734,1.199608,13.885972,12.686364,0.030128,0.327932,0.297804,0.106192,9.348463,9.242271,1.248719,12.043376,10.794657,0.135082,8.332673,8.197591,0.427479,3.506805,3.079326,3.465079,33.433035,29.967956,353.002279,150.322713,-202.679566,43.185432,102.866156,59.680724,,,,,,,147.468709,26.537604,-120.931105,0.265929,18.258115,17.992186,0.009416,29.227811,29.218395,966.131205,663.700451,-302.430754,1745.404415,778.108621,-967.295794,13.215718,20.619927,7.404209,14.201518,25.908115,11.706597,0,0.952349,0.952349,472.010532,268.56051,-203.450022,331.646458,334.664723,3.01826499999999,26.869994,24.685324,-2.18467,507.953166,811.849774,303.896608,1400.249739,1848.767177,448.517438,3.798154,100.37612,96.577966,17.159426,49.693355,32.533929,337.473621,369.419631,31.94601,0.009496,0.015515,0.006019,13.725932,33.834335,20.108403,723.246124,371.094116,-352.152008,0,0.072706,0.072706,523.877931,273.259935,-250.617996,412.723386,143.236977,-269.486409,3.603258,0.301404,-3.301854,513.716729,159.974781,-353.741948,3847.565522,3561.200391,-286.365131000001,2755.045628,648.234096,-2106.811532,1247.586745,3052.167772,1804.581027,1181.48623,1644.020228,462.533998,23.099059,91.275272,68.176213,0.042351,0.333189,0.290838,1.208525,1.451173,0.242648,2808.567074,2376.306467,-432.260607000001,5457.994974,3223.309714,-2234.68526,650.755677,152.873312,-497.882365,,,,159.667136,82.553202,-77.113934,64.87423,24.410365,-40.463865,187.614156,99.978767,-87.635389,11.662868,1.504287,-10.158581,1261.579006,1163.170478,-98.4085279999999,7.750906,11.193924,3.443018,8.043363,27.949684,19.906321,43.601928,22.264977,-21.336951,189.431433,145.529141,-43.902292,,,,1525.53496,313.813264,-1211.721696,40.417668,18.217979,-22.199689,36.02503,37.121648,1.09661799999999,5.12242,2.401836,-2.720584,211.566362,10.987949,-200.578413,1.682622,54.988408,53.305786,90.127469,40.063037,-50.064432,0.530882,1.903429,1.372547,0.413133,1.095345,0.682212,0.007433,1.635761,1.628328,1.874424,14.829511,12.955087,0.765998,16.386457,15.620459,656.245161,541.352029,-114.893132,88.228406,80.771542,-7.45686400000002,0.3,79.791995,79.491995,15.770756,12.87247,-2.898286,0.024801,2.986125,2.961324,0,0.715748,0.715748,2001.014263,1006.377804,-994.636459,,,,21.286252,14.504394,-6.78185800000001,29.169157,13.017092,-16.152065,1.567124,2.647834,1.08071,2.164191,2.430126,0.265935,,,,4.540096,10.218477,5.678381,0.01584,0.07506,0.05922,0.186387,3.995369,3.808982,0.844075,4.533464,3.689389,76.508108,145.57465,69.066542,51.338889,48.363318,-2.97557100000001,14.380793,28.540004,14.159211,232.564066,626.15615,393.592084,1.461956,49.58828,48.126324,18.377842,22.660598,4.282756,4.477312,161.277813,156.800501,611.99561,159.331434,-452.664176,6.85445,35.75344,28.89899,433.6,474.7,41.1,0,0,0,0.043279,0.01868,-0.024599,70.4112,135.385793,64.974593,255.656546,132.55404,-123.102506,,,,1588.320744,1018.497698,-569.823046,66.924847,143.848266,76.923419,137.390223,904.598412,767.208189,0.622287,28.016675,27.394388,27.584755,108.655132,81.070377,38.646242,50.544716,11.898474,2.808851,89.075209,86.266358,1799.196098,1268.823743,-530.372355,234.018689,158.632749,-75.3859400000001,4.216967,4.032155,-0.184812000000001,313.563955,43.354267,-270.209688,146.368437,11.03903,-135.329407,0.085916,0.433453,0.347537,1290.71913,504.90079,-785.81834,882.149367,251.433149,-630.716218,2.960231,0.861826,-2.098405,135.816447,9.040281,-126.776166,1596.84805,743.355669,-853.492381000001,1227.964283,1570.070803,342.10652,981.179883,470.392875,-510.787008,0,0.333057,0.333057,4.040119,8.51581,4.475691,486.164268,395.470377,-90.6938910000002,23.310773,20.022201,-3.28857200000001,0.015084,0.083253,0.068169,0.376603,0.880735,0.504132,21920.595248,5161.442609,-16759.152639,0.066597,3.458645,3.392048,0,0.141068,0.141068,3090.798648,2055.412959,-1035.385689,260.527581,1670.75077,1410.223189,2257.923855,1260.181932,-997.741923,6932.339419,3824.826778,-3107.512641,687.103684,1285.911895,598.808211,0,0.112857,0.112857,0.020324,0.005628,-0.014696,0.006498,0.035305,0.028807,0.0032,0.862019,0.858819,5.726812,25.859979,20.133167,212.266205,141.319555,-70.94665,0.059013,0.126752,0.067739,0.179561,1.53474,1.355179,0.012143,0.009416,-0.002727,0.443493,0.892632,0.449139,0.07313,0.38587,0.31274,0.103564,0.544498,0.440934,0.00065,0,-0.00065,0.089978,0.036036,-0.053942,0.000217,0.023292,0.023075,3.704447,8.32572,4.621273,0,0,0,2.089473,8.879559,6.790086,0.7473,2.673004,1.925704,0.276184,3.71107,3.434886,0,0.859674,0.859674,0.009157,0.034806,0.025649,9.795947,3.342083,-6.453864,0.49563,0.641874,0.146244,42.43691,172.364708,129.927798,883.590309,82.054276,-801.536033,41.339114,28.180964,-13.15815,131.008066,77.934043,-53.074023,158.409696,367.630921,209.221225,1.145834,7.437747,6.291913,,,,0,0.005501,0.005501,121.289089,13.433523,-107.855566,0.002144,2.838994,2.83685,14.951003,11.661921,-3.289082,0.378024,6.96801,6.589986,0.338556,4.184995,3.846439,7.713979,9.190212,1.476233,1.371006,4.65142,3.280414,46.41917,21.588826,-24.830344,5.247107,39.35048,34.103373,0.001242,3.815644,3.814402,0.10717,1.762653,1.655483,0.041336,11.951746,11.91041,1049.756603,342.029549,-707.727054,0.157925,8.967761,8.809836,70.815771,13.326782,-57.488989,162.364293,7.120767,-155.243526,2.297673,0.074495,-2.223178,0.423393,1.192706,0.769313,0.05981,14.735734,14.675924,608.732022,147.675683,-461.056339,168.321271,18.367436,-149.953835,0,0.143301,0.143301,0.076862,0.225509,0.148647,0,0.119027,0.119027,5.967647,11.227949,5.260302,34.00234,4.608618,-29.393722,0.227982,0.214282,-0.0137,1.330072,0.431149,-0.898923,0.000437,0.141503,0.141066,3.482006,15.301025,11.819019,0,0.051587,0.051587,0.087903,5.071125,4.983222,1.884663,7.73241,5.847747,27.165417,43.40057,16.235153,0.11888,25.755106,25.636226,0,0.138296,0.138296,5.791689,14.647295,8.855606,13.323481,2.498997,-10.824484,0.748782,19.914655,19.165873,19.618181,2.495689,-17.122492,0,2.86499,2.86499,0.004504,0.000121,-0.004383,1.221087,0.570967,-0.65012,0,0.020403,0.020403,486.23279,385.02978,-101.20301,43.393385,20.536752,-22.856633,7.632937,3.486466,-4.146471,0.175751,5.198788,5.023037,8.515604,1.484369,-7.031235,0.073349,2.25719,2.183841,4.553905,1.452291,-3.101614,26.211746,0.004885,-26.206861,0,6.733596,6.733596,,,
2009-05-01,7847.126948,3716.930982,-4130.195966,20748.757642,17915.52191,-2833.235732,118736,83369,-35367,7907.566534,0,-7907.566534,7757.553537,5794.140328,-1963.413209,22769.423604,19151.813939,-3617.609665,6889.752918,7130.638906,240.885988,8307.131852,8767.307198,460.175346000002,29716.327825,25487.996603,-4228.33122199999,24840.87272,21620.757678,-3220.11504199999,3969.070922,1732.32462,-2236.746302,39924.890241,20055.020526,-19869.869715,116341.492649,83651.049988,-32690.442661,48643.718652,24308.299163,-24335.419489,1386.673659,1626.172918,239.499259,863.956603,1726.236822,862.280219,3148.531982,1022.841407,-2125.690575,0.148083,0.950337,0.802254,16398.797057,16090.388065,-308.408991999997,0.265992,0.029225,-0.236767,13317.530768,9397.608538,-3919.92223,285.631929,296.941674,11.309745,10.93271,19.075304,8.142594,141.209294,175.748419,34.539125,275.161593,282.964833,7.80324000000002,128.972494,64.786994,-64.1855,291.428394,393.888965,102.460571,23.066452,313.636255,290.569803,0.59684,61.361462,60.764622,57.111143,181.495852,124.384709,0,46.074668,46.074668,37.911463,123.290488,85.379025,1.508203,22.818099,21.309896,1.255808,45.886656,44.630848,51.604101,77.396524,25.792423,264.269955,411.842033,147.572078,0.438858,4.348926,3.910068,0.436089,25.649665,25.213576,4.517878,8.271422,3.753544,0.162309,11.549082,11.386773,0.083979,0.577125,0.493146,0.193926,6.207635,6.013709,1.227629,10.972737,9.745108,0.062864,5.381925,5.319061,1.301267,4.982267,3.681,2.492106,30.991999,28.499893,462.505645,162.526048,-299.979597,38.072605,162.330118,124.257513,,,,,,,188.227264,49.237029,-138.990235,0.500108,11.502512,11.002404,0.096643,33.573908,33.477265,795.443618,675.369031,-120.074587,2149.632065,832.052835,-1317.57923,13.765392,26.52376,12.758368,12.617012,31.385516,18.768504,0,0.955116,0.955116,414.716108,297.294857,-117.421251,291.588874,381.147516,89.5586420000001,20.420493,29.084199,8.663706,419.739286,829.889612,410.150326,1540.388725,1999.835685,459.44696,3.615235,89.988036,86.372801,16.091409,50.792826,34.701417,358.130416,477.628422,119.498006,0.00367,0.049163,0.045493,25.444529,19.96974,-5.474789,593.164744,360.332038,-232.832706,0,0.106373,0.106373,480.928278,262.057298,-218.87098,357.160515,121.04977,-236.110745,3.91888,0.238338,-3.680542,395.4489,165.627616,-229.821284,3458.549075,3329.055215,-129.49386,2343.361679,722.00547,-1621.356209,1256.147512,2805.236352,1549.08884,984.836422,1889.388513,904.552091,12.278154,137.511903,125.233749,0.003976,0.266717,0.262741,23.255678,0.801467,-22.454211,2515.40901,1987.086747,-528.322262999999,4932.772765,3656.233435,-1276.53933,450.208654,160.535324,-289.67333,,,,141.52061,87.11558,-54.40503,43.731015,23.563075,-20.16794,232.09299,92.748977,-139.344013,15.673163,1.636352,-14.036811,1241.771262,1910.473988,668.702726,7.791949,10.372502,2.580553,9.463493,19.930565,10.467072,28.436248,26.001668,-2.43458,139.172883,144.943178,5.77029499999995,,,,1803.510752,478.777996,-1324.732756,71.989844,3.275424,-68.71442,32.771624,75.443665,42.672041,5.993914,5.841849,-0.152065,37.480912,24.671484,-12.809428,1.733186,24.364846,22.63166,61.029042,52.529777,-8.49926499999998,0.008251,1.309292,1.301041,0.405768,1.016636,0.610868,0,1.372835,1.372835,3.530892,39.405418,35.874526,19.162924,9.787366,-9.375558,634.763199,705.25445,70.4912510000001,93.885462,60.011487,-33.873975,0.007593,156.972565,156.964972,19.210801,28.705967,9.495166,0.035618,0.172943,0.137325,0.06705,1.060119,0.993069,1932.681056,1001.770538,-930.910518,,,,17.431516,8.509035,-8.922481,27.981161,11.575717,-16.405444,2.557897,1.672757,-0.88514,0.893066,2.581922,1.688856,,,,4.010551,8.131713,4.121162,0.09597,0.299443,0.203473,0.103234,4.594967,4.491733,3.225491,4.325324,1.099833,70.029151,310.052887,240.023736,54.422104,34.86037,-19.561734,13.22089,18.033908,4.813018,235.074217,603.568119,368.493902,1.0172,6.518658,5.501458,27.337102,26.722067,-0.61503500000001,11.303409,142.157006,130.853597,675.83728,164.073179,-511.764101,3.690199,25.054629,21.36443,533.5,524.1,-9.39999999999998,1.205209,0,-1.205209,0.013852,0.03264,0.018788,61.513577,116.070976,54.557399,162.29216,130.762629,-31.529531,,,,1827.619953,759.560068,-1068.059885,36.656789,81.312977,44.656188,142.892704,939.014725,796.122021,0.297261,33.295066,32.997805,231.757719,54.672588,-177.085131,54.137951,40.305812,-13.832139,14.816419,90.483468,75.667049,1580.832009,1507.475759,-73.35625,271.616823,264.929789,-6.68703399999998,4.350956,3.258994,-1.091962,282.257184,41.779437,-240.477747,99.494865,18.680977,-80.813888,0,1.562861,1.562861,1373.841378,468.771504,-905.069874,984.209441,248.813813,-735.395628,4.366103,0.467239,-3.898864,125.461753,10.098978,-115.362775,1742.134735,784.545485,-957.589249999999,1176.598743,1471.769117,295.170374,1040.166803,453.182406,-586.984397,0,0.137523,0.137523,4.310161,7.859379,3.549218,518.734935,441.466921,-77.2680139999999,21.815172,15.382792,-6.43238,0.01825,0.16234,0.14409,0.010192,1.123361,1.113169,22734.147846,5256.018098,-17478.129748,0.141438,5.37619,5.234752,0,0,0,3191.768624,2466.488689,-725.279935,275.622242,1803.000648,1527.378406,2245.763309,1389.380452,-856.382857,6144.98128,4270.519343,-1874.461937,582.282262,1528.189222,945.906960000001,0,0.014404,0.014404,0.041537,0.059563,0.018026,0.015826,0.009743,-0.006083,0,0,0,4.97964,8.07624,3.0966,241.584489,159.141734,-82.442755,0.03252,0.170456,0.137936,13.076549,1.169923,-11.906626,0,0.091561,0.091561,0.39803,3.828824,3.430794,0.053335,0.20385,0.150515,0.048976,0.683541,0.634565,0.000175,0.00105,0.000875,0.06961,0.045158,-0.024452,0.00013,0.064022,0.063892,1.556306,5.472951,3.916645,0.003018,0.025992,0.022974,4.18846,7.648499,3.460039,0.580357,1.905649,1.325292,0.246647,3.797609,3.550962,0,1.502652,1.502652,0,0.242908,0.242908,14.472022,2.030084,-12.441938,0.330037,1.011344,0.681307,34.720658,148.606919,113.886261,449.734574,91.579433,-358.155141,34.185622,35.659392,1.47376999999999,212.20249,52.777215,-159.425275,152.803406,368.042329,215.238923,1.749045,0.443966,-1.305079,,,,0,0.000064,0.000064,157.310118,16.239552,-141.070566,0.017639,3.913961,3.896322,27.842234,10.048924,-17.79331,0.52729,11.588757,11.061467,0.620881,3.223854,2.602973,6.309484,11.538735,5.229251,2.755865,2.369012,-0.386853,58.639244,12.808316,-45.830928,6.050142,61.153888,55.103746,0.007882,3.12661,3.118728,0.023305,2.027482,2.004177,0.655353,14.195616,13.540263,1074.845895,249.856674,-824.989221,0.045951,1.975731,1.92978,52.865612,19.016066,-33.849546,143.139119,4.275497,-138.863622,0.009283,0.286426,0.277143,0.071767,0.919458,0.847691,0.022261,8.665837,8.643576,760.506941,81.796128,-678.710813,280.952127,24.884063,-256.068064,0,0.110507,0.110507,0.020811,0.23876,0.217949,0.004708,0.07854,0.073832,3.516282,5.64514,2.128858,1.764176,7.565393,5.801217,0.533719,0.364134,-0.169585,1.187288,2.698874,1.511586,0.024085,0.17708,0.152995,3.811271,25.970023,22.158752,0.030048,0.137503,0.107455,0.059576,16.3363,16.276724,2.714756,7.5395,4.824744,14.360926,36.357069,21.996143,0.654013,0.995383,0.34137,0.06546,0.229439,0.163979,4.031671,7.973964,3.942293,12.3693,2.385949,-9.983351,1.547712,19.680671,18.132959,24.146818,15.256467,-8.890351,0.000498,0.270477,0.269979,0.001383,0,-0.001383,0.317657,0.474429,0.156772,0,0.031934,0.031934,442.362045,325.695806,-116.666239,12.549796,8.334079,-4.215717,7.538286,1.497059,-6.041227,0.396822,3.025145,2.628323,6.580242,1.211073,-5.369169,0.730422,4.190822,3.4604,4.109902,2.126924,-1.982978,19.115768,0.042456,-19.073312,0,7.148342,7.148342,,,
2009-06-01,9625.768098,3773.785704,-5851.982394,23136.819795,18671.621086,-4465.198709,122156,85737,-36419,7771.92172,0,-7771.92172,9235.986121,6139.266506,-3096.719615,25325.310261,20741.217422,-4584.092839,6987.38841,7380.169297,392.780886999997,9317.012056,8920.873596,-396.13846,32560.907777,27364.006454,-5196.90132299999,27254.135225,21843.934945,-5410.20028,5048.671598,2002.829903,-3045.841695,42970.892992,20420.073481,-22550.819511,127173.227421,86829.51161,-40343.7158109999,52181.927072,24912.72925,-27269.197822,1626.165077,1675.386085,49.2210079999995,809.406381,1784.398915,974.992534,3776.842656,1292.897239,-2483.945417,0.910063,0.73595,-0.174113,18549.455561,16817.076012,-1732.37954899999,0.257249,0.002597,-0.254652,14011.452216,10546.930442,-3464.521774,263.452025,324.587491,61.135466,15.996583,24.553804,8.557221,163.027424,160.271005,-2.75641899999999,286.856155,270.355796,-16.500359,129.119774,61.348975,-67.770799,485.986118,415.389773,-70.596345,29.790517,349.32864,319.538123,0.767976,67.621298,66.853322,46.369085,194.140696,147.771611,0,23.969566,23.969566,46.639489,108.89102,62.251531,0.424254,22.352139,21.927885,0.53673,53.16398,52.62725,56.42163,57.566047,1.14441699999999,297.723581,443.433045,145.709464,0.887393,4.591898,3.704505,0.282774,10.534936,10.252162,4.058384,6.788947,2.730563,0.659008,11.083373,10.424365,0.004517,0.624662,0.620145,0.076637,8.870709,8.794072,1.139616,11.613377,10.473761,0.165195,5.52591,5.360715,0.826455,4.774762,3.948307,2.377451,28.966823,26.589372,371.171673,154.402621,-216.769052,36.987787,186.75338,149.765593,,,,,,,181.013793,23.440055,-157.573738,0.044763,20.727567,20.682804,0.00838,28.724285,28.715905,1013.130378,715.056953,-298.073425,2499.641533,712.452223,-1787.18931,15.022681,26.514254,11.491573,15.549292,60.610092,45.0608,0,2.141718,2.141718,443.529038,292.61598,-150.913058,346.886989,410.525214,63.638225,41.593741,32.289974,-9.30376700000001,346.15126,716.346224,370.194964,1783.835635,2088.62459,304.788955,2.42492,114.549267,112.124347,19.307022,76.911614,57.604592,364.656272,587.780576,223.124304,2.468128,0.058337,-2.409791,14.565227,25.425481,10.860254,647.752602,379.976529,-267.776073,0,0.056691,0.056691,631.901352,232.408328,-399.493024,385.179642,135.695394,-249.484248,6.071306,0.37884,-5.692466,502.878177,172.492241,-330.385936,3752.58846,4199.993527,447.405067000001,2373.408166,688.972921,-1684.435245,1434.848022,2544.776941,1109.928919,995.059493,1874.713439,879.653946,24.905973,66.092207,41.186234,0.028676,0.463098,0.434422,2.85731,2.093326,-0.763984,3013.47068,2457.531468,-555.939211999999,5513.498242,3181.328804,-2332.169438,490.343824,150.435697,-339.908127,,,,142.263768,66.6077,-75.656068,38.747569,15.828987,-22.918582,205.484051,111.843518,-93.640533,16.22391,1.405802,-14.818108,1184.645704,1339.700209,155.054505,31.642337,10.355615,-21.286722,10.885885,26.517954,15.632069,69.228135,25.605621,-43.622514,172.957379,193.345337,20.387958,,,,1626.233851,555.781229,-1070.452622,67.830561,4.714259,-63.116302,15.054207,47.932402,32.878195,7.117557,3.830949,-3.286608,158.030247,12.665818,-145.364429,2.340962,27.833279,25.492317,92.842817,50.103467,-42.73935,0.755898,3.936622,3.180724,0.474138,2.263784,1.789646,0.006529,11.160705,11.154176,3.042553,17.87645,14.833897,0.664012,4.9481,4.284088,729.793518,743.898968,14.10545,125.806688,100.621965,-25.184723,0.033626,75.350063,75.316437,17.72182,5.2105,-12.51132,0.025484,0.079902,0.054418,0.004786,0.052664,0.047878,2300.00718,1150.434624,-1149.572556,,,,16.739879,17.897133,1.157254,30.300488,11.778618,-18.52187,2.525639,1.828893,-0.696746,0.821308,2.819506,1.998198,,,,5.430329,12.806489,7.37616,0.056793,0.157424,0.100631,1.289066,4.3302,3.041134,0.457786,6.420594,5.962808,52.334312,283.740053,231.405741,58.188444,50.830898,-7.35754599999999,15.829298,12.473919,-3.35537899999999,259.243917,705.592152,446.348235,1.695642,10.517641,8.821999,2.311437,29.32801,27.016573,5.04439,169.995035,164.950645,815.290838,187.370086,-627.920752,3.899852,19.52655,15.626698,493.8,554.3,60.4999999999999,0.498271,0,-0.498271,0.05277,0.09103,0.03826,67.618182,83.937614,16.319432,385.202362,128.578819,-256.623543,,,,1704.216647,775.951193,-928.265454,30.401461,99.330833,68.929372,178.591884,969.512548,790.920664,1.758632,46.210452,44.45182,150.248995,133.035626,-17.213369,22.143766,81.809377,59.665611,11.523046,115.56907,104.046024,1564.243303,1397.912798,-166.330505,286.7179,138.676195,-148.041705,4.864275,1.843737,-3.020538,294.298876,36.870009,-257.428867,110.019372,11.63229,-98.387082,0,1.570277,1.570277,1475.84798,579.907652,-895.940328,1042.495608,270.596755,-771.898853,2.951606,0.432028,-2.519578,143.252541,12.172847,-131.079694,1888.972889,840.727589,-1048.2453,1268.38577,1791.588313,523.202542999999,1036.645764,415.769936,-620.875828,0,0.094694,0.094694,2.992154,6.725183,3.733029,481.496663,458.824951,-22.671712,16.562454,21.242568,4.680114,0,0.115288,0.115288,0.029136,1.413201,1.384065,23972.774237,5548.574581,-18424.199656,0.30745,2.73293,2.42548,0,0,0,3287.363,2375.768211,-911.594789,291.22738,1639.960886,1348.733506,2140.41226,1572.851887,-567.560373,7792.142071,3992.691376,-3799.450695,558.478515,1515.774038,957.295523,0.273356,0.034219,-0.239137,0.060678,0.016755,-0.043923,0.007288,0.018679,0.011391,0.000051,0.190035,0.189984,5.391923,22.350984,16.959061,228.047912,217.222978,-10.824934,0.009277,0.416829,0.407552,0.545192,1.500189,0.954997,0.006918,0.087376,0.080458,0.275924,1.613722,1.337798,0.076804,0.596626,0.519822,0.077441,0.185453,0.108012,0,0,0,0.066192,0.032146,-0.034046,0,0.002775,0.002775,1.47012,5.231341,3.761221,0.012604,0.220829,0.208225,1.512719,9.4034,7.890681,0.664796,1.625318,0.960522,0.314486,3.427865,3.113379,0,0.972233,0.972233,0.001119,0.027004,0.025885,11.914203,1.789237,-10.124966,0.197602,1.073545,0.875943,35.933398,86.912927,50.979529,844.682312,92.858751,-751.823561,28.85947,53.122756,24.263286,313.322292,40.128815,-273.193477,189.031092,421.397527,232.366435,1.468004,1.118678,-0.349326,,,,0,0.005104,0.005104,193.328761,11.060647,-182.268114,0.082142,4.60797,4.525828,22.081292,11.105872,-10.97542,1.406261,13.145419,11.739158,0.131027,1.796303,1.665276,5.384072,9.057349,3.673277,6.564062,4.580926,-1.983136,47.10014,12.251206,-34.848934,25.822314,118.104269,92.281955,0.001352,4.925107,4.923755,18.662997,27.443188,8.780191,0.073433,15.070951,14.997518,1608.216375,346.593201,-1261.623174,0.061573,1.239971,1.178398,120.60256,6.289084,-114.313476,186.932924,3.74197,-183.190954,0.00505,0.006599,0.001549,0.024381,2.174465,2.150084,0.071767,11.877208,11.805441,938.791162,94.005614,-844.785548,88.963717,21.479777,-67.48394,0,0.153774,0.153774,0.01365,0.648696,0.635046,0.050853,0.109429,0.058576,5.015715,6.434922,1.419207,0.952404,5.465126,4.512722,0.099387,0.145315,0.045928,0.770096,2.278567,1.508471,0.019844,0.083616,0.063772,5.871068,110.186851,104.315783,0,0.017724,0.017724,0.046124,26.090629,26.044505,2.575635,4.396805,1.82117,28.531482,66.563737,38.032255,0.697252,0.640933,-0.056319,0.001979,0.114346,0.112367,3.49766,13.015675,9.518015,12.096527,2.041957,-10.05457,1.612296,11.398106,9.78581,20.806868,12.30406,-8.50280800000001,0,0.473891,0.473891,0.090096,0.376368,0.286272,0.011007,0.517584,0.506577,0,0.007164,0.007164,377.658413,351.969054,-25.689359,6.16216,8.742119,2.579959,11.800028,7.478962,-4.321066,0.431619,4.405142,3.973523,5.458518,0.50788,-4.950638,0.374114,11.251312,10.877198,2.692902,2.438853,-0.254049,18.526413,5.813601,-12.712812,0,0,0,,,
2009-07-01,10475.970345,3511.923728,-6964.046617,25180.302602,17089.075415,-8091.22718699999,129912,87833,-42079,8567.661927,0,-8567.661927,9243.140043,5740.370417,-3502.769626,26587.47051,19999.770316,-6587.700194,7404.131701,7695.740221,291.60852,10266.90005,8861.920071,-1404.979979,32845.04917,27584.41224,-5260.63693,30177.700023,20174.886188,-10002.813835,5613.970365,2054.876929,-3559.093436,45930.044921,20528.270344,-25401.774577,135695.817657,85634.748231,-50061.069426,55862.894694,25356.004806,-30506.889888,1862.597977,1676.461722,-186.136254999999,928.227706,1602.329448,674.101742,4213.555985,1284.949578,-2928.606407,0.907222,0.193449,-0.713773,18763.358402,16453.503769,-2309.854633,0.168427,0,-0.168427,14081.690768,11130.908471,-2950.782297,287.294992,311.865686,24.570694,4.334677,21.417795,17.083118,181.769643,168.774277,-12.995366,296.540781,294.246731,-2.29404999999986,144.689111,52.491576,-92.197535,660.018216,384.520374,-275.497842,27.538371,318.265443,290.727072,0.930825,54.011861,53.081036,56.1765,210.004365,153.827865,0.00206,40.040604,40.038544,53.797469,121.445239,67.64777,0.048824,20.380202,20.331378,0.807072,65.150026,64.342954,54.957581,72.98214,18.024559,292.285234,464.563078,172.277844,0.076956,3.380839,3.303883,0.240529,12.356023,12.115494,4.030092,8.373763,4.343671,0.666653,11.655008,10.988355,0.021994,0.59322,0.571226,0.527757,7.508121,6.980364,1.266961,11.16911,9.902149,0.256906,4.221888,3.964982,0.609552,5.1085,4.498948,3.113436,36.432148,33.318712,461.994701,172.785813,-289.208888,35.36121,150.797286,115.436076,,,,,,,107.338774,23.972144,-83.36663,0.026982,21.378828,21.351846,1.074847,18.368646,17.293799,1077.55308,752.557368,-324.995712,2898.385211,574.924134,-2323.461077,15.423875,16.360353,0.936477999999999,11.119141,30.381528,19.262387,0,3.425938,3.425938,502.959483,245.110748,-257.848735,358.289091,429.366013,71.0769220000001,25.519453,37.496396,11.976943,459.870521,784.60942,324.738899,1926.342927,2241.641566,315.298639,3.06684,114.849775,111.782935,18.225211,57.797458,39.572247,292.338564,485.046013,192.707449,0.007947,0.092627,0.08468,11.851709,29.534592,17.682883,664.864046,346.835111,-318.028935,0,0.014639,0.014639,453.102534,188.063673,-265.038861,324.507676,128.307249,-196.200427,4.496747,0.201166,-4.295581,577.271634,155.740156,-421.531478,4198.881707,3829.494498,-369.387208999999,2567.777148,495.315093,-2072.462055,1340.496667,2622.962999,1282.466332,1305.970031,1790.850326,484.880295,22.073439,107.349096,85.275657,0.02728,0.250535,0.223255,1.731423,0.912181,-0.819242,3176.341695,1875.501722,-1300.839973,6539.156944,3285.057875,-3254.099069,515.089356,140.809121,-374.280235,,,,179.654343,68.525054,-111.129289,47.094412,10.672056,-36.422356,176.154942,116.692959,-59.4619830000001,13.855255,1.461186,-12.394069,1348.628703,1464.48666,115.857957,14.468525,16.824579,2.356054,13.015569,18.432965,5.417396,28.75029,31.427141,2.67685100000001,173.648372,181.839036,8.190664,,,,2146.375019,510.450995,-1635.924024,75.655184,12.941687,-62.713497,33.397931,133.958342,100.560411,9.467237,6.537605,-2.929632,253.694642,15.092693,-238.601949,8.903426,19.864571,10.961145,276.000665,40.507775,-235.49289,0.077915,10.062184,9.984269,0.702675,4.294855,3.59218,0.154,0.315213,0.161213,3.686429,7.846747,4.160318,0.583683,10.179266,9.595583,614.305476,603.466332,-10.839144,122.542692,67.388848,-55.153844,0.1408,66.398573,66.257773,14.702331,25.57215,10.869819,0.057416,0.338343,0.280927,0.011181,1.264691,1.25351,2362.047004,918.569779,-1443.477225,,,,16.718744,13.561527,-3.157217,32.87496,11.475844,-21.399116,3.189886,1.933619,-1.256267,2.794691,3.505691,0.711000000000001,,,,8.199556,18.249882,10.050326,0.090376,0.390788,0.300412,1.491303,2.831183,1.33988,0.984829,7.651897,6.667068,49.485538,175.41868,125.933142,60.8709,36.666065,-24.204835,16.896831,20.57183,3.67499900000001,321.326182,512.708014,191.381832,41.360074,7.308851,-34.051223,25.493296,19.936703,-5.556593,8.261085,177.699855,169.43877,587.789444,176.853991,-410.935453,5.671656,11.016343,5.344687,660.9,448.1,-212.8,1.437502,0,-1.437502,0.186968,0.105246,-0.081722,86.122374,100.187678,14.065304,318.67707,124.771767,-193.905303,,,,2051.377841,858.330881,-1193.04696,45.268773,89.11098,43.842207,361.345261,845.954853,484.609592,0.449107,26.544311,26.095204,140.903286,54.394096,-86.50919,24.723964,58.171798,33.447834,16.785469,121.217796,104.432327,1824.845003,1657.994577,-166.850426,311.996618,122.183235,-189.813383,4.857298,1.35321,-3.504088,342.597307,30.127773,-312.469534,139.535928,11.229089,-128.306839,0,0.150342,0.150342,1550.796094,595.468804,-955.32729,1138.276532,301.270049,-837.006483,4.487216,8.358291,3.871075,172.045017,13.212308,-158.832709,2147.715259,952.836004,-1194.879255,1423.43638,2120.510634,697.074254,1052.478255,358.970743,-693.507512,0.012371,0.202032,0.189661,5.864632,13.260437,7.395805,552.384419,504.474829,-47.9095899999999,17.691421,19.19335,1.501929,0.056253,0.103599,0.047346,0.040157,2.330094,2.289937,25671.084409,5269.286701,-20401.797708,3.791677,2.460662,-1.331015,0,0.051047,0.051047,3393.934437,2392.278868,-1001.655569,278.680176,1547.61663,1268.936454,2308.080708,1635.334089,-672.746619,8167.821287,4145.224089,-4022.597198,660.033001,1393.761242,733.728241,0.011141,0.042156,0.031015,0,0.014458,0.014458,0.042322,0.018032,-0.02429,0,0.011453,0.011453,7.48983,8.504678,1.014848,243.350707,167.01805,-76.332657,0.008399,0.248726,0.240327,0.557405,2.54083,1.983425,0.000257,0.044653,0.044396,0.211611,2.245607,2.033996,0.071122,0.674391,0.603269,0.074092,0.203776,0.129684,0.002427,0,-0.002427,0.102773,0.029078,-0.073695,0,0.032431,0.032431,0.175602,5.079521,4.903919,0,0,0,2.382948,8.90034,6.517392,0.944037,1.88007,0.936033,0.227128,4.709988,4.48286,0.007516,1.043829,1.036313,0,0.205946,0.205946,12.317497,2.539039,-9.778458,0.213208,1.362942,1.149734,33.796145,170.346306,136.550161,874.312488,111.251601,-763.060887,26.642758,25.904333,-0.738424999999999,465.020653,34.612201,-430.408452,258.082079,409.851683,151.769604,0.578384,0.022771,-0.555613,,,,0,0.000085,0.000085,212.443998,13.675806,-198.768192,0.011328,3.005202,2.993874,4.017083,18.944972,14.927889,0.413345,8.470132,8.056787,0.768127,3.450829,2.682702,5.325855,8.210149,2.884294,2.877291,4.425748,1.548457,12.09922,12.629957,0.530736999999997,10.723657,64.993486,54.269829,0.000996,4.8291,4.828104,18.761217,1.941396,-16.819821,2.834583,16.440231,13.605648,1974.438155,325.251733,-1649.186422,0.253452,5.164203,4.910751,156.346944,32.488454,-123.85849,213.739289,4.004244,-209.735045,0.299789,0.151432,-0.148357,0.032546,1.824852,1.792306,0,66.107402,66.107402,649.225117,97.77532,-551.449797,350.795367,22.590534,-328.204833,0,0.136038,0.136038,0.008066,1.503444,1.495378,0.087351,0.051175,-0.036176,7.16346,6.896573,-0.266886999999999,1.378876,8.238263,6.859387,0.287122,0.809064,0.521942,0.898838,1.11498,0.216142,0,0.280346,0.280346,5.218252,63.864237,58.645985,0.00463,1.357569,1.352939,0.3443,17.809011,17.464711,1.453834,6.423535,4.969701,27.440869,28.863789,1.42292000000001,0.289789,1.455709,1.16592,0.000998,0.148271,0.147273,4.303494,10.840803,6.537309,16.520282,3.625491,-12.894791,0.272698,39.995886,39.723188,20.553389,10.300254,-10.253135,0,0.084181,0.084181,0.003779,0.009164,0.005385,0.648921,0.332587,-0.316334,0.111356,0.254757,0.143401,399.193364,352.224829,-46.968535,3.931355,33.46398,29.532625,32.892183,10.632756,-22.259427,0.33857,5.820389,5.481819,14.386821,0.897741,-13.48908,2.899239,9.76967,6.870431,2.957583,4.92167,1.964087,46.25219,0.1374,-46.11479,0,0.1251,0.1251,,,
2009-08-01,10053.943702,3693.173159,-6360.770543,22371.787756,16652.4659,-5719.32185600001,128770,87767,-41003,9190.18872,0,-9190.18872,10307.509272,6667.515223,-3639.994049,24147.51672,18516.016103,-5631.500617,7211.026485,7839.875206,628.848720999998,9099.695251,9218.221947,118.526696000001,34290.738663,28711.141315,-5579.59734799999,26077.34823,19797.080578,-6280.26765200002,5552.285729,2375.673579,-3176.61215,45779.705755,21227.950674,-24551.755081,131271.594586,87315.10033,-43956.494256,55460.995374,25207.42825,-30253.567124,1707.755346,1651.738716,-56.0166300000003,790.331616,1993.654887,1203.323271,4105.271486,1415.290145,-2689.981341,0.199183,0.488706,0.289523,19230.281091,17638.750654,-1591.530437,0.00054,0,-0.00054,15060.457572,11072.390661,-3988.066911,285.14151,333.67127,48.52976,3.356096,24.694124,21.338028,156.27883,162.14053,5.86170000000007,293.558259,267.52607,-26.0321890000001,143.185319,66.716651,-76.468668,552.152016,413.243836,-138.90818,25.068448,352.430765,327.362317,0.45967,41.034694,40.575024,81.76185,277.799688,196.037838,0,37.128203,37.128203,63.462917,94.646355,31.183438,0.280013,16.72843,16.448417,0.402822,51.931883,51.529061,50.786326,64.302071,13.515745,277.439412,408.440359,131.000947,0.461547,2.761846,2.300299,0.372791,25.646658,25.273867,3.572392,7.256164,3.683772,0.361969,12.930351,12.568382,0.008741,0.363864,0.355123,0.779985,5.255567,4.475582,1.843993,9.136164,7.292171,0.059925,5.969581,5.909656,0.480084,3.453154,2.97307,1.982813,31.577204,29.594391,433.869923,158.949065,-274.920858,20.681513,142.301657,121.620144,,,,,,,16.030488,22.541241,6.51075300000001,0.259721,24.099141,23.83942,0.0932,21.625596,21.532396,1011.082842,755.621237,-255.461605,2559.124146,675.193989,-1883.930157,14.665277,17.992452,3.327175,2.610945,24.441608,21.830663,0,1.408319,1.408319,412.967747,315.392685,-97.5750619999999,354.116366,503.326402,149.210036,50.32448,61.777169,11.452689,340.922276,713.199969,372.277693,1611.611317,2318.239746,706.628429,3.799674,124.255327,120.455653,19.569021,74.502882,54.933861,303.38461,546.502514,243.117904,1.323977,0.065466,-1.258511,10.354082,27.525172,17.17109,459.562353,452.287132,-7.2752210000001,0,0.000351,0.000351,308.095617,226.090025,-82.005592,277.172284,163.779244,-113.39304,5.716579,0.066129,-5.65045,459.006864,166.74878,-292.258084,4282.668115,3539.259512,-743.408602999999,2007.94461,424.089444,-1583.855166,1310.272951,2463.013594,1152.740643,846.740927,1680.664346,833.923419,22.983981,70.348244,47.364263,0.068331,0.31566,0.247329,1.421397,1.247816,-0.173581,2475.172243,1858.728206,-616.444037,5775.125671,3467.911952,-2307.213719,518.279159,160.397923,-357.881236,,,,151.107193,68.075173,-83.03202,50.649517,17.284394,-33.365123,158.279264,96.006327,-62.272937,14.800818,0.91141,-13.889408,1231.359298,1440.003145,208.643847,9.435497,9.348766,-0.0867310000000003,9.71914,28.418613,18.699473,38.817632,29.075345,-9.74228700000002,154.229584,163.039868,8.81028400000002,,,,1400.216968,431.3445,-968.872468,83.056469,23.298686,-59.757783,30.113021,63.766987,33.653966,7.997106,5.843365,-2.153741,64.120643,9.930256,-54.190387,3.649527,24.817579,21.168052,151.008311,35.528044,-115.480267,0.10725,4.899369,4.792119,1.195961,1.329047,0.133086,0.000488,0.668766,0.668278,5.430187,65.849838,60.419651,25.750089,4.811593,-20.938496,640.621071,605.16974,-35.4513309999999,128.125524,69.270157,-58.855367,0.016565,92.00579,91.989225,18.30917,37.597014,19.287844,0.093844,0.169667,0.075823,0,2.562328,2.562328,2420.659952,917.770816,-1502.889136,,,,19.989493,8.317534,-11.671959,32.846108,18.556127,-14.289981,2.20625,1.389434,-0.816816,0.816063,3.710881,2.894818,,,,9.847474,10.356509,0.509035000000003,0.024012,0.148755,0.124743,1.811355,3.897987,2.086632,1.550288,2.416034,0.865745999999999,58.66277,81.4804,22.81763,51.465604,39.927506,-11.538098,13.10053,14.407963,1.307433,324.742988,651.392021,326.649033,0.830042,9.809314,8.979272,57.763092,20.475059,-37.288033,6.647061,160.54929,153.902229,961.653181,133.714291,-827.93889,3.399821,22.396704,18.996883,498.2,486.4,-11.8,0.039677,0.013231,-0.026446,0.155242,0.043908,-0.111334,91.701223,96.482003,4.78078000000001,276.597166,160.164453,-116.432713,,,,1844.954038,833.24093,-1011.713108,46.696585,86.003412,39.306827,114.110355,795.451862,681.341507,0.311252,24.092327,23.781075,71.89522,62.330415,-9.56480499999998,38.06244,36.138182,-1.924258,9.253556,110.938851,101.685295,1643.744635,1677.835983,34.0913479999999,280.459027,109.396866,-171.062161,4.464008,1.732725,-2.731283,313.971827,31.100209,-282.871618,127.724278,14.466827,-113.257451,0,0.178729,0.178729,1720.398415,596.803037,-1123.595378,1111.559157,263.286183,-848.272974,4.382681,2.031186,-2.351495,172.159891,14.300723,-157.859168,2128.542671,966.9787,-1161.563971,1572.095339,1849.59327,277.497931000001,1098.344355,376.959993,-721.384362,0,0.340812,0.340812,4.139178,9.033813,4.894635,586.421122,488.693324,-97.7277979999998,13.709056,16.96353,3.25447399999999,0.036451,0.388228,0.351777,0.049329,1.833925,1.784596,25798.119656,5517.974227,-20280.145429,0.281693,2.576012,2.294319,0,0,0,3121.090285,2695.972515,-425.11777,293.632588,1604.811008,1311.17842,2224.208273,1689.498413,-534.709860000001,8165.11718,4047.61877,-4117.49841,600.682205,1742.405021,1141.722816,0.004795,0.003828,-0.000967,0.022856,0.668365,0.645509,0.027429,0.006956,-0.020473,0,0.526713,0.526713,6.858841,16.147935,9.289094,166.745006,205.300155,38.5551490000001,0.045721,0.278838,0.233117,0.155381,0.655897,0.500516,0,0.173744,0.173744,0.297182,1.148425,0.851243,0.050076,0.650245,0.600169,0.042167,0.248509,0.206342,0,0.000262,0.000262,0.05958,0.243607,0.184027,0.000678,0.085916,0.085238,0.14562,5.431592,5.285972,0,0.002985,0.002985,1.623928,9.254837,7.630909,1.35416,1.690193,0.336033,0.351259,4.268897,3.917638,0.001068,1.089049,1.087981,0.02078,0.549209,0.528429,11.641866,2.704442,-8.937424,0.19677,0.644107,0.447337,44.798582,138.660948,93.862366,1077.026354,123.961662,-953.064692,31.170495,44.509372,13.338877,263.460931,33.701384,-229.759547,164.067572,606.825892,442.75832,1.229099,6.553081,5.323982,,,,0,0,0,181.960831,21.674072,-160.286759,0,15.730932,15.730932,24.696326,8.814797,-15.881529,0.269607,42.102908,41.833301,0.218518,7.463946,7.245428,8.769805,6.123812,-2.645993,2.474758,3.275881,0.801122999999999,66.105523,37.613044,-28.492479,4.932131,79.220786,74.288655,0.0105,4.702812,4.692312,27.053571,8.199425,-18.854146,0.083788,4.996641,4.912853,2028.384133,363.676442,-1664.707691,0.079255,7.992599,7.913344,148.190977,9.525381,-138.665596,120.432321,3.974114,-116.458207,0.415284,0.659971,0.244687,0.197983,4.603871,4.405888,0.006388,44.487461,44.481073,599.514372,138.732899,-460.781473,183.955998,18.664794,-165.291204,0.009233,0.103763,0.09453,0.020099,1.158877,1.138778,0.020806,3.160535,3.139729,5.25561,6.316059,1.060449,40.937228,4.913934,-36.023294,0.091255,1.925343,1.834088,1.039122,15.789044,14.749922,0.011223,0.098426,0.087203,5.614053,14.500753,8.8867,0,0.146335,0.146335,0.160838,9.380032,9.219194,4.813647,3.500288,-1.313359,26.07946,31.863677,5.784217,0.270788,0.81453,0.543742,0.011338,0.087204,0.075866,2.089526,22.187551,20.098025,16.384916,2.880326,-13.50459,5.893658,30.333727,24.440069,27.517388,7.851072,-19.666316,0,0.543699,0.543699,0,0.048226,0.048226,0.008013,0.362744,0.354731,0.000801,0.025934,0.025133,499.568848,362.585045,-136.983803,8.389263,19.528984,11.139721,9.911696,2.229531,-7.682165,0.317794,5.451403,5.133609,10.622104,1.770295,-8.851809,0.56387,22.630988,22.067118,4.409483,9.789672,5.380189,29.091502,0.019685,-29.071817,0,11.411068,11.411068,,,
2009-09-01,11908.148514,4187.2168,-7720.931714,23529.030358,18055.916582,-5473.11377600001,136267,91673,-44594,10035.267835,0,-10035.267835,10884.769557,6655.272559,-4229.496998,26613.515388,20588.602058,-6024.91333,7725.978694,8499.110282,773.131588,9901.147793,9129.628981,-771.518811999998,36042.72401,29968.66709,-6074.05691999999,27819.980334,21145.416431,-6674.56390300002,6726.61924,2106.701534,-4619.917706,48888.550996,22412.553127,-26475.997869,141004.477358,91458.4052299999,-49546.0721280001,59646.981028,27159.970675,-32487.010353,1774.88842,1604.675129,-170.213291,866.689501,1920.926235,1054.236734,4886.413374,1232.252311,-3654.161063,0.335452,0.639506,0.304054,19912.682159,18392.13483,-1520.54732900001,0,0,0,16130.041851,11576.53226,-4553.509591,250.481221,326.964083,76.4828620000001,18.439963,18.912558,0.472595000000005,167.278552,152.54147,-14.737082,287.522027,247.129678,-40.3923489999999,160.206851,59.243022,-100.963829,606.050329,399.279557,-206.770772,29.021615,347.333348,318.311733,0.57831,94.070677,93.492367,105.230715,205.87965,100.648935,0.00325,28.004319,28.001069,38.508819,101.041888,62.533069,1.005304,13.175064,12.16976,0.958245,58.854814,57.896569,49.507922,60.1188,10.610878,303.34944,419.517319,116.167879,0.456891,3.749853,3.292962,0.94897,10.709312,9.760342,4.311219,8.066405,3.755186,1.155577,12.552306,11.396729,0.000314,0.202527,0.202213,0.246153,4.906159,4.660006,1.716121,9.74476,8.028639,0.033753,6.322909,6.289156,0.6508,6.960301,6.309501,3.188044,30.489598,27.301554,439.71207,148.020951,-291.691119,10.008878,145.141378,135.1325,,,,,,,33.447422,23.196344,-10.251078,0.172469,29.291533,29.119064,0.007284,22.767117,22.759833,1102.867493,840.958071,-261.909422,2776.947464,803.672478,-1973.274986,14.614857,20.947748,6.332891,16.354863,28.652256,12.297393,0.021108,1.024854,1.003746,507.130151,279.633483,-227.496668,407.676479,460.158005,52.4815260000001,73.44251,40.565808,-32.876702,431.809851,696.361712,264.551861,1758.650664,2339.100568,580.449904,7.565894,117.154993,109.589099,23.652227,61.041568,37.389341,266.21144,445.990576,179.779136,0.004264,0.179161,0.174897,15.752558,17.805575,2.05301700000001,723.623877,358.33005,-365.293827,0,0,0,468.276174,254.719018,-213.557156,270.892648,136.372053,-134.520595,8.141394,0.567804,-7.57359,492.538858,164.604172,-327.934686,4251.874576,3748.604899,-503.269677000001,2293.740729,579.176441,-1714.564288,1530.623318,2670.051358,1139.42804,1168.032478,1822.449295,654.416817,177.247986,145.645359,-31.602627,0.03436,0.753673,0.719313,1.014767,2.256941,1.242174,2818.034487,2065.651793,-752.382694,5670.619863,3633.293832,-2037.326031,469.299515,176.512526,-292.786989,,,,152.448508,77.320774,-75.127734,70.250601,16.215992,-54.034609,193.22505,94.940056,-98.284994,15.543599,5.096949,-10.44665,1198.087228,1312.562,114.474772,11.717348,12.321049,0.603701000000003,9.160958,29.855931,20.694973,25.34881,34.386617,9.037807,182.418151,157.594751,-24.8234,,,,1763.867246,496.692498,-1267.174748,43.144954,8.611739,-34.533215,31.297189,119.518799,88.22161,8.088623,5.615569,-2.473054,219.876827,9.203041,-210.673786,1.797115,30.36336,28.566245,166.076991,37.778808,-128.298183,0.87408,7.060708,6.186628,1.524834,2.893888,1.369054,0.033048,0.476235,0.443187,6.773001,91.177108,84.404107,0.528122,7.17594,6.647818,607.167984,727.249125,120.081141,132.254494,70.477738,-61.776756,0.023615,129.704014,129.680399,19.081384,7.053325,-12.028059,0.078788,3.246728,3.16794,0.0025,0.081372,0.078872,2023.136521,1088.63729,-934.499231,,,,20.828662,13.545758,-7.282904,35.69869,12.442416,-23.256274,1.556979,1.330933,-0.226046,1.425912,1.853262,0.42735,,,,3.331078,7.503219,4.172141,0.022822,0.636939,0.614117,0.014601,1.634725,1.620124,1.601888,4.479588,2.8777,125.94522,113.849839,-12.095381,56.247653,74.733274,18.485621,17.343394,11.002789,-6.340605,311.331021,515.153658,203.822637,1.057257,27.143838,26.086581,29.107612,25.309575,-3.798037,6.438366,197.859256,191.42089,1120.721996,185.669999,-935.051997,5.241954,19.440598,14.198644,565,424.4,-140.6,0.210748,0.005092,-0.205656,0.194423,0.019072,-0.175351,89.187783,83.324524,-5.86325899999999,472.603481,193.686714,-278.916767,,,,2229.534363,953.25798,-1276.276383,16.936621,287.532027,270.595406,64.286692,916.967831,852.681139,0.666618,36.573125,35.906507,13.95857,54.427926,40.469356,44.351521,72.79428,28.442759,15.519033,103.25424,87.735207,2068.985927,1641.598446,-427.387481,269.191103,101.460658,-167.730445,6.339381,3.256502,-3.082879,328.366599,37.553684,-290.812915,134.804894,28.210114,-106.59478,0,0.37071,0.37071,1748.178534,643.947412,-1104.231122,1102.24754,261.225987,-841.021553,3.381266,2.580101,-0.801165000000001,188.204089,11.749376,-176.454713,2117.621741,954.828652,-1162.793089,1653.650306,1991.543016,337.89271,1094.94007,401.061712,-693.878358,0.0098,0.140241,0.130441,1.06459,8.369722,7.305132,611.343278,488.637824,-122.705454,16.740281,11.445573,-5.294708,0.000358,0.14755,0.147192,0.154962,1.18638,1.031418,27893.916592,5764.348788,-22129.567804,0.265635,2.212969,1.947334,0,0,0,3368.12542,2611.689295,-756.436124999999,345.35191,2233.696549,1888.344639,2358.851058,1662.181422,-696.669636,8587.879536,4436.85839,-4151.021146,701.950686,1631.65721,929.706524,0.092372,0.088963,-0.003409,0,0.043982,0.043982,0.023543,0.010034,-0.013509,0,0,0,10.571037,8.741929,-1.829108,126.544491,207.493045,80.948554,0.080197,0.075629,-0.004568,0.539994,0.253621,-0.286373,0,0.038194,0.038194,0.269691,1.146087,0.876396,0.037942,0.679077,0.641135,0.13496,0.378449,0.243489,0.000019,0,-0.000019,0.176048,0.102986,-0.073062,0,0.060893,0.060893,5.274513,4.481769,-0.792743999999999,0,0.040634,0.040634,3.23469,8.82296,5.58827,3.550824,46.47571,42.924886,0.296185,3.827805,3.53162,0,1.167945,1.167945,0.050313,0.318428,0.268115,13.657308,3.774755,-9.882553,0.192653,0.669524,0.476871,29.614001,142.061043,112.447042,1425.964104,96.934184,-1329.02992,24.001889,33.551029,9.54913999999999,307.494291,44.4641,-263.030191,199.913597,523.881856,323.968259,1.28141,17.844515,16.563105,,,,0,0.00325,0.00325,288.804734,54.165078,-234.639656,0.117627,2.529854,2.412227,34.686755,15.560459,-19.126296,0.384888,16.974621,16.589733,0.616495,2.272881,1.656386,5.330578,5.048,-0.282577999999999,1.516723,2.180852,0.664129,38.750545,14.029101,-24.721444,6.381981,78.245663,71.863682,0.216227,3.191366,2.975139,25.803877,1.238926,-24.564951,1.891146,6.427779,4.536633,2171.972851,264.011783,-1907.961068,0.509398,1.302446,0.793048,68.930292,11.19638,-57.733912,233.958383,5.815748,-228.142635,1.134933,0.029768,-1.105165,0.047584,2.837625,2.790041,0.0055,32.590424,32.584924,958.83221,109.865621,-848.966589,400.64309,25.965867,-374.677223,0,0.149662,0.149662,0.010486,0.360884,0.350398,0.014824,0.001117,-0.013707,7.10982,6.193345,-0.916475000000002,0.567062,12.621104,12.054042,0.000381,0.65961,0.659229,1.276611,0.985562,-0.291049,0.02398,0.078985,0.055005,3.66423,20.864922,17.200692,0,0.028496,0.028496,0.276684,31.316325,31.039641,2.19115,9.078065,6.886915,25.030406,47.742151,22.711745,0.641438,0.553658,-0.08778,0,0.216086,0.216086,3.003625,8.548483,5.544858,15.772176,3.739709,-12.032467,0.319185,9.33908,9.019895,20.693625,3.823722,-16.869903,0,0.339991,0.339991,0.127603,0.075713,-0.05189,1.600715,0.813789,-0.786926,0,0.002968,0.002968,503.139263,351.978697,-151.160566,9.928849,21.222387,11.293538,9.917673,6.269537,-3.648136,0.128754,3.49366,3.364906,6.663458,1.824623,-4.838835,2.870257,2.46462,-0.405637000000001,7.73683,3.030144,-4.706686,17.985292,0.056318,-17.928974,0,26.454778,26.454778,,,
2009-10-01,10343.927764,4503.098814,-5840.82895,25691.621733,20591.175199,-5100.446534,139309,94829,-44480,10835.200646,0,-10835.200646,11416.565278,6808.270959,-4608.294319,29317.989272,23689.496187,-5628.49308500001,7876.997385,9103.035372,1226.037987,9317.797352,10431.279814,1113.482462,38519.117483,31561.71155,-6957.40593299999,30173.35503,23958.312336,-6215.04269399998,5916.943841,2183.066175,-3733.877666,51694.591118,24937.248556,-26757.342562,147026.850889,100005.493436,-47021.3574530001,62147.163449,29468.405047,-32678.758402,1849.30843,1794.874811,-54.4336190000001,951.744471,2339.428725,1387.684254,4388.816731,1325.817464,-3062.999267,0.729263,0.409896,-0.319367,21229.22711,18830.72088,-2398.50623,0,0,0,17289.890373,12730.99067,-4558.899703,276.824055,332.6638,55.839745,3.908071,20.990478,17.082407,159.475868,169.667864,10.191996,295.286664,301.91781,6.63114599999994,164.049967,69.238268,-94.811699,670.747928,438.297697,-232.450231,27.515119,497.296847,469.781728,2.692284,105.000309,102.308025,68.158135,276.792781,208.634646,0,38.8112,38.8112,35.141721,126.023031,90.88131,1.315561,16.291851,14.97629,1.255168,58.590403,57.335235,44.521535,63.380599,18.859064,282.923948,483.089372,200.165424,0.735035,4.494989,3.759954,0.532894,10.967946,10.435052,4.792152,12.885875,8.093723,0.147381,13.436409,13.289028,0.066102,0.322352,0.25625,0.112656,5.135149,5.022493,1.857467,15.228538,13.371071,0.062299,7.669004,7.606705,0.37109,5.830404,5.459314,2.240769,40.371619,38.13085,374.439922,203.197102,-171.24282,23.559697,209.230249,185.670552,,,,,,,2.354314,29.419015,27.064701,0.016486,21.621781,21.605295,0.019075,20.788343,20.769268,1061.338616,958.272964,-103.065652,2516.93471,841.470629,-1675.464081,16.020136,27.223546,11.20341,8.796276,28.964157,20.167881,0.036972,0.920769,0.883797,551.619688,402.756572,-148.863116,341.107466,462.108384,121.000918,31.116509,42.629838,11.513329,395.827147,732.207048,336.379901,1636.74534,2577.804567,941.059227,9.111349,151.684438,142.573089,20.378421,86.019856,65.641435,282.353202,520.412798,238.059596,1.288157,0.153163,-1.134994,14.04319,19.468889,5.425699,697.03972,412.841995,-284.197725,0,0,0,548.789403,293.862017,-254.927386,283.963908,143.635293,-140.328615,6.407799,0.330652,-6.077147,430.996863,171.082507,-259.914356,4676.119544,4216.293415,-459.826129,2587.162568,470.682689,-2116.479879,1269.375102,2597.632304,1328.257202,1184.630183,1929.978517,745.348334,32.189758,158.403822,126.214064,0.055617,0.551434,0.495817,1.515096,2.042987,0.527891000000001,2995.840098,2425.36909,-570.471008,6894.161894,4103.684487,-2790.477407,597.10399,700.111863,103.007873,,,,172.247655,94.69177,-77.555885,61.757479,21.395114,-40.362365,182.284041,103.177421,-79.10662,16.052856,3.266802,-12.786054,1595.281772,1458.213812,-137.067960000001,10.574617,11.924652,1.350035,9.206153,23.365872,14.159719,114.760125,39.851217,-74.908908,182.186852,219.534576,37.347724,,,,1328.48638,554.17611,-774.31027,19.534981,12.559018,-6.975963,53.036696,58.322163,5.285467,7.147942,2.883422,-4.26452,290.085272,17.754521,-272.330751,3.040014,34.310439,31.270425,191.809262,45.694214,-146.115048,1.207336,3.318445,2.111109,1.144371,3.006274,1.861903,0.192518,1.759295,1.566777,41.417404,3.234516,-38.182888,0.445345,12.866469,12.421124,654.718231,834.037378,179.319147,194.356076,71.188099,-123.167977,0.245528,47.181947,46.936419,23.25403,14.882589,-8.371441,0.047301,0.13523,0.087929,0.077664,0.302745,0.225081,2248.868876,1134.085946,-1114.78293,,,,19.362643,29.664571,10.301928,32.255482,17.858652,-14.39683,1.679263,0.794038,-0.885225,1.591546,4.796582,3.205036,,,,3.08474,8.378547,5.293807,0.00747,0.610643,0.603173,0.014604,1.418552,1.403948,1.567748,2.817519,1.249771,75.02992,595.54024,520.51032,62.136207,51.904642,-10.231565,18.546366,12.865054,-5.681312,334.361536,743.415284,409.053748,0.855995,15.155995,14.3,60.531378,20.049135,-40.482243,7.324082,192.183479,184.859397,1010.752948,99.642698,-911.11025,7.347307,35.482383,28.135076,612.7,487.9,-124.8,0.874437,0,-0.874437,0.054205,0.008125,-0.04608,86.780724,112.876578,26.095854,290.554822,161.894289,-128.660533,,,,1950.940614,980.46918,-970.471434,34.659243,282.864286,248.205043,62.461782,1133.301881,1070.840099,0.971411,16.874299,15.902888,30.426996,150.545208,120.118212,47.879117,51.738499,3.859382,11.982285,215.201492,203.219207,1989.801612,1502.903361,-486.898251000001,276.250893,117.500979,-158.749914,3.686343,1.790145,-1.896198,292.735299,32.922574,-259.812725,122.798656,24.791801,-98.006855,0,0.323318,0.323318,1896.799337,640.934113,-1255.865224,1192.447623,278.271552,-914.176071,2.661503,0.875572,-1.785931,185.819827,11.554074,-174.265753,2240.488924,1066.195513,-1174.293411,1479.15275,2294.482618,815.329868,1241.924832,388.639443,-853.285389,0,0.637094,0.637094,2.511286,8.239016,5.72773,634.565161,545.431895,-89.1332659999999,14.321213,13.136378,-1.184835,0,0.078997,0.078997,0.497738,2.34256,1.844822,29557.782865,6879.300033,-22678.482832,1.8742,3.23411,1.35991,0,0,0,3426.456496,2898.095137,-528.361359,325.91491,1951.839616,1625.924706,2645.473229,1958.618001,-686.855228000001,9197.654303,4637.388375,-4560.265928,744.089608,2086.255714,1342.166106,0.001062,0.064796,0.063734,0.287379,0.054412,-0.232967,0.042558,0.519338,0.47678,0,0,0,14.289588,5.033654,-9.255934,169.965953,204.593163,34.6272099999999,0.030573,0.044795,0.014222,0.334609,0.137675,-0.196934,0,0.047862,0.047862,0.398162,1.601972,1.20381,0.107191,0.622283,0.515092,0.178691,0.240995,0.062304,0,0.00063,0.00063,0.079353,0.086105,0.00675199999999998,0,0.039799,0.039799,3.823336,6.538965,2.715629,0,0.056915,0.056915,3.06252,10.676185,7.613665,0.949251,12.686888,11.737637,0.147169,4.121246,3.974077,0.045,1.473796,1.428796,0.000571,0.275525,0.274954,13.721475,2.119826,-11.601649,0.190422,1.418822,1.2284,39.717549,129.649243,89.931694,1086.143688,97.757,-988.386688,20.348766,57.704122,37.355356,279.441294,77.568639,-201.872655,154.393218,518.196439,363.803221,0.735403,1.604134,0.868730999999999,,,,0,0.0032,0.0032,205.716382,24.252819,-181.463563,0.010961,2.631511,2.62055,11.187101,14.483252,3.296151,0.167384,21.170801,21.003417,0.294671,2.589227,2.294556,5.210419,6.498793,1.288374,0.474114,3.484739,3.010625,16.09977,12.888939,-3.210831,10.550084,64.344661,53.794577,0.494778,1.595895,1.101117,1.182924,1.791698,0.608774,0.592876,21.352915,20.760039,1711.829587,320.378349,-1391.451238,0.59711,0.93897,0.34186,66.473757,7.19056,-59.283197,222.31842,6.514428,-215.803992,0.119419,0.034169,-0.08525,0.157898,1.282261,1.124363,0.029778,67.36748,67.337702,894.431658,94.36507,-800.066588,356.513798,13.952358,-342.56144,0,0.104102,0.104102,0.01946,0.571471,0.552011,0.011279,0.026084,0.014805,7.386876,7.169569,-0.217307000000002,64.560437,8.729039,-55.831398,0.002857,3.197052,3.194195,2.560311,1.103865,-1.456446,0.043745,0.011224,-0.032521,4.134014,5.534726,1.400712,0.015543,0.054745,0.039202,0.144405,24.896046,24.751641,2.185896,6.449711,4.263815,19.825224,97.137489,77.312265,0.783312,0.411703,-0.371609,0.043163,0.136676,0.093513,1.660484,12.474015,10.813531,12.17604,2.139396,-10.036644,1.999525,9.569256,7.569731,23.266561,13.851954,-9.41460699999999,0,0.293614,0.293614,0.080994,0.256443,0.175449,1.10959,0.685554,-0.424036,0,0.173483,0.173483,593.612951,381.502077,-212.110874,86.964833,13.667643,-73.29719,16.645264,6.669428,-9.975836,0.389348,2.838877,2.449529,6.600499,2.124516,-4.475983,0.609939,5.003887,4.393948,3.700259,2.742102,-0.958156999999999,28.60116,0.034685,-28.566475,0,62.879893,62.879893,,,
2009-11-01,10479.8123,4402.745179,-6077.067121,25270.807492,18708.030433,-6562.777059,143475,94635,-48840,10591.847476,0,-10591.847476,10679.070362,6759.977209,-3919.093153,29332.129478,20999.21091,-8332.91856799999,7671.684188,8149.335711,477.651522999997,9522.963216,10132.666539,609.703322999996,37581.293141,30599.724084,-6981.56905700001,29992.567673,21499.320618,-8493.24705500001,6309.367437,2033.622343,-4275.745094,49433.069534,23907.266944,-25525.80259,143324.276766,94606.513892,-48717.762874,58991.037277,28221.343574,-30769.693703,1778.521504,1896.702091,118.180587,926.839464,2022.449861,1095.610397,5112.285846,1290.330439,-3821.955407,0.208558,0.520827,0.312269,20395.458952,18586.12754,-1809.331412,0,0,0,17185.834189,12013.596544,-5172.237645,242.47017,377.800249,135.330079,4.091516,21.361249,17.269733,145.076356,171.020457,25.944101,305.704437,324.551793,18.847356,128.94563,64.735307,-64.210323,676.20993,481.34996,-194.85997,34.333175,357.964826,323.631651,2.271645,53.069682,50.798037,56.828219,223.210137,166.381918,0.009724,42.26069,42.250966,37.180985,130.030265,92.84928,1.071209,19.000527,17.929318,2.682407,55.363579,52.681172,45.992225,66.674769,20.682544,280.114981,477.244325,197.129344,0.383988,2.960694,2.576706,0.4032,12.228805,11.825605,3.6522,12.684349,9.032149,0.69925,16.458529,15.759279,0.301042,0.381623,0.080581,0.067093,4.775697,4.708604,1.360399,14.765018,13.404619,0.122079,6.562453,6.440374,0.172962,4.863178,4.690216,3.16118,35.570293,32.409113,584.160392,158.027371,-426.133021,83.12394,245.587392,162.463452,,,,,,,1.091163,29.265462,28.174299,0.078077,19.428705,19.350628,1.958418,29.583804,27.625386,942.988396,858.356104,-84.632292,2432.919973,837.151518,-1595.768455,22.904782,19.954014,-2.950768,8.74875,28.910372,20.161622,0.007361,0.728941,0.72158,449.310072,438.130282,-11.17979,327.041129,422.303898,95.262769,74.401645,32.650717,-41.750928,423.310759,1066.720582,643.409823,1814.990761,2268.047417,453.056656,6.208715,135.099266,128.890551,20.792566,66.404239,45.611673,354.877989,499.41877,144.540781,0.742326,0.009231,-0.733095,12.064075,25.241035,13.17696,791.228914,371.334519,-419.894395,0,0.122055,0.122055,586.75675,194.925025,-391.831725,279.938866,163.99165,-115.947216,7.367448,0.112202,-7.255246,430.502167,153.160921,-277.341246,4372.783746,3806.628963,-566.154783,1964.736151,860.099166,-1104.636985,1633.00307,2890.963181,1257.960111,1378.077239,1771.943681,393.866442,21.046029,105.438125,84.392096,0.014585,0.691488,0.676903,0.929552,1.521484,0.591932000000001,3034.07754,2215.782754,-818.294786,6948.504332,3608.748907,-3339.755425,481.865361,189.808802,-292.056559,,,,146.052922,79.855026,-66.197896,52.342727,9.948565,-42.394162,168.986086,88.197252,-80.788834,18.336173,1.813952,-16.522221,1711.445615,1270.828692,-440.616923,10.206642,20.929728,10.723086,8.063779,23.774722,15.710943,80.321774,44.009839,-36.311935,164.683453,192.776401,28.092948,,,,1519.777806,432.305555,-1087.472251,27.01128,5.974678,-21.036602,37.889633,63.961812,26.072179,7.058095,9.70467,2.646575,215.880231,11.504081,-204.37615,34.766584,28.574553,-6.192031,153.261485,39.468937,-113.792548,0.439133,2.796887,2.357754,0.551736,1.253641,0.701905,0.000604,8.142372,8.141768,4.755985,4.040549,-0.715436,25.24012,4.530201,-20.709919,619.82451,761.759135,141.934625,137.713548,70.625071,-67.088477,0.101116,115.080102,114.978986,21.639997,5.712184,-15.927813,0.050899,0.226388,0.175489,0.003941,0.470143,0.466202,2369.938174,1039.665375,-1330.272799,,,,22.253781,26.397928,4.144147,31.793326,13.576208,-18.217118,2.795717,1.14841,-1.647307,2.390756,1.773934,-0.616822000000001,,,,4.425503,8.107789,3.682286,0.02296,0.11582,0.09286,10.414733,0.613609,-9.801124,1.380225,4.445126,3.064901,49.978769,138.275048,88.296279,53.917205,61.187319,7.270114,18.633059,11.671999,-6.96106,314.37366,525.397067,211.023407,0.948106,8.165892,7.217786,2.523957,45.987961,43.464004,5.570294,158.860589,153.290295,757.022852,98.666471,-658.356381,4.594686,41.576762,36.982076,567.4,573.8,6.39999999999998,0.257759,0,-0.257759,0.225066,0.027793,-0.197273,69.560929,110.80548,41.244551,226.188862,181.38641,-44.802452,,,,2237.005013,840.420821,-1396.584192,62.497636,257.151201,194.653565,87.615185,1054.812418,967.197233,0.70727,42.963489,42.256219,11.787027,89.518616,77.731589,36.636552,64.056132,27.41958,12.922138,216.619787,203.697649,1724.126769,1069.961737,-654.165032000001,250.215114,153.544799,-96.670315,3.67942,6.239025,2.559605,229.537359,30.497689,-199.03967,118.795016,12.381315,-106.413701,0,0.293708,0.293708,1774.008389,655.196242,-1118.812147,977.627836,294.301924,-683.325912,3.548131,0.625028,-2.923103,138.488099,8.401685,-130.086414,2167.744357,1007.667744,-1160.076613,1200.852669,1898.11035,697.257681,989.476578,462.223053,-527.253525,0,0.135445,0.135445,1.288458,7.224484,5.936026,661.707064,662.411381,0.70431700000006,11.009426,20.738183,9.728757,0,1.037767,1.037767,0.509636,1.849076,1.33944,27541.720775,7374.160636,-20167.560139,2.809841,2.354951,-0.45489,0,0.431703,0.431703,3312.63578,2626.568086,-686.067694,293.263831,1699.246309,1405.982478,2864.931908,1925.410966,-939.520942,9477.993465,4235.225118,-5242.768347,729.471261,1734.970501,1005.49924,0,0.209747,0.209747,0.060301,0.121352,0.061051,0.017557,0.103059,0.085502,0.000964,0.735357,0.734393,17.883683,63.655168,45.771485,163.090279,189.654965,26.564686,0.014393,0.137217,0.122824,0.328011,0.265075,-0.062936,0,0.127735,0.127735,0.449237,1.88447,1.435233,0.026297,0.23546,0.209163,0.145378,0.308637,0.163259,0,0,0,0.014462,0.06897,0.054508,0.000004,0,-0.000004,0.120434,6.21818,6.097746,0,0.231041,0.231041,1.956933,9.871648,7.914715,0.595419,2.435631,1.840212,0.302296,4.151345,3.849049,0.005403,1.591632,1.586229,0.004611,0.334672,0.330061,12.107926,3.023253,-9.084673,0.245583,2.361291,2.115708,37.883788,161.221216,123.337428,747.668035,110.654952,-637.013083,21.018526,73.262017,52.243491,92.214333,44.734043,-47.48029,161.300872,345.829826,184.528954,0.074086,20.169804,20.095718,,,,0,0.000053,0.000053,322.058059,45.607794,-276.450265,0.230851,3.137616,2.906765,29.103574,22.908498,-6.19507599999999,0.496626,9.001775,8.505149,0.058104,2.020558,1.962454,6.42195,6.765193,0.343243,0.805623,4.477002,3.671379,58.22771,13.231537,-44.996173,14.628378,43.359381,28.731003,0.003776,1.154856,1.15108,0.25158,3.911394,3.659814,0.058674,8.105493,8.046819,2399.282342,334.03675,-2065.245592,0.26209,0.513856,0.251766,20.109805,9.868688,-10.241117,162.681809,6.551447,-156.130362,0.824944,0.180143,-0.644801,0.389336,1.288682,0.899346,0.09275,38.804531,38.711781,847.398116,157.110613,-690.287503,467.418291,23.855676,-443.562615,0,0.357748,0.357748,0.402246,0.462917,0.060671,0.004339,0.169915,0.165576,6.883653,5.609382,-1.274271,69.176846,4.853004,-64.323842,0.067705,0.211411,0.143706,3.750519,1.098406,-2.652113,0.000314,0.027388,0.027074,2.63381,10.434839,7.801029,0,0.15996,0.15996,0.140967,7.174271,7.033304,3.027058,4.579302,1.552244,15.801748,30.847478,15.04573,0.537119,0.319251,-0.217868,0.050826,0.237155,0.186329,2.724469,18.086464,15.361995,13.116901,2.828601,-10.2883,3.009342,15.865765,12.856423,12.342557,6.509291,-5.833266,0,0.18388,0.18388,0.2312,0.749218,0.518018,0.014441,0.14254,0.128099,0.010631,0.048857,0.038226,587.251415,343.431704,-243.819711,6.428161,29.680891,23.25273,12.289559,4.87504,-7.414519,0.088995,4.073769,3.984774,5.89202,0.677204,-5.214816,2.063469,10.914049,8.85058,6.144096,2.274216,-3.86988,23.547489,0.021633,-23.525856,0,96.866046,96.866046,,,
2009-12-01,11588.479633,4801.081449,-6787.398184,25372.38215,18971.54976,-6400.83239000001,147620,98293,-49327,10712.871847,0,-10712.871847,11371.761859,6669.071333,-4702.690526,28968.890095,23977.127931,-4991.762164,7689.707425,9333.995652,1644.288227,10268.571185,10479.251762,210.680576999999,38935.565449,30315.975524,-8619.589925,29926.158229,22343.44735,-7582.71087900001,7154.06592,2046.043982,-5108.021938,48700.645051,27091.714606,-21608.930445,146105.807486,99371.867233,-46733.9402530001,58800.76584,32033.766562,-26766.999278,1760.28202,1803.628075,43.3460549999998,1020.660288,2131.025307,1110.365019,5413.935572,1364.687423,-4049.248149,0.020575,0.220873,0.200298,21848.097171,18532.562584,-3315.53458700001,0,0.015827,0.015827,17087.468278,11783.41294,-5304.055338,297.956494,327.796658,29.8401639999999,8.401822,20.161512,11.75969,151.910565,180.024547,28.113982,294.54937,317.65577,23.1064,130.929758,70.73939,-60.190368,610.528298,431.017907,-179.510391,28.043343,524.342303,496.29896,2.357312,42.829007,40.471695,123.276246,259.032254,135.756008,0,42.088628,42.088628,23.946278,156.208259,132.261981,1.602419,20.528849,18.92643,1.543741,55.349101,53.80536,48.666202,61.489259,12.823057,274.407535,476.393803,201.986268,0.143834,3.918676,3.774842,0.841621,26.650634,25.809013,3.416817,10.628482,7.211665,0.399301,14.667424,14.268123,0.005138,0.571887,0.566749,0.137638,5.664989,5.527351,1.3572,12.921114,11.563914,0.098687,5.630461,5.531774,0.133564,5.97829,5.844726,3.429727,33.450811,30.021084,482.310075,126.253782,-356.056293,40.542609,204.047962,163.505353,,,,,,,38.317295,78.598666,40.281371,0.029793,18.320674,18.290881,1.662398,23.630753,21.968355,1170.345515,962.466944,-207.878571,2795.237853,644.859904,-2150.377949,19.305009,23.113433,3.80842400000001,12.89983,26.487774,13.587944,0,0.636094,0.636094,396.297373,608.545094,212.247721,474.327557,455.547664,-18.7798929999999,54.931938,34.472881,-20.459057,573.570518,1033.535312,459.964794,1852.889178,2496.318131,643.428953,4.288388,139.550942,135.262554,17.214648,65.783966,48.569318,325.974081,429.761375,103.787294,0.344217,1.580396,1.236179,15.183374,27.339259,12.155885,801.695726,387.138041,-414.557685,0,0.04682,0.04682,524.451679,226.731045,-297.720634,307.247101,140.140153,-167.106948,7.190792,0.145443,-7.045349,408.358475,198.368583,-209.989892,3975.144068,3714.847194,-260.296873999999,1925.584523,461.623559,-1463.960964,1303.470191,2661.966865,1358.496674,1866.917554,1957.814649,90.897095,36.363141,156.309869,119.946728,0.092943,0.789393,0.69645,1.173333,1.224587,0.0512539999999999,3043.496951,2253.266545,-790.230406,6963.873347,4021.617606,-2942.255741,560.079239,201.827314,-358.251925,,,,218.857049,97.169299,-121.68775,71.436003,21.089874,-50.346129,186.034307,103.884209,-82.150098,20.733567,1.22639,-19.507177,1661.404935,1560.798801,-100.606134,14.917029,35.552062,20.635033,9.39551,26.096289,16.700779,34.21642,26.445291,-7.77112899999999,187.59662,286.69319,99.09657,,,,1423.712771,403.703424,-1020.009347,4.768952,6.830527,2.061575,36.572768,70.407141,33.834373,7.770827,10.20969,2.438863,294.32733,17.287926,-277.039404,1.721745,29.565594,27.843849,123.828427,64.653533,-59.174894,0.359415,4.523037,4.163622,0.578394,1.769163,1.190769,0.010156,1.722851,1.712695,15.567693,2.563802,-13.003891,0.628982,6.930688,6.301706,751.256117,694.71086,-56.5452569999999,162.297331,89.840311,-72.45702,0.001064,78.978718,78.977654,25.108711,6.635354,-18.473357,0.052397,0.265505,0.213108,0.0044,0.604125,0.599725,2335.246168,1058.15765,-1277.088518,,,,37.028554,16.324573,-20.703981,35.48292,15.228669,-20.254251,2.407306,1.699062,-0.708244,11.534951,2.077096,-9.457855,,,,6.416335,8.17186,1.755525,0.026566,1.751528,1.724962,0.037241,1.215571,1.17833,1.080066,4.891835,3.811769,57.03426,262.737261,205.703001,65.177578,69.62175,4.44417200000004,25.584181,12.636277,-12.947904,355.109116,817.448603,462.339487,0.51163,10.131036,9.619406,26.339754,15.252348,-11.087406,5.388429,134.370176,128.981747,825.572731,96.878302,-728.694429,7.559519,11.070346,3.510827,537.7,524.3,-13.4000000000001,0.73523,0,-0.73523,0.620891,0.05,-0.570891,58.310023,105.422027,47.112004,659.582198,259.000074,-400.582124,,,,2037.187224,1096.556041,-940.631183,47.490652,389.285096,341.794444,75.230978,1088.768738,1013.53776,0.24811,21.778619,21.530509,12.353957,84.975392,72.621435,41.940965,47.55539,5.61442500000001,10.880801,156.398984,145.518183,1784.642964,1406.689986,-377.952978,253.770323,127.852388,-125.917935,3.646955,3.629968,-0.0169870000000008,280.930617,33.176652,-247.753965,127.964861,13.818904,-114.145957,0,0.473172,0.473172,1897.787551,689.588571,-1208.19898,1068.141642,318.360862,-749.78078,3.752585,1.707678,-2.044907,152.569833,9.846208,-142.723625,2235.40835,1036.325291,-1199.083059,1345.461019,2124.891036,779.430017,1148.711873,806.680328,-342.031545,0,0.059027,0.059027,0.450195,7.514149,7.063954,631.596449,536.44519,-95.1512590000001,11.230982,17.152083,5.921101,0,0.39729,0.39729,0.080389,1.995043,1.914654,26470.075735,8324.982797,-18145.092938,2.659452,2.264564,-0.394888,0,0,0,3374.165952,2813.977994,-560.187958,320.895413,2329.066396,2008.170983,2649.185041,2066.060226,-583.124815,9517.841208,4928.307586,-4589.533622,752.091074,1909.228221,1157.137147,0,0.12723,0.12723,0.06229,0.312727,0.250437,0.006132,0.037448,0.031316,0,0,0,9.145694,8.491873,-0.653821000000002,234.386066,182.591436,-51.79463,0.454708,0.218254,-0.236454,0.642511,0.381533,-0.260978,0,0.478601,0.478601,0.648621,1.335403,0.686782,0.038052,0.371507,0.333455,0.045458,0.555267,0.509809,0.000812,0,-0.000812,0.0606,0.033262,-0.027338,0,0.267398,0.267398,6.742175,6.94331,0.201134999999999,0,0.023135,0.023135,1.79944,9.026295,7.226855,1.217689,1.592222,0.374533,0.252797,3.373025,3.120228,0,1.2353,1.2353,0,0.563238,0.563238,12.768218,2.137084,-10.631134,0.298763,1.863385,1.564622,41.981128,155.863994,113.882866,1359.46091,78.185418,-1281.275492,20.279004,80.026217,59.747213,86.644709,52.968451,-33.676258,167.346347,311.558122,144.211775,0.220603,4.268729,4.048126,,,,0,0,0,293.005926,39.19802,-253.807906,0.008565,2.538043,2.529478,9.239431,9.810988,0.571557,0.340259,22.057257,21.716998,0.079367,2.703904,2.624537,5.588524,5.318173,-0.270351,0.666384,3.843401,3.177017,147.66329,14.008344,-133.654946,22.865286,57.351535,34.486249,0.465481,1.229626,0.764145,0.04182,1.333609,1.291789,0.226405,6.809202,6.582797,2470.970176,295.776423,-2175.193753,0.84821,0.456408,-0.391802,147.642733,13.106603,-134.53613,192.544024,7.765673,-184.778351,0.015399,0.017423,0.002024,0.46066,1.962465,1.501805,0.097998,33.985062,33.887064,763.598386,176.9541,-586.644286,376.127936,32.119802,-344.008134,0.034072,0.120618,0.086546,0,0.502016,0.502016,0.016646,0.024313,0.007667,11.690971,6.219307,-5.471664,68.101322,4.612002,-63.48932,0.378922,0.254728,-0.124194,1.111751,3.633191,2.52144,0.116215,0.003909,-0.112306,2.119258,8.331469,6.212211,0,0.19543,0.19543,0.041077,4.94331,4.902233,3.980705,8.778764,4.798059,22.65625,42.174738,19.518488,0.54164,0.502175,-0.039465,0.044089,0.042619,-0.00147000000000001,2.87595,16.472532,13.596582,16.712076,41.493162,24.781086,1.342916,6.495218,5.152302,19.736587,14.073275,-5.663312,0.050496,0.544032,0.493536,0.36441,0.108076,-0.256334,0.711838,0.171009,-0.540829,0,0.075998,0.075998,739.250968,382.825606,-356.425362,25.623373,11.147283,-14.47609,9.102228,36.916159,27.813931,0.199944,10.792997,10.593053,7.684974,0.939271,-6.745703,9.215237,3.536064,-5.679173,8.476525,2.104211,-6.372314,24.676883,0.253579,-24.423304,0,22.120046,22.120046,,,
2010-01-01,10966.445219,3757.759429,-7208.68579,21293.223721,18550.497634,-2742.72608699999,146808,98302,-48506,9605.571165,0,-9605.571165,10882.193468,5965.796346,-4916.397122,24377.303318,21304.758506,-3072.544812,7293.354467,8724.49229,1431.137823,9733.335334,9723.834653,-9.50068100000317,37743.237644,28760.94747,-8982.290174,25937.436133,21651.369644,-4286.06648899999,6631.588553,1760.484078,-4871.104475,45501.930237,24451.539911,-21050.390326,136725.372523,92600.632335,-44124.7401880001,55834.004895,28882.251752,-26951.753143,1466.280101,1721.59998,255.319878999999,845.445604,1821.529413,976.083809,4882.2,991.8,-3890.4,0.32436,0.215325,-0.109035,21653.836333,17238.673232,-4415.16310099999,0,0,0,16089.401311,11522.274238,-4567.127073,243.207646,328.198493,84.990847,2.170355,18.959413,16.789058,126.299696,151.983927,25.684231,221.322956,323.117305,101.794349,112.031938,45.274513,-66.757425,580.116379,406.119169,-173.99721,52.584933,493.660423,441.07549,8.832869,61.28023,52.447361,48.254702,220.09351,171.838808,0,47.754311,47.754311,24.470528,120.807812,96.337284,0.481465,19.06537,18.583905,0.599687,50.357539,49.757852,6.401135,80.661141,74.260006,183.301486,466.906573,283.605087,0.145726,2.660965,2.515239,9.875348,11.257992,1.382644,2.480722,8.156068,5.675346,0.476489,11.954163,11.477674,0.000114,0.54184,0.541726,0.311719,5.332542,5.020823,1.331763,31.78686,30.455097,0.151941,6.475587,6.323646,0.255395,5.128449,4.873054,2.891999,29.416182,26.524183,623.501723,135.503379,-487.998344,57.219021,232.234611,175.01559,,,,,,,0.9474,27.977448,27.030048,0.03853,26.346615,26.308085,0.366621,29.748857,29.382236,1061.325184,896.212478,-165.112706,2222.112885,624.763222,-1597.349663,17.935574,17.523213,-0.412361000000001,10.747823,17.527274,6.779451,0.004,4.126977,4.122977,639.411541,511.514919,-127.896622,379.996696,511.704465,131.707769,44.507533,34.076951,-10.430582,833.261668,758.032246,-75.2294220000001,1942.338948,2265.383193,323.044245,4.711516,153.133753,148.422237,14.05752,68.681192,54.623672,252.733103,462.325049,209.591946,0.121057,0.068434,-0.052623,13.604397,30.683962,17.079565,646.462919,319.374908,-327.088011,0,0.20881,0.20881,774.089753,192.579897,-581.509856,220.768812,119.41903,-101.349782,5.038119,0.109992,-4.928127,306.762843,172.363679,-134.399164,3198.563623,3823.179784,624.616161000002,2352.253592,761.8333,-1590.420292,1397.73115,2484.169193,1086.438043,1561.633243,1851.899201,290.265958,31.909768,120.964377,89.054609,0.08086,0.115158,0.034298,1.061657,2.623812,1.562155,2555.731924,2011.08256,-544.649364000001,5007.718306,3826.700173,-1181.018133,424.769062,309.983772,-114.78529,,,,152.570883,119.800628,-32.770255,50.820856,10.777423,-40.043433,150.887492,95.32775,-55.559742,12.988968,1.064124,-11.924844,1366.230086,1677.540186,311.310099999999,9.182447,11.140467,1.95802,20.009145,23.915372,3.906227,34.137634,33.784986,-0.352647999999981,168.887128,206.823041,37.935913,,,,1698.915424,314.390047,-1384.525377,18.791976,6.58991,-12.202066,53.320707,89.227286,35.906579,5.546546,12.199298,6.652752,148.758555,8.747805,-140.01075,8.224947,22.957141,14.732194,134.661743,26.317329,-108.344414,0.548115,5.731238,5.183123,0.656996,8.878492,8.221496,1.309212,0.687771,-0.621441,4.240856,2.027023,-2.213833,24.279646,5.854912,-18.424734,621.351625,752.48392,131.132295,184.937142,175.55542,-9.381722,0.055262,7.636738,7.581476,19.968731,19.019141,-0.949589999999993,0.02276,0.260687,0.237927,0,0.074136,0.074136,2011.604105,1060.791854,-950.812251,,,,24.9152,12.469449,-12.445751,34.682061,13.842176,-20.839885,1.487231,1.209047,-0.278184,2.913505,1.42737,-1.486135,,,,50.417338,8.674575,-41.742763,0.03113,1.219921,1.188791,0.026861,0.882749,0.855888,1.54425,1.828489,0.284239,55.29099,136.533979,81.242989,56.745193,69.592739,12.847546,17.339038,10.054367,-7.284671,290.450312,656.654656,366.204344,0.504009,10.084394,9.580385,36.243362,47.425146,11.181784,5.344109,171.68802,166.343911,1195.71563,95.509241,-1100.206389,6.325362,30.833735,24.508373,642.3,463.9,-178.4,1.22615,0,-1.22615,0.153631,0.052875,-0.100756,71.367956,83.580322,12.212366,268.357798,198.48457,-69.873228,,,,2055.989135,811.476213,-1244.512922,75.504152,242.203022,166.69887,82.257129,823.944796,741.687667,1.570365,16.233019,14.662654,29.584044,74.247228,44.663184,39.224062,131.986308,92.762246,19.970495,262.013646,242.043151,2080.532755,1296.851247,-783.681508,228.805231,117.160097,-111.645134,4.852988,1.658829,-3.194159,279.04324,36.007265,-243.035975,147.375454,11.341517,-136.033937,0,0.34224,0.34224,1644.816573,682.632608,-962.183965,1156.776489,259.123127,-897.653362,2.964724,0.755862,-2.208862,155.02672,13.120262,-141.906458,2062.759593,987.848258,-1074.911335,1292.295514,2132.696533,840.401019,1166.606844,507.087053,-659.519791,0,0.030734,0.030734,0.061166,6.963661,6.902495,581.368259,685.098795,103.730536,12.122873,13.647385,1.524512,0.021522,0.195686,0.174164,0.294849,1.405149,1.1103,25215.919006,6898.358856,-18317.56015,0.199095,10.119814,9.920719,0,0,0,3102.861595,2716.681092,-386.180503,312.328303,1894.952538,1582.624235,2585.869055,1980.162127,-605.706928,8340.840554,4840.292937,-3500.547617,649.259641,1532.914598,883.654957,0,0.061189,0.061189,0.04653,0.108629,0.062099,0.118911,0.204315,0.085404,0,0,0,7.51733,27.912922,20.395592,172.120504,226.923156,54.802652,0.01637,0.22371,0.20734,0.891791,0.756722,-0.135069,0.004358,0.136623,0.132265,0.087482,1.077929,0.990447,0.058062,0.112354,0.054292,0.046627,0.136353,0.089726,0,0,0,0.085625,0.053479,-0.032146,0,0.069888,0.069888,2.642584,6.60652,3.963936,0,0.000269,0.000269,3.08543,8.097744,5.012314,0.557264,2.181206,1.623942,0.384065,2.971771,2.587706,0,0.949205,0.949205,0.034764,0.302159,0.267395,8.301148,7.098811,-1.202337,0.187118,2.519793,2.332675,49.899299,162.045278,112.145979,1312.192687,85.1129,-1227.079787,22.934306,26.712982,3.77867600000001,162.859367,52.99197,-109.867397,306.44178,439.447515,133.005735,0.482274,11.091959,10.609685,,,,0.000019,0,-0.000019,155.763432,26.066525,-129.696907,25.805927,3.26089,-22.545037,3.595066,11.141909,7.546843,0.286312,6.861468,6.575156,0.731466,1.0227,0.291234,5.560231,3.484204,-2.076027,5.28708,2.278555,-3.008525,234.338076,24.389452,-209.948624,34.276443,33.230891,-1.04555200000001,0.488271,3.688368,3.200097,0.065965,4.528391,4.462426,0.050237,4.151585,4.101348,2313.432494,215.8481,-2097.584394,0.218191,2.37847,2.160279,69.414239,12.14067,-57.273569,190.306943,5.786099,-184.520844,0.813641,0.015578,-0.798063,0.01831,0.820823,0.802513,0.009811,20.273975,20.264164,738.391261,64.833947,-673.557314,293.478297,17.349085,-276.129212,0.03654,0.270023,0.233483,0.107023,1.405628,1.298605,0.005158,0.051082,0.045924,60.38222,8.295612,-52.086608,56.94939,5.025227,-51.924163,0.628009,0.861094,0.233085,0.640743,0.451884,-0.188859,0.002851,0.04992,0.047069,2.088063,9.988988,7.900925,0,0.051921,0.051921,0.210364,4.596753,4.386389,2.854378,9.692474,6.838096,16.627539,34.363152,17.735613,0.456295,0.981146,0.524851,0.004734,0.111745,0.107011,5.3702,8.352043,2.981843,12.42058,1.917193,-10.503387,3.718552,15.249709,11.531157,24.350862,10.864477,-13.486385,0,0.21997,0.21997,0.315863,0.542233,0.22637,0.309398,1.723572,1.414174,0,0.020416,0.020416,564.133741,337.53578,-226.597961,2.713633,7.745441,5.031808,16.152374,2.475622,-13.676752,1.118053,2.883762,1.765709,8.836302,1.022551,-7.813751,0.550239,29.219138,28.668899,6.701376,1.555639,-5.145737,20.088888,0.013723,-20.075165,0,0,0,,,
2010-02-01,10780.99698,4348.587977,-6432.409003,23124.566334,17851.652686,-5272.91364800001,150520,99555,-50965,9942.947907,0,-9942.947907,11147.474198,6779.483016,-4367.991182,23622.102071,19861.10752,-3760.994551,6601.446626,8877.076768,2275.630142,9578.282873,9834.005941,255.723067999999,37692.514941,30260.37847,-7432.13647099999,26937.830523,20707.339653,-6230.49087000001,5711.224704,1951.207288,-3760.017416,43152.770829,24208.822468,-18943.948361,133898.772498,93858.1766710001,-40040.5958269999,53178.476278,29290.713642,-23887.762636,1662.746263,1866.301748,203.555485,799.93737,1813.188085,1013.250715,4293.1,1117.8,-3175.3,0.505713,1.336067,0.830354,21233.211441,18545.025856,-2688.185585,0.000096,0.007525,0.007429,16459.3035,11715.352614,-4743.95088600001,269.432484,339.702101,70.269617,3.240765,17.712987,14.472222,150.670516,190.973449,40.302933,288.328918,340.881284,52.552366,149.453902,71.82583,-77.628072,535.692663,421.327504,-114.365159,22.290785,449.032368,426.741583,0.420938,33.050084,32.629146,81.023816,312.601508,231.577692,0,26.857689,26.857689,30.386442,106.21552,75.829078,0.96908,17.187486,16.218406,0.488457,42.499532,42.011075,29.396001,126.35103,96.955029,269.16778,501.59158,232.4238,0.291679,1.982712,1.691033,0.424679,11.251606,10.826927,3.328417,10.203989,6.875572,0.192461,10.423911,10.23145,0.139874,0.23498,0.095106,0.025226,4.895501,4.870275,1.380239,10.545697,9.165458,0.078695,5.448839,5.370144,0.26467,3.908211,3.643541,2.83923,29.089657,26.250427,537.106338,131.789831,-405.316507,84.692296,165.535536,80.84324,,,,,,,2.555936,19.715526,17.15959,0.086097,17.784646,17.698549,3.122234,27.515923,24.393689,1172.037764,1019.444362,-152.593402,2707.945043,647.632612,-2060.312431,19.103851,18.664241,-0.439609999999995,15.969774,23.830636,7.860862,0.06466,2.164949,2.100289,413.129223,307.099942,-106.029281,390.371148,511.505972,121.134824,53.359225,31.441368,-21.917857,645.300607,796.445515,151.144908,1432.141455,2360.276428,928.134973,2.634496,110.263945,107.629449,12.657921,62.655709,49.997788,246.076784,493.923101,247.846317,0.000304,0.520644,0.52034,15.626323,25.043847,9.417524,639.158517,331.071833,-308.086684,0,0.041064,0.041064,530.489872,229.847727,-300.642145,255.595199,132.867267,-122.727932,3.786426,0.119204,-3.667222,369.251996,166.599849,-202.652147,4344.174075,4001.446644,-342.727430999998,2684.489846,577.820427,-2106.669419,1465.816535,2435.364692,969.548157,1016.131539,1781.686357,765.554818,21.125044,120.031077,98.906033,0.049898,0.338223,0.288325,3.440709,1.331081,-2.109628,2609.826983,2034.749676,-575.077307,5750.194616,3488.041024,-2262.153592,437.315318,180.887572,-256.427746,,,,182.697301,125.062463,-57.634838,70.067318,14.679594,-55.387724,170.4511,92.015765,-78.435335,16.005475,0.849935,-15.15554,1317.688657,1190.727548,-126.961109,18.907751,12.985689,-5.922062,13.258911,22.102675,8.84376400000001,82.027555,45.987067,-36.040488,201.527181,228.709645,27.182464,,,,1235.777273,368.394375,-867.382898,16.219771,12.540686,-3.679085,34.499013,137.911163,103.41215,2.890171,3.927847,1.037676,41.131472,11.14255,-29.988922,13.022503,15.650079,2.627576,194.362298,32.686598,-161.6757,1.309682,5.864832,4.55515,0.733932,0.798205,0.0642730000000001,0.000959,13.250148,13.249189,3.505284,2.218903,-1.286381,3.978964,5.604768,1.625804,459.641016,677.14273,217.501714,193.525366,91.450193,-102.075173,0,2.563294,2.563294,19.269365,25.316086,6.046721,0.148055,0.46484,0.316785,0.000673,0,-0.000673,1946.255243,1054.919419,-891.335824,,,,25.965929,22.084687,-3.881242,30.511151,15.433029,-15.078122,1.346983,0.791014,-0.555969,8.104359,5.541956,-2.562403,,,,6.574223,5.697364,-0.876859,0.002552,0.411909,0.409357,0.213723,1.4193,1.205577,0.689644,3.149945,2.460301,55.569426,101.73011,46.160684,61.957084,43.640731,-18.316353,25.071305,12.0932,-12.978105,335.699366,755.273875,419.574509,0.749593,37.817872,37.068279,65.732223,37.336945,-28.395278,4.551528,128.027491,123.475963,1231.000089,296.71402,-934.286069,7.0045,33.540469,26.535969,543.4,457.8,-85.6,0.254545,0,-0.254545,0.015432,0.210018,0.194586,67.496806,82.927841,15.431035,241.650949,166.306231,-75.344718,,,,2040.694365,1054.001307,-986.693058,63.937901,368.375828,304.437927,86.358774,960.515593,874.156819,35.003124,69.981296,34.978172,18.633525,184.742762,166.109237,51.723171,37.648623,-14.074548,23.256187,153.682069,130.425882,1972.140932,1232.856945,-739.283987,249.226403,113.842619,-135.383784,4.876338,4.581195,-0.295142999999999,309.572191,25.52153,-284.050661,128.805047,14.990952,-113.814095,0,0.389267,0.389267,1552.243767,700.622663,-851.621104,1049.335546,278.293258,-771.042288,3.987307,0.759115,-3.228192,173.291457,17.187827,-156.10363,1888.146228,929.710198,-958.43603,1060.237782,2193.647669,1133.409887,1200.732042,591.073919,-609.658123,0,0.274325,0.274325,0.78589,5.903546,5.117656,550.796658,540.537742,-10.258916,13.253267,13.906122,0.652855000000002,0,0.165145,0.165145,0.284933,1.239554,0.954621,23342.777514,6840.227481,-16502.550033,0.252638,3.153716,2.901078,0,0,0,3113.066703,2969.232128,-143.834575,247.081359,1874.703281,1627.621922,2181.060782,1839.49369,-341.567092,8776.279973,4625.432423,-4150.84755,584.335342,1592.27701,1007.941668,0.000001,0.138428,0.138427,0.074039,0.029423,-0.044616,0.169334,0.125106,-0.044228,0,0,0,6.207491,4.739,-1.468491,188.009798,187.938259,-0.0715390000000014,0.319502,0.184495,-0.135007,0.327737,0.856836,0.529099,0.007027,0.059254,0.052227,0.087987,1.382366,1.294379,0.066296,0.053872,-0.012424,0.079607,0.408061,0.328454,0.000021,0.000192,0.000171,0.043775,0.115049,0.071274,0,0.070174,0.070174,1.944309,3.51502,1.570711,0,0,0,7.461743,9.653305,2.191562,0.768119,1.452421,0.684302,0.139642,3.549417,3.409775,0.0903,1.029055,0.938755,0.023461,0.430726,0.407265,9.652295,2.982694,-6.669601,0.129013,1.682923,1.55391,46.844725,197.729098,150.884373,1034.311268,52.601794,-981.709474,20.17372,49.995372,29.821652,44.381753,61.369633,16.98788,218.478118,468.214234,249.736116,0.1565,15.427456,15.270956,,,,0,0,0,34.940983,16.135796,-18.805187,26.402937,4.432282,-21.970655,23.349728,7.467455,-15.882273,0.401403,11.641713,11.24031,0.341794,3.15885,2.817056,7.783712,4.488007,-3.295705,0.774411,2.228169,1.453758,126.342453,8.327404,-118.015049,16.807908,74.536753,57.728845,0.778604,4.450477,3.671873,0.045008,1.230828,1.18582,0.04332,5.927593,5.884273,2058.736957,310.044267,-1748.69269,0.839045,0.440084,-0.398961,144.406165,8.905767,-135.500398,171.761147,5.942355,-165.818792,0.041463,0.004683,-0.03678,0.514944,2.624332,2.109388,0.006105,34.578174,34.572069,800.457489,87.550657,-712.906832,252.496265,15.140173,-237.356092,0.023862,2.206238,2.182376,0.181096,0.415536,0.23444,0.006326,0.019109,0.012783,9.280434,16.954478,7.674044,50.000341,12.190496,-37.809845,0.078383,0.414779,0.336396,0.773156,1.508853,0.735697,0.002397,0.004769,0.002372,2.451539,12.919563,10.468024,0.001199,0.135274,0.134075,0.181364,9.877631,9.696267,13.925653,17.170446,3.24479299999999,11.482229,37.34337,25.861141,0.404922,0.802549,0.397627,0.058269,0.044264,-0.014005,3.66676,8.817895,5.151135,12.510544,2.979518,-9.531026,2.276025,11.297628,9.021603,13.345975,11.250147,-2.095828,0,0.484472,0.484472,0.327623,0.05518,-0.272443,2.411278,0.234779,-2.176499,0,0.095928,0.095928,446.464628,306.50635,-139.958278,15.10913,6.761572,-8.347558,12.00046,1.736106,-10.264354,1.217455,3.41192,2.194465,5.731845,0.814673,-4.917172,3.533323,1.531896,-2.001427,2.798591,2.127256,-0.671335,13.916889,0.161789,-13.7551,0,0,0,,,
2010-03-01,13656.518007,4626.859712,-9029.658295,28264.096023,20956.324168,-7307.77185500001,153982,103530,-50452,12382.427338,0,-12382.427338,12803.837134,7815.862128,-4987.975006,28648.129064,23953.070473,-4695.05859100001,7970.050782,10736.890174,2766.839392,11312.012744,12044.85995,732.847206,44405.784801,36390.54955,-8015.235251,33238.319436,24803.994084,-8434.32535200001,7908.560282,2639.762099,-5268.798183,48030.359946,27709.418877,-20320.941069,157728.782628,110510.205728,-47218.5768999999,59843.785831,32439.176174,-27404.609657,2196.130621,2183.662188,-12.468433,1019.523832,2191.345065,1171.821233,6195.7,1625.1,-4570.6,0.795702,0.518806,-0.276896,24316.311419,22189.194894,-2127.116525,0,0,0,20089.473382,14201.354656,-5888.118726,307.526025,431.29044,123.764415,9.137775,27.260197,18.122422,189.209782,251.568825,62.359043,352.506339,397.384347,44.8780079999999,175.248613,72.652576,-102.596037,816.735682,464.966422,-351.76926,27.699134,572.660883,544.961749,0.517543,37.505025,36.987482,46.446204,288.826727,242.380523,0.345,41.306959,40.961959,43.408379,138.254931,94.846552,0.944364,14.940244,13.99588,1.595263,49.155311,47.560048,44.583118,138.292684,93.709566,354.90418,565.799578,210.895398,0.116215,1.853752,1.737537,0.400508,11.956022,11.555514,5.907175,9.469415,3.56224,0.218075,18.098574,17.880499,0.014022,0.372478,0.358456,0.067271,5.833692,5.766421,1.573929,11.160553,9.586624,0.044464,4.74526,4.700796,0.754237,5.522322,4.768085,4.167841,33.839335,29.671494,669.151979,186.453474,-482.698505,94.23419,320.237845,226.003655,,,,,,,2.098602,56.469622,54.37102,0.078033,26.382576,26.304543,0.02675,22.006997,21.980247,1101.708013,1129.457168,27.7491550000002,3094.826282,912.962318,-2181.863964,24.732711,24.696079,-0.0366319999999938,8.386876,26.649631,18.262755,0.000349,1.143341,1.142992,533.409341,427.783545,-105.625796,405.471595,511.852881,106.381286,37.817795,45.904271,8.08647600000002,647.79009,924.271249,276.481159,1958.058331,3086.290103,1128.231772,3.19675,141.484081,138.287331,17.916364,87.550898,69.634534,329.037138,518.226927,189.189789,0.000417,0.320392,0.319975,20.85246,17.937646,-2.914814,739.604084,490.698766,-248.905318,0.02424,0.063679,0.039439,568.48463,367.325881,-201.158749,348.7055,170.464124,-178.241376,4.885415,0.127903,-4.757512,518.689557,194.461737,-324.22782,4244.640483,4654.091163,409.450680000001,3063.783963,743.581875,-2320.202088,1617.791395,2610.964372,993.172977,1499.700755,2207.508013,707.807258,36.019621,120.058866,84.039245,0.059524,1.006187,0.946663,1.750895,1.739123,-0.0117720000000001,3886.973354,2360.525058,-1526.448296,7204.788525,4242.619272,-2962.169253,562.382277,168.324526,-394.057751,,,,201.267025,152.259902,-49.007123,136.567785,33.396079,-103.171706,216.88628,144.868464,-72.017816,19.864177,2.8585,-17.005677,1778.123589,1931.741189,153.6176,15.188903,16.080213,0.891310000000001,11.069174,20.957389,9.888215,66.792204,62.524693,-4.26751099999998,264.703579,266.393778,1.69019900000012,,,,1785.729336,463.583346,-1322.14599,61.815545,11.70166,-50.113885,68.628106,94.079209,25.451103,6.638542,18.307113,11.668571,118.443372,15.187149,-103.256223,13.236582,33.803411,20.566829,125.712906,33.660783,-92.052123,0.054356,5.079345,5.024989,0.435118,3.830788,3.39567,0.00223,5.276711,5.274481,3.231262,4.123391,0.892128999999999,0.569147,6.073079,5.503932,735.858913,780.778135,44.9192219999999,163.69696,79.801158,-83.895802,0.015022,70.415522,70.4005,27.048416,16.943978,-10.104438,0.163236,0.579526,0.41629,0.000943,0.160944,0.160001,2499.375164,1182.406584,-1316.96858,,,,28.299294,34.694958,6.395664,44.840209,30.599653,-14.240556,1.372364,10.09408,8.721716,1.209381,3.662177,2.452796,,,,10.341628,6.710248,-3.63138,0.013579,0.818016,0.804437,0.402321,1.242886,0.840565,3.239881,3.542169,0.302288,63.536751,96.288113,32.751362,78.557082,84.921432,6.36435,14.980678,15.977152,0.996474000000005,350.624332,698.243297,347.618965,0.647386,8.829673,8.182287,38.890249,28.450642,-10.439607,5.132716,149.92299,144.790274,1109.850525,119.112548,-990.737977,6.375621,9.089626,2.714005,565.1,563.7,-1.39999999999998,0.875713,0,-0.875713,0.010258,0.021631,0.011373,83.830787,110.084244,26.253457,719.827091,222.861483,-496.965608,,,,2582.662251,924.486103,-1658.176148,23.452231,283.246519,259.794288,94.534736,941.168005,846.633269,14.940007,29.879788,14.939781,56.862002,96.067394,39.205392,31.407765,59.99847,28.590705,6.152671,179.680931,173.52826,2457.136409,1450.471885,-1006.664524,261.604301,196.598537,-65.005764,5.521949,3.17526,-2.346689,369.467977,33.590775,-335.877202,164.26691,16.126465,-148.140445,0,0.479838,0.479838,1869.728436,745.938114,-1123.790322,927.78919,294.521511,-633.267679,2.722988,0.494132,-2.228856,177.252052,13.635787,-163.616265,2186.565123,1133.642624,-1052.922499,1322.26393,2658.640434,1336.376504,1388.651338,575.227596,-813.423742,0,0.198928,0.198928,1.218356,6.855133,5.636777,696.347758,616.115846,-80.231912,12.790937,17.999025,5.208088,0.000157,0.172342,0.172185,0.110201,1.367746,1.257545,24292.213197,7400.774615,-16891.438582,0.622407,5.658206,5.035799,0,0.280763,0.280763,3725.553571,3740.03586,14.4822890000009,321.711183,2148.804778,1827.093595,2600.522098,2189.409102,-411.112995999999,10484.962475,5073.197176,-5411.765299,740.768722,1929.992739,1189.224017,0,0.005597,0.005597,0.041226,0.035233,-0.00599299999999999,0.00211,0.114581,0.112471,0,0.025511,0.025511,8.58516,9.816918,1.231758,248.206098,208.907031,-39.2990670000001,0.009768,0.529158,0.51939,0.199765,0.177456,-0.022309,0.000254,0.08833,0.088076,0.134504,1.767114,1.63261,0.053252,2.257019,2.203767,0.303248,0.786682,0.483434,0.000217,0,-0.000217,0.085789,2.960653,2.874864,0.033203,0,-0.033203,6.007113,4.887697,-1.119416,0,0,0,4.088969,11.043312,6.954343,0.792593,2.447873,1.65528,0.236698,4.637607,4.400909,0.025773,2.27905,2.253277,0.000401,0.266439,0.266038,9.791479,3.471883,-6.319596,0.190856,4.101675,3.910819,47.979219,146.822189,98.84297,1263.95749,104.552887,-1159.404603,23.970355,56.455928,32.485573,250.234072,80.804723,-169.429349,174.658394,633.219747,458.561353,0.4973,12.39964,11.90234,,,,0,0,0,391.007052,23.110482,-367.89657,0.017715,3.887617,3.869902,6.678303,12.537399,5.859096,0.262396,33.723079,33.460683,1.498131,1.730336,0.232205,4.909491,8.508075,3.598584,0.691755,4.553863,3.862108,129.750988,18.191425,-111.559563,37.478651,50.36377,12.885119,0.752306,1.370754,0.618448,0.224218,3.081843,2.857625,0.087372,25.361327,25.273955,2728.864413,494.511446,-2234.352967,0.404215,1.074596,0.670381,145.45596,99.209305,-46.246655,158.293504,10.200589,-148.092915,1.462346,0.057071,-1.405275,0.2026,4.667895,4.465295,0.020018,36.135874,36.115856,1298.496417,114.683928,-1183.812489,456.278638,20.203595,-436.075043,0.013186,0.095378,0.082192,0.023157,0.2706,0.247443,0.00691,0.068948,0.062038,13.521466,22.094114,8.572648,1.853425,4.8584,3.004975,0.007832,1.358473,1.350641,0.186048,1.008075,0.822027,0,0.03607,0.03607,5.089572,17.304996,12.215424,0.029856,0.040847,0.010991,0.136462,27.380313,27.243851,4.162166,10.58095,6.418784,22.671569,43.587455,20.915886,0.529357,0.935819,0.406462,0.000241,0.664826,0.664585,4.499405,9.920276,5.420871,16.14456,3.592717,-12.551843,1.306874,18.414667,17.107793,11.690169,12.282203,0.592034000000004,0.00336,0.674652,0.671292,0.074417,0,-0.074417,0.548274,0.299485,-0.248789,0.000228,0.036955,0.036727,667.630745,413.143397,-254.487348,18.719185,12.460215,-6.25897,18.548986,2.292851,-16.256135,0.725391,4.575669,3.850278,10.251759,1.608881,-8.642878,3.246544,3.231994,-0.0145499999999998,5.604581,1.855577,-3.749004,24.199845,0.009842,-24.190003,0,0,0,,,
2010-04-01,13838.447106,4505.050657,-9333.396449,24771.261733,18949.878423,-5821.38331000001,153706,102397,-51309,11991.035416,0,-11991.035416,12642.315932,7462.306769,-5180.009163,26983.369608,21194.775056,-5788.59455200001,8411.839419,9568.389524,1156.550105,11027.116878,11428.431306,401.314427999998,42251.216202,34218.865926,-8032.35027599999,30271.069248,22558.980396,-7712.08885200001,7613.329309,2143.375934,-5469.953375,48817.797041,24994.035357,-23823.761684,153165.030786,102477.44178,-50687.589006,61002.019631,30053.598272,-30948.421359,1880.094109,2137.498572,257.404463,999.868895,2062.938693,1063.069798,5827.9,1249.2,-4578.7,0.332034,1.057409,0.725375,23656.975053,20970.195654,-2686.779399,0.078589,0,-0.078589,18594.241149,13248.670272,-5345.57087700001,352.993535,385.249097,32.2555619999998,3.331103,31.942685,28.611582,152.263428,229.034157,76.770729,268.163967,377.544836,109.380869,164.758464,104.133276,-60.625188,629.605011,478.856174,-150.748837,26.147236,479.430919,453.283683,1.423181,65.400712,63.977531,100.845124,274.275225,173.430101,0,40.414747,40.414747,31.902245,138.193038,106.290793,0.74203,16.174771,15.432741,1.23937,53.806452,52.567082,46.071686,116.361811,70.290125,312.309704,562.681032,250.371328,0.129074,3.966128,3.837054,0.890276,15.655174,14.764898,4.45108,9.542378,5.091298,0.475489,10.975747,10.500258,0,0.365325,0.365325,0.010105,4.965969,4.955864,1.653513,14.394994,12.741481,0.169199,5.084626,4.915427,0.931042,6.696597,5.765555,4.952198,33.582796,28.630598,604.121081,162.383563,-441.737518,72.722596,278.661848,205.939252,,,,,,,1.183962,29.125996,27.942034,0.419267,42.40449,41.985223,0.163849,18.638103,18.474254,1397.254633,1050.308069,-346.946564,2655.027493,887.39992,-1767.627573,24.333628,26.070503,1.73687499999999,8.896394,29.480405,20.584011,0.005118,1.376316,1.371198,751.589237,393.189999,-358.399238,419.361809,600.981623,181.619814,50.206064,41.84049,-8.365574,646.353431,879.965178,233.611747,2002.153874,2758.0564,755.902526,2.521623,139.219951,136.698328,21.593438,68.583297,46.989859,262.224097,561.851546,299.627449,1.527224,0.164943,-1.362281,13.330705,42.229524,28.898819,844.663718,388.426324,-456.237394,0,0.021025,0.021025,811.596573,264.109968,-547.486605,274.064042,131.774052,-142.28999,4.193944,0.095973,-4.097971,521.148083,187.655078,-333.493005,3822.72414,3799.581077,-23.1430630000004,2158.874751,802.998622,-1355.876129,1480.791084,2668.087293,1187.296209,1050.597984,2034.686815,984.088831,37.927521,113.953087,76.025566,0.018802,1.281155,1.262353,1.090485,10.619315,9.52883,3364.336342,2232.1913,-1132.145042,6678.888216,3686.276961,-2992.611255,507.852044,160.105859,-347.746185,,,,198.516261,95.917314,-102.598947,82.823272,13.111151,-69.712121,193.227068,103.935334,-89.291734,17.902012,1.181868,-16.720144,1480.049544,1457.474215,-22.5753289999996,21.466165,16.530493,-4.935672,19.631349,28.799775,9.168426,21.58037,57.949202,36.368832,238.142961,239.447008,1.30404699999994,,,,2169.511602,446.693993,-1722.817609,6.511332,13.970564,7.459232,119.220588,114.938721,-4.28186699999998,7.505358,26.234005,18.728647,222.812327,14.468769,-208.343558,3.5063,23.620899,20.114599,251.887915,37.848889,-214.039026,0.050869,4.688308,4.637439,0.449647,2.791722,2.342075,0.000574,1.407185,1.406611,0.801493,2.776679,1.975186,0.83473,2.810061,1.975331,598.79906,810.356758,211.557698,179.720401,63.544367,-116.176034,0.283753,177.639399,177.355646,20.920284,41.919725,20.999441,0.30471,0.313016,0.00830600000000004,0.035954,0.025152,-0.010802,2279.280167,1101.108696,-1178.171471,,,,23.540815,24.936711,1.395896,33.88851,11.996934,-21.891576,2.785703,0.989851,-1.795852,1.209233,2.719412,1.510179,,,,19.978162,13.575619,-6.402543,0.02146,0.221234,0.199774,0.531633,1.276181,0.744548,5.390099,5.479692,0.0895929999999998,56.639616,82.778883,26.139267,68.511282,53.21133,-15.299952,14.820706,16.822396,2.00169,334.451193,912.662868,578.211675,1.426336,6.712589,5.286253,1.566115,22.210623,20.644508,5.222412,197.415674,192.193262,1243.060553,126.27939,-1116.781163,5.731727,11.215298,5.483571,526,513.6,-12.4,0.750275,0.002993,-0.747282,0.101184,0.08273,-0.018454,76.448687,109.023121,32.574434,544.111825,238.266564,-305.845261,,,,2995.115367,999.798623,-1995.316744,56.203646,287.250342,231.046696,77.5109,1007.154837,929.643937,0.39062,23.373035,22.982415,15.910383,66.104892,50.194509,38.98264,46.007801,7.025161,7.704644,202.533303,194.828659,2652.531622,1674.752576,-977.779046,287.882102,136.274824,-151.607278,4.754343,1.090321,-3.664022,356.405146,45.104861,-311.300285,148.100408,14.975014,-133.125394,0,0.931041,0.931041,1786.501412,748.111115,-1038.390297,1037.003998,323.620839,-713.383159,5.649248,1.684901,-3.964347,170.234647,12.105271,-158.129376,2137.860461,1157.303721,-980.55674,1390.980964,2287.808962,896.827998,1341.055035,517.800949,-823.254086,0,0.450263,0.450263,0.695971,17.795562,17.099591,579.638588,584.238118,4.59952999999996,12.472561,22.709829,10.237268,0.101537,0.270244,0.168707,0.149193,1.73393,1.584737,25920.188141,6600.725426,-19319.462715,0.434481,4.614729,4.180248,0,0,0,3888.43187,3183.543547,-704.888322999998,349.084074,2061.961045,1712.876971,2783.342511,2035.07597,-748.266541,9441.981641,4493.850674,-4948.130967,675.718268,1829.834251,1154.115983,0.005779,0.056878,0.051099,0.080193,0,-0.080193,0.010504,0.192291,0.181787,0,0.057849,0.057849,8.763565,18.706409,9.942844,287.583391,182.680894,-104.902497,0.028971,0.191509,0.162538,0.23416,0.08882,-0.14534,0.00005,0.125686,0.125636,0.151171,1.404471,1.2533,0.086729,0.189985,0.103256,0.020422,0.377749,0.357327,0,0,0,0.072191,0.104635,0.032444,0,0.076686,0.076686,5.95036,7.674549,1.724189,0,0.081519,0.081519,4.08176,10.875593,6.793833,1.415134,1.38595,-0.0291839999999999,0.353922,3.208303,2.854381,0.016364,1.169859,1.153495,0.002016,0.072507,0.070491,15.12295,2.376298,-12.746652,0.156404,1.345996,1.189592,60.204146,202.470391,142.266245,1085.291165,55.969198,-1029.321967,62.693215,45.563561,-17.129654,299.501201,97.656135,-201.845066,229.804833,524.34933,294.544497,0.898551,3.764347,2.865796,,,,0,0.048427,0.048427,74.768061,16.256495,-58.511566,0.01247,3.973606,3.961136,4.72545,11.60603,6.88058,0.355702,9.014259,8.658557,0.310673,12.956592,12.645919,7.796925,7.445492,-0.351433,0.773098,4.545789,3.772691,116.531804,9.038175,-107.493629,16.1667,90.405559,74.238859,0.359531,2.182568,1.823037,0.033447,11.934076,11.900629,0.142418,8.15982,8.017402,2560.391659,323.62078,-2236.770879,0.318387,0.860348,0.541961,0.666554,11.844976,11.178422,195.842678,10.881583,-184.961095,0.742272,0.034838,-0.707434,0.169997,1.958038,1.788041,0.0616,42.119354,42.057754,1518.245449,112.601727,-1405.643722,547.439771,20.09174,-527.348031,0.004191,0.02739,0.023199,0.006073,0.158243,0.15217,0.000015,0.07242,0.072405,0.341142,7.353196,7.012054,118.0411,4.990908,-113.050192,0.022781,0.466866,0.444085,0.222354,0.157759,-0.064595,0.000231,0.01269,0.012459,6.900926,19.542669,12.641743,0,0.52896,0.52896,0.014544,18.730075,18.715531,6.046522,4.717282,-1.32924,22.370437,21.424283,-0.946154,0.305758,0.750606,0.444848,0.000142,0.104025,0.103883,3.442178,12.303798,8.86162,16.518263,4.130083,-12.38818,4.553754,16.917168,12.363414,8.366163,9.025761,0.659597999999999,0.015693,0.404387,0.388694,0.011796,0.009019,-0.002777,0.490064,0.378142,-0.111922,0,0.10166,0.10166,531.668934,393.687142,-137.981792,3.252518,7.147982,3.895464,16.243552,2.714768,-13.528784,2.090572,3.192343,1.101771,6.694228,1.542805,-5.151423,1.979495,1.602297,-0.377197999999999,6.75656,0.990116,-5.766444,24.465105,0.020286,-24.444819,0,10.193844,10.193844,,,
2010-05-01,12494.722719,4659.628953,-7835.093766,25738.823416,19431.316301,-6307.507115,158128,105517,-52611,12046.901515,0,-12046.901515,13012.41237,7521.758329,-5490.654041,27501.517019,21761.138392,-5740.378627,8903.540494,9759.906553,856.366059,10619.383569,11893.940501,1274.556932,43077.302402,34650.638722,-8426.66368,31292.977425,23411.938225,-7881.03920000001,6991.417726,2206.374748,-4785.042978,51737.008794,26057.587319,-25679.421475,156153.200886,105463.276426,-50689.9244600001,63116.651982,31227.244784,-31889.407198,2023.033834,2144.136382,121.102547999999,1054.523015,2072.641024,1018.118009,5483.6,1485.4,-3998.2,0.391091,0.498422,0.107331,23658.132044,21371.313356,-2286.818688,0.553676,0,-0.553676,19419.170358,13279.325366,-6139.844992,315.331899,412.005778,96.673879,4.278985,23.042902,18.763917,180.263035,193.427264,13.164229,336.890268,410.186478,73.2962100000001,160.067313,79.04603,-81.021283,735.24134,483.280423,-251.960917,37.523883,577.153582,539.629699,1.662837,45.522815,43.859978,116.882476,329.385074,212.502598,0,24.022046,24.022046,28.568263,145.744402,117.176139,0.609883,14.811719,14.201836,2.474005,48.205375,45.73137,46.908232,109.55355,62.645318,295.239979,566.190409,270.95043,0.195387,4.110676,3.915289,0.557249,9.140815,8.583566,5.139463,7.222457,2.082994,0.542246,10.307173,9.764927,0.030408,0.350505,0.320097,0.424613,5.329656,4.905043,1.478168,11.532486,10.054318,0.065579,8.781993,8.716414,1.021985,6.029571,5.007586,2.241893,33.544138,31.302245,479.416849,152.556389,-326.86046,143.079583,229.741197,86.661614,,,,,,,1.518621,74.226324,72.707703,0.037673,33.984237,33.946564,2.961065,40.160137,37.199072,1195.590589,906.041211,-289.549378,3070.203441,1007.484465,-2062.718976,21.208318,22.666155,1.457837,16.952802,29.961212,13.00841,0.000121,1.598103,1.597982,490.379508,439.637981,-50.7415269999999,250.008353,506.232043,256.22369,22.540654,59.824606,37.283952,526.405404,1051.916363,525.510959,1884.080807,2916.911706,1032.830899,2.734856,178.791861,176.057005,20.525916,70.246415,49.720499,218.09962,613.529242,395.429622,0,0.503537,0.503537,16.294673,15.459216,-0.835457,931.820522,429.30252,-502.518002,0,0.959385,0.959385,671.444804,201.755588,-469.689216,344.675332,172.882535,-171.792797,5.810376,0.169135,-5.641241,456.534096,168.948792,-287.585304,3702.65966,3811.050211,108.390551000001,2886.463278,686.691333,-2199.771945,1479.134372,2719.31464,1240.180268,1289.575207,2063.904819,774.329611999999,48.106043,161.752643,113.6466,0.019307,0.510049,0.490742,0.91623,2.541288,1.625058,2867.51405,2242.32412,-625.18993,6795.180317,3799.048584,-2996.131733,584.696248,238.545543,-346.150705,,,,198.266213,108.619963,-89.64625,76.497484,14.186531,-62.310953,184.629515,92.848859,-91.780656,17.776862,1.366124,-16.410738,1460.40345,1731.746384,271.342934,10.319017,12.621113,2.302096,10.086585,19.367286,9.280701,60.638166,47.173431,-13.464735,294.911175,209.949699,-84.961476,,,,2492.458178,496.035449,-1996.422729,9.433258,8.273759,-1.159499,164.096365,117.87517,-46.221195,4.909447,7.920441,3.010994,88.494001,18.079469,-70.414532,12.676454,34.774358,22.097904,230.624407,42.805183,-187.819224,0.032441,4.38975,4.357309,0.888753,1.602308,0.713555,0.001476,1.014218,1.012742,2.140102,3.773002,1.6329,15.695681,8.938275,-6.757406,755.761771,787.711673,31.9499020000001,156.724623,65.698938,-91.0256850000001,0.000935,258.429384,258.428449,23.112504,78.563321,55.450817,0.374433,0.412935,0.0385019999999999,0.031455,0.166765,0.13531,2374.24008,1317.202853,-1057.037227,,,,22.51062,38.53972,16.0291,37.97986,14.566472,-23.413388,2.499429,4.324641,1.825212,0.939091,2.085917,1.146826,,,,11.004895,11.106862,0.101967000000002,0,0.75534,0.75534,0.398787,2.128991,1.730204,3.010085,7.636911,4.626826,70.195122,74.990446,4.79532400000002,82.468282,71.977914,-10.490368,16.072665,14.648453,-1.424212,319.268014,955.045907,635.777893,0.561229,7.423609,6.86238,71.638821,19.754108,-51.884713,7.235385,159.946358,152.710973,778.637073,99.724776,-678.912297,4.16751,9.012227,4.844717,612.7,498,-114.7,0.005932,1.82752,1.821588,0.196408,0.02962,-0.166788,62.004587,104.320849,42.316262,489.081392,368.584607,-120.496785,,,,2695.679677,919.428087,-1776.25159,19.039069,263.183644,244.144575,88.427301,923.593424,835.166123,11.143392,26.449464,15.306072,18.030465,79.50618,61.475715,20.196639,69.45956,49.262921,9.952263,175.257402,165.305139,2685.465778,1841.192357,-844.273421,286.558133,164.139216,-122.418917,3.52957,2.616752,-0.912818000000001,311.602866,50.314394,-261.288472,114.798888,13.853833,-100.945055,0,0.665762,0.665762,1666.166811,679.393555,-986.773256,1162.362222,304.306827,-858.055395,4.49435,1.014828,-3.479522,133.497971,10.480921,-123.01705,2177.855369,1185.149259,-992.70611,1547.775542,2470.016493,922.240951,1314.83976,517.38367,-797.45609,0,0.901736,0.901736,0.29392,13.65649,13.36257,608.280424,594.639858,-13.6405660000001,10.017453,15.706435,5.688982,0.054333,0.327082,0.272749,0.08852,3.589681,3.501161,29052.438345,6755.285795,-22297.15255,0.107614,6.458287,6.350673,0,0,0,4120.265103,3307.48845,-812.776652999999,329.191638,1961.451475,1632.259837,2906.308211,2020.950135,-885.358076,8640.577073,5193.089945,-3447.487128,757.071609,1818.283643,1061.212034,0.004145,0.097174,0.093029,0.009382,0.027929,0.018547,0.09827,0.431338,0.333068,0.003552,0.16969,0.166138,6.212292,10.799271,4.586979,265.882055,193.6864,-72.195655,0.024291,0.302409,0.278118,0.302862,0.077622,-0.22524,0.000601,0.084097,0.083496,0.238075,1.390255,1.15218,0.035987,0.010997,-0.02499,0.467335,0.325968,-0.141367,0.000918,0,-0.000918,0.004955,0.34501,0.340055,0.000486,0.032414,0.031928,6.757278,8.623024,1.865746,0,0.021132,0.021132,3.409475,10.778289,7.368814,0.987166,18.055403,17.068237,0.922092,3.403812,2.48172,0.004766,1.196255,1.191489,0.002251,0.327145,0.324894,11.98929,3.02571,-8.96358,0.09564,1.304472,1.208832,47.643656,98.40163,50.757974,1142.915748,91.083259,-1051.832489,28.256261,43.305278,15.049017,322.508744,57.376947,-265.131797,161.847609,433.431926,271.584317,0.4982,4.589752,4.091552,,,,0,0,0,162.642907,31.842027,-130.80088,0.026257,3.943326,3.917069,28.464585,12.642397,-15.822188,0.394482,6.195356,5.800874,0.267116,1.611467,1.344351,0.95907,5.73384,4.77477,0.433231,3.791734,3.358503,85.847083,14.265197,-71.581886,19.672549,102.417185,82.744636,0.098048,3.707623,3.609575,0.084157,5.913383,5.829226,7.992428,60.386251,52.393823,2512.61693,381.771351,-2130.845579,0.598869,2.230208,1.631339,169.619966,17.483897,-152.136069,172.107298,8.952754,-163.154544,0.086343,0.095076,0.00873299999999999,0.248786,9.440173,9.191387,0.03528,50.720675,50.685395,1077.985814,102.582513,-975.403301,380.942709,24.707786,-356.234923,0,0.025689,0.025689,0.118029,0.436021,0.317992,0.163545,0.072045,-0.0915000000000001,15.357051,7.646178,-7.710873,2.158102,9.086446,6.928344,0.301394,1.541509,1.240115,0.553864,0.911333,0.357469,0.000173,0.01748,0.017307,6.216461,24.528965,18.312504,0.004585,0.091018,0.086433,0.014947,14.394881,14.379934,8.773844,6.760608,-2.013236,17.582642,25.041144,7.458502,0.270885,0.70247,0.431585,0.562757,0.119194,-0.443563,2.669484,11.941053,9.271569,12.890702,2.874804,-10.015898,9.458306,17.678166,8.21986,10.534081,19.798664,9.26458299999999,0,0.584197,0.584197,0,0.079392,0.079392,0.890888,0.661685,-0.229203,0.000034,0.077039,0.077005,724.428058,456.004999,-268.423059,5.863105,10.914752,5.051647,9.227121,2.741548,-6.485573,2.166805,6.147767,3.980962,5.585321,1.304426,-4.280895,2.022001,2.937653,0.915652000000001,2.652204,3.586748,0.934544000000001,18.68626,0.093351,-18.592909,0,0,0,,,
2010-06-01,13518.324722,4582.853898,-8935.470824,27709.511712,20334.693122,-7374.81859,162202,104494,-57708,11983.996031,0,-11983.996031,13295.432419,7790.674294,-5504.758125,31640.088799,23364.040413,-8276.04838600001,9451.587056,10039.001553,587.414496999998,11090.240454,11292.368733,202.128278999999,44742.667311,36167.029905,-8575.63740599999,33130.50576,24157.361746,-8973.14401399999,6922.221094,1967.711891,-4954.509203,57819.614175,26074.895077,-31744.719098,168323.631277,107153.195142,-61170.4361350002,71412.707462,31527.414376,-39885.293086,2129.378725,1957.15863,-172.220095,1024.122756,2040.853684,1016.730928,5205.6,1230.5,-3975.1,1.010527,0.4515,-0.559027,24693.616035,22275.222785,-2418.39324999999,0.155913,0.003307,-0.152606,20049.051276,13891.80712,-6157.24415599999,294.359528,316.289742,21.930214,14.216533,26.855101,12.638568,196.879634,212.457331,15.577697,367.109925,379.473484,12.3635590000001,171.622497,82.763253,-88.859244,747.499786,420.82105,-326.678736,29.913996,444.775385,414.861389,0.799039,49.511884,48.712845,68.60419,271.164195,202.560005,0.002081,33.211507,33.209426,27.655946,125.843531,98.187585,0.831454,14.84212,14.010666,0.936617,43.408939,42.472322,60.746215,105.052742,44.306527,351.907355,545.35377,193.446415,0.097552,2.533577,2.436025,1.390399,13.515714,12.125315,4.413963,7.558737,3.144774,0.347719,9.489957,9.142238,0.002798,0.436066,0.433268,0.037604,6.289869,6.252265,1.513668,44.158921,42.645253,0.091925,5.4254,5.333475,1.204987,6.451352,5.246365,3.129633,31.047054,27.917421,494.722833,152.09278,-342.630053,73.415855,194.830558,121.414703,,,,,,,2.075797,41.070536,38.994739,0.169385,30.571903,30.402518,2.961292,27.679447,24.718155,1367.278763,847.376416,-519.902347,2534.947287,857.184622,-1677.762665,27.000533,42.373803,15.37327,6.309414,28.74062,22.431206,0.000003,2.687001,2.686998,632.253376,517.345609,-114.907767,420.565487,485.65845,65.0929630000001,67.25668,33.296631,-33.960049,589.014672,933.393037,344.378365,2216.960623,3025.396017,808.435394000001,4.187,132.41237,128.22537,27.049015,92.360609,65.311594,278.756633,649.008171,370.251538,0.000762,0.159472,0.15871,17.782481,27.78574,10.003259,1027.558687,372.322923,-655.235764,0,0.020532,0.020532,439.586722,247.657533,-191.929189,370.013249,167.689404,-202.323845,7.818594,0.211557,-7.607037,527.591842,166.265649,-361.326193,4558.575284,4192.163913,-366.411370999999,2899.121445,555.430774,-2343.690671,1630.456135,3177.213591,1546.757456,1498.255997,2342.749962,844.493965,34.919596,146.01088,111.091284,0.016577,0.986853,0.970276,1.12665,22.923335,21.796685,3171.962768,2050.534288,-1121.42848,6798.469855,4118.062813,-2680.407042,612.481224,138.494126,-473.987098,,,,205.594318,101.757347,-103.836971,72.60362,13.589223,-59.014397,213.724444,92.14339,-121.581054,18.346802,1.356852,-16.98995,1506.496115,1697.230027,190.733912,14.102677,11.29619,-2.806487,11.303657,30.744647,19.44099,15.732122,38.729628,22.997506,233.4977,254.254713,20.757013,,,,2475.361711,474.915949,-2000.445762,4.525273,7.75807,3.232797,46.503471,110.328135,63.824664,5.323006,6.941938,1.618932,212.617181,11.021001,-201.59618,20.722775,29.466271,8.743496,217.718862,87.232865,-130.485997,0.436696,13.476482,13.039786,1.075014,5.256457,4.181443,0.024466,8.617134,8.592668,2.149006,3.871007,1.722001,18.258698,10.433255,-7.825443,850.731582,807.355212,-43.3763699999998,236.456993,76.880781,-159.576212,0.013347,73.850727,73.83738,23.512704,7.103349,-16.409355,0.404196,0.091964,-0.312232,0,0.600703,0.600703,2504.196584,1262.696793,-1241.499791,,,,28.64046,23.805356,-4.835104,41.958552,31.791453,-10.167099,2.748457,1.024823,-1.723634,1.494913,3.647712,2.152799,,,,11.461016,7.632899,-3.828117,0.001051,1.129842,1.128791,0.510527,0.915802,0.405275,3.020024,7.017096,3.997072,53.617255,106.112664,52.495409,86.885303,49.926642,-36.958661,15.169536,14.116132,-1.053404,376.809957,935.460707,558.65075,1.018583,9.256635,8.238052,30.423814,47.235498,16.811684,5.840894,174.810712,168.969818,1560.203246,93.290286,-1466.91296,5.414403,10.061115,4.646712,528.4,531.7,3.30000000000007,0.012727,0,-0.012727,0.303842,0.07092,-0.232922,82.25452,90.179223,7.92470299999997,546.441791,309.458428,-236.983363,,,,2906.37692,984.658945,-1921.717975,4.501057,342.765569,338.264512,92.874257,917.586731,824.712474,22.043774,24.171348,2.127574,17.186428,85.980664,68.794236,25.848033,144.775105,118.927072,8.67807,152.032286,143.354216,2524.691412,1699.001669,-825.689743,339.804724,147.163723,-192.641001,4.95114,1.670226,-3.280914,382.185742,55.607375,-326.578367,124.056493,14.984014,-109.072479,0,0.769749,0.769749,1916.427221,676.510038,-1239.917183,1260.201535,268.430923,-991.770612,5.486665,1.082402,-4.404263,196.736407,12.566072,-184.170335,2212.35781,1251.292964,-961.064846,1350.489695,2393.337493,1042.847798,1394.30868,469.413615,-924.895065,0,0.40941,0.40941,0.383249,8.543932,8.160683,692.225898,570.130386,-122.095512,10.363165,13.196212,2.833047,0.030591,0.144915,0.114324,0.082929,2.575601,2.492672,32843.100035,6733.718548,-26109.381487,3.080286,6.575778,3.495492,0.008363,0,-0.008363,4403.102607,3308.150331,-1094.952276,357.425592,2321.096981,1963.671389,3340.569162,2016.416748,-1324.152414,10217.846615,5009.662396,-5208.184219,701.944185,1770.943651,1068.999466,0,0.046308,0.046308,0.417716,0.098071,-0.319645,0.000143,0.01761,0.017467,0,0.005325,0.005325,4.784442,25.438665,20.654223,290.71304,183.553155,-107.159885,0.084616,0.691305,0.606689,0.123069,0.091848,-0.031221,0.016597,0.016463,-0.000134000000000006,0.452727,1.781464,1.328737,0.134481,0.074957,-0.059524,0.058724,14.934508,14.875784,0,0.001716,0.001716,0.055017,0.04427,-0.010747,0,0.015738,0.015738,6.884264,7.5749,0.690636,0,0.067355,0.067355,2.457739,13.544004,11.086265,1.218405,11.869552,10.651147,0.448769,3.901209,3.45244,0.000079,1.165217,1.165138,0.087499,0.346911,0.259412,14.095603,2.28347,-11.812133,0.132984,1.953152,1.820168,56.753463,150.143936,93.390473,1237.754246,122.363446,-1115.3908,30.447355,33.641522,3.19416699999999,477.392012,152.2758,-325.116212,178.100015,383.265141,205.165126,0.6737,0.923094,0.249394,,,,0,0,0,117.042485,24.24986,-92.792625,0.032074,3.913524,3.88145,69.63667,15.311184,-54.325486,0.399085,20.405196,20.006111,0.12696,1.447005,1.320045,7.459456,10.33691,2.877454,2.640279,4.564104,1.923825,39.167364,25.073612,-14.093752,26.77807,71.830455,45.052385,0.122668,2.555461,2.432793,0.399436,4.879399,4.479963,0.061127,6.643453,6.582326,2653.801355,294.402145,-2359.39921,0.717135,0.320954,-0.396181,38.461528,13.917373,-24.544155,79.239306,8.493714,-70.745592,0.257233,0.045795,-0.211438,0.589093,3.815026,3.225933,0.014368,34.809544,34.795176,1130.75123,87.056316,-1043.694914,277.851437,16.846259,-261.005178,0.107676,0.206525,0.098849,0.229981,0.037521,-0.19246,0.03313,0.16523,0.1321,12.397255,13.205691,0.808435999999997,35.102259,7.000933,-28.101326,0.052539,0.484705,0.432166,0.533718,1.618335,1.084617,0.022336,0.025275,0.002939,5.541395,118.733601,113.192206,0.04986,0.055904,0.00604399999999999,0.539679,11.596623,11.056944,3.692767,8.505426,4.812659,28.436514,27.211262,-1.225252,0.353292,0.669999,0.316707,0.022227,0.045311,0.023084,3.159158,15.784238,12.62508,14.804616,2.80892,-11.995696,2.758441,19.258857,16.500416,7.199999,5.13197,-2.068029,0,0.425971,0.425971,0.000167,0.025371,0.025204,0.326962,0.579388,0.252426,0,0.015893,0.015893,601.655207,424.092436,-177.562771,2.417559,11.246965,8.829406,12.915121,3.810335,-9.104786,0.311055,5.661656,5.350601,8.884701,1.371256,-7.513445,1.392264,2.858282,1.466018,1.796949,2.14588,0.348931,11.600914,0.028465,-11.572449,0,0,0,,,
2010-07-01,12405.387435,4366.733412,-8038.654023,28484.639315,18784.609281,-9700.03003399999,159664,107246,-52418,10693.191556,0,-10693.191556,10588.938263,6713.82988,-3875.108383,30666.559584,23928.491246,-6738.06833799999,9414.540912,10424.744517,1010.203605,11563.252518,11711.797297,148.544778999996,39513.391098,32854.275971,-6659.115127,34467.544852,22267.261704,-12200.283148,7403.648043,2170.126661,-5233.521382,58152.988277,27521.451885,-30631.536392,163909.987758,104051.18442,-59858.8033380001,69828.146998,32954.544779,-36873.602219,2060.062592,1910.875684,-149.186908,1132.488435,2092.811694,960.323258999999,5563,1365.5,-4197.5,1.280147,0.366314,-0.913833,21299.574779,19643.939915,-1655.634864,0.235667,0,-0.235667,18213.816319,13210.336056,-5003.48026300001,288.066099,328.801484,40.7353850000001,11.281855,20.460198,9.178343,226.876181,201.832558,-25.043623,345.813404,374.84628,29.032876,195.427169,64.724582,-130.702587,685.674566,411.573323,-274.101243,32.432504,378.629663,346.197159,0.551152,87.900925,87.349773,75.04641,255.517319,180.470909,0,20.169878,20.169878,26.259077,145.349709,119.090632,0.585835,15.286436,14.700601,0.428725,52.415797,51.987072,50.809986,93.39521,42.585224,318.205173,529.097457,210.892284,0.106126,3.600848,3.494722,0.330068,10.78752,10.457452,4.749762,8.102437,3.352675,0.330858,17.631254,17.300396,0.215831,0.443875,0.228044,0.164227,6.179175,6.014948,1.416118,27.198454,25.782336,0.36126,9.234574,8.873314,0.812124,5.835165,5.023041,3.000175,31.119467,28.119292,533.505834,159.62505,-373.880784,62.517071,170.732547,108.215476,,,,,,,0.307242,24.800027,24.492785,0.25085,35.02829,34.77744,0.037892,21.749379,21.711487,1412.406862,1022.474645,-389.932217,2619.316168,832.669026,-1786.647142,19.762621,22.219945,2.457324,17.833849,32.196,14.362151,0.005138,3.859872,3.854734,772.693697,431.716345,-340.977352,464.052986,596.57302,132.520034,64.186746,38.772754,-25.413992,612.281626,994.163487,381.881861,2400.252114,3365.250673,964.998558999999,4.154597,149.73762,145.583023,20.336214,81.318282,60.982068,289.506871,628.596991,339.09012,0.899455,0.179756,-0.719699,13.853561,26.482336,12.628775,1075.971246,319.426426,-756.54482,0.0004,0.092137,0.091737,659.435229,203.804296,-455.630933,428.005885,190.801966,-237.203919,4.70341,0.3275,-4.37591,536.615816,168.75569,-367.860126,4402.42667,4041.471964,-360.954706,2727.614951,403.213685,-2324.401266,1895.429569,2841.905378,946.475809,1539.491395,2008.801454,469.310059,57.081718,94.440325,37.358607,0.014204,0.88521,0.871006,1.626614,1.892056,0.265442,3256.897145,1981.324753,-1275.572392,7245.38636,3790.481118,-3454.905242,626.244543,148.642365,-477.602178,,,,228.218161,113.590689,-114.627472,70.813536,12.7109,-58.102636,221.199191,110.78628,-110.412911,16.308363,1.508489,-14.799874,1443.804853,1574.07147,130.266617,49.635254,16.954782,-32.680472,11.028882,23.343348,12.314466,26.351199,27.319449,0.968249999999994,233.834612,232.339229,-1.49538300000006,,,,2666.871416,502.41072,-2164.460696,6.819296,7.85297,1.033674,156.48824,135.827697,-20.660543,10.166502,3.573601,-6.592901,354.623384,23.457478,-331.165906,24.854964,13.392711,-11.462253,240.698069,69.47266,-171.225409,0.362234,12.223663,11.861429,1.658786,2.034913,0.376127,0.0057,10.034728,10.029028,4.534696,4.65294,0.118244000000001,0.440194,4.705598,4.265404,856.813248,782.896996,-73.9162520000002,189.293067,83.952665,-105.340402,0.109502,28.421052,28.31155,22.242863,81.49451,59.251647,0.450035,0.468146,0.018111,0,0.077937,0.077937,2571.823335,1124.018576,-1447.804759,,,,31.893889,29.15584,-2.73804900000002,36.190376,14.257201,-21.933175,2.71268,1.244863,-1.467817,4.017957,1.962592,-2.055365,,,,8.47205,7.27734,-1.19471,0,0.582134,0.582134,0.46532,0.925227,0.459907,1.285081,2.530706,1.245625,63.086062,104.384853,41.298791,92.156419,48.576718,-43.579701,19.731124,12.452063,-7.279061,326.228908,811.303413,485.074505,1.056688,6.265898,5.20921,2.035875,30.534044,28.498169,7.664999,201.606943,193.941944,906.533624,136.008565,-770.525059,4.482135,13.433511,8.951376,723.4,462.1,-261.3,0,0,0,0.419914,0.054635,-0.365279,91.390325,97.099963,5.70963799999998,385.477886,283.493886,-101.984,,,,2451.706819,813.447407,-1638.259412,4.688281,279.610935,274.922654,113.961278,1054.587795,940.626517,39.245298,21.093857,-18.151441,32.518968,80.289046,47.770078,30.980182,204.464057,173.483875,2.084474,172.63023,170.545756,2596.04967,1815.491692,-780.557977999999,317.917012,210.51707,-107.399942,5.04111,1.365884,-3.675226,331.798131,51.388546,-280.409585,149.634557,13.083861,-136.550696,0,0.810929,0.810929,1899.642688,758.445322,-1141.197366,1380.695311,289.959664,-1090.735647,5.187459,1.393336,-3.794123,202.151244,12.875527,-189.275717,2190.96324,1294.428837,-896.534403000001,1499.553192,2680.283763,1180.730571,1358.074626,687.803559,-670.271067,0,0.213782,0.213782,3.553364,12.199795,8.646431,705.677202,559.73081,-145.946392,12.028377,17.177136,5.148759,0.088084,0.380525,0.292441,0.063016,3.292605,3.229589,33266.833594,7339.256032,-25927.577562,0.911274,7.232961,6.321687,0,0,0,4457.078875,3409.981351,-1047.097524,365.674383,2137.505298,1771.830915,3092.234462,2196.974105,-895.260357000001,10091.162484,5130.069965,-4961.092519,841.320488,1788.478031,947.157543,0,0.064603,0.064603,0.247023,0.077612,-0.169411,0.000522,0.134884,0.134362,0.000008,0.061548,0.06154,2.888319,6.696217,3.807898,265.945671,260.866986,-5.07868500000006,0.055941,0.268628,0.212687,0.276512,0.197525,-0.078987,0,0.119524,0.119524,0.438002,1.786834,1.348832,0.146418,0.207214,0.060796,0.078055,0.348944,0.270889,0,0.000319,0.000319,0.046866,0.095782,0.048916,0.000274,0.033616,0.033342,2.66607,7.785851,5.119781,0.002952,0.014249,0.011297,2.395633,7.876463,5.48083,1.115778,9.420303,8.304525,0.366306,2.897369,2.531063,0.001108,0.693983,0.692875,0.006409,0.347249,0.34084,14.328968,3.327608,-11.00136,0.161919,1.038119,0.8762,37.388691,103.603248,66.214557,1412.970699,91.093211,-1321.877488,83.389569,42.74574,-40.643829,481.582637,76.921987,-404.66065,145.876079,529.719429,383.84335,1.949237,1.462008,-0.487229,,,,0,0,0,227.061985,29.314725,-197.74726,0.064112,31.085159,31.021047,50.717386,4.434517,-46.282869,0.497417,26.883796,26.386379,0.251358,2.368039,2.116681,5.464766,6.87593,1.411164,6.305537,4.115103,-2.190434,53.648671,15.101956,-38.546715,17.132983,83.490097,66.357114,0.082254,1.987945,1.905691,0.205904,3.737844,3.53194,0.015748,6.597065,6.581317,2700.365069,296.828858,-2403.536211,0.39757,1.071594,0.674024,86.813347,11.658359,-75.154988,188.896608,3.250941,-185.645667,0.138278,0.143133,0.004855,0.043971,1.393183,1.349212,0.041774,35.943477,35.901703,872.896146,97.315429,-775.580717,208.035839,24.396077,-183.639762,0.185164,0.088774,-0.09639,0.183352,0.206258,0.022906,0.000661,0.040954,0.040293,11.160143,12.54517,1.385027,73.359331,11.330556,-62.028775,0.002687,2.4517,2.449013,1.246649,12.99813,11.751481,0.000343,0.328814,0.328471,8.116864,58.349662,50.232798,0.000983,0.153113,0.15213,0.057789,7.495543,7.437754,3.308407,6.481961,3.173554,31.539298,22.83454,-8.704758,0.408928,0.859637,0.450709,0.21859,0.004471,-0.214119,1.752483,18.546833,16.79435,20.323445,3.214263,-17.109182,2.917333,11.39033,8.472997,8.543802,9.509608,0.965806000000001,0,0.174976,0.174976,0.005727,0.14728,0.141553,0.325022,0.641264,0.316242,0,0.03918,0.03918,888.819582,501.613334,-387.206248,7.502137,5.636065,-1.866072,11.869288,3.651911,-8.217377,3.122399,4.949494,1.827095,15.134143,1.850652,-13.283491,1.110631,4.501627,3.390996,7.861511,4.497911,-3.3636,38.24024,0.018401,-38.221839,0,0,0,,,
2010-08-01,13549.159239,4571.31673,-8977.842509,27552.768532,19356.401718,-8196.36681399999,164528,107428,-57100,12165.974923,0,-12165.974923,12197.78294,7329.916194,-4867.866746,30694.983328,21941.22155,-8753.761778,9440.10355,9941.165824,501.062274,11655.27596,11819.606936,164.330975999999,43709.18997,35391.782186,-8317.40778400001,33157.199028,23308.23216,-9848.966868,7970.62476,2639.386644,-5331.238116,60986.497989,26482.619912,-34503.878077,171004.09837,106871.289849,-64132.808521,73578.795172,31635.213308,-41943.581864,2196.033814,1907.934606,-288.099208,932.35445,2013.909859,1081.555409,6125.7,1711.5,-4414.2,0.617431,1.852204,1.234773,23457.003102,21214.167186,-2242.835916,0.041599,0.003859,-0.03774,20252.186868,14177.615,-6074.571868,313.228066,378.521863,65.2937969999999,14.746689,27.021128,12.274439,219.683405,191.274492,-28.408913,352.136836,397.357621,45.220785,178.926167,84.87517,-94.050997,801.916115,375.449531,-426.466584,38.377634,488.490027,450.112393,1.486666,70.045992,68.559326,52.32989,227.185151,174.855261,0,28.590025,28.590025,23.477624,126.914359,103.436735,0.441959,13.007447,12.565488,1.029322,39.99377,38.964448,51.302937,90.700147,39.39721,330.143225,480.455929,150.312704,0.090851,3.698728,3.607877,0.124139,9.164724,9.040585,3.977794,8.224978,4.247184,1.371991,8.55785,7.185859,0.007022,0.232891,0.225869,0.034554,7.576469,7.541915,1.741746,83.568866,81.82712,0.149372,8.002535,7.853163,0.457964,4.259198,3.801234,3.508094,29.634367,26.126273,525.364608,136.38595,-388.978658,70.810351,171.689907,100.879556,,,,,,,3.817899,77.496878,73.678979,0.122296,35.315479,35.193183,1.369208,23.566542,22.197334,1379.472179,983.186748,-396.285431,3100.445363,884.956365,-2215.488998,29.219065,21.101672,-8.117393,18.45959,29.499467,11.039877,0.000085,3.371451,3.371366,725.127752,536.150878,-188.976874,481.646321,552.197017,70.550696,65.011133,39.576324,-25.434809,435.298622,800.817842,365.51922,2081.716712,3426.996125,1345.279413,4.25228,153.604828,149.352548,19.131495,93.666072,74.534577,323.320802,667.071753,343.750951,0.000137,0.15238,0.152243,17.003501,22.718569,5.715068,744.334618,406.416748,-337.91787,0.00039,0.007244,0.006854,454.49834,249.519682,-204.978658,296.453512,232.511511,-63.942001,6.888899,0.144312,-6.744587,591.842826,148.732353,-443.110473,4493.841835,3870.572047,-623.269788,2871.0448,392.166199,-2478.878601,1815.83098,2821.37226,1005.54128,1011.293674,2238.271625,1226.977951,39.66286,114.686007,75.023147,0.037467,0.057576,0.020109,1.588789,2.879604,1.290815,3002.69278,2061.307719,-941.385061,7479.620666,4057.360724,-3422.259942,606.879771,148.147123,-458.732648,,,,220.015119,109.694082,-110.321037,73.950381,28.751283,-45.199098,216.759296,109.360201,-107.399095,19.515549,2.015259,-17.50029,1670.4,1952.559152,282.159152,93.187035,15.340191,-77.846844,9.480056,37.68596,28.205904,21.145739,44.618846,23.473107,272.55445,236.678822,-35.875628,,,,2404.651711,556.23362,-1848.418091,13.5339,8.387722,-5.146178,76.76707,84.835142,8.068072,8.273939,4.568326,-3.705613,319.187302,13.715801,-305.471501,39.090702,17.042167,-22.048535,71.256662,57.447218,-13.809444,0.275819,11.102177,10.826358,1.441064,1.933431,0.492367,0.012355,1.152509,1.140154,3.468542,3.409247,-0.0592949999999992,0.519288,10.963708,10.44442,715.307857,833.553369,118.245512,205.622436,74.089295,-131.533141,0.025468,98.700631,98.675163,19.621752,69.638544,50.016792,0.446533,0.083381,-0.363152,1.21412,0.315977,-0.898143,2538.93696,1081.678755,-1457.258205,,,,23.08171,35.610639,12.528929,40.738126,74.219863,33.481737,2.734785,1.319788,-1.414997,1.401139,2.472217,1.071078,,,,13.874991,6.582003,-7.292988,0,1.016529,1.016529,0.196818,1.106529,0.909711,1.762267,1.893654,0.131387000000001,56.741317,70.71306,13.971743,94.071211,45.275974,-48.795237,20.512501,15.900113,-4.612388,451.281376,802.036628,350.755252,0.625974,17.659044,17.03307,33.471423,26.652298,-6.81912500000001,7.7043,190.083927,182.379627,824.428946,92.99142,-731.437526,14.309627,22.323734,8.014107,556.4,502.5,-53.9,0.052345,0,-0.052345,0.514519,0.025,-0.489519,103.632876,78.812479,-24.820397,437.563995,178.161013,-259.402982,,,,2630.961277,1001.685238,-1629.276039,5.487568,324.299027,318.811459,95.63546,963.618072,867.982612,26.778752,17.146062,-9.63269,26.144927,75.477119,49.332192,32.824018,55.830473,23.006455,1.247935,158.754497,157.506562,2762.491542,1713.254256,-1049.237286,338.139585,153.559176,-184.580409,5.713527,2.439791,-3.273736,452.291808,53.33368,-398.958128,156.997149,22.543605,-134.453544,0,0.463449,0.463449,2094.281561,746.022006,-1348.259555,1445.991183,284.913632,-1161.077551,4.92752,1.177181,-3.750339,219.712386,15.858502,-203.853884,2294.656755,1189.873714,-1104.783041,1370.1172,2448.318638,1078.201438,1474.265953,607.955531,-866.310422,0,0.365996,0.365996,1.415433,12.7271,11.311667,752.68857,622.101149,-130.587421,16.297612,18.691653,2.394041,0.073412,0.84585,0.772438,0.174561,1.55806,1.383499,35375.288431,7209.734849,-28165.553582,0.707796,7.61002,6.902224,0,0.017619,0.017619,4440.85077,3185.337613,-1255.513157,353.165065,2252.208561,1899.043496,3275.970515,2055.301012,-1220.669503,10728.614179,4922.10033,-5806.513849,670.503346,1698.244275,1027.740929,0,0,0,0.198133,0,-0.198133,0.04909,0.155315,0.106225,0.000063,0.001108,0.001045,8.636439,20.001477,11.365038,224.027721,240.02401,15.9962889999999,0.05827,0.168064,0.109794,0.113818,0.446016,0.332198,0.000953,0.181142,0.180189,0.559646,1.194335,0.634689,0.115143,0.161447,0.046304,0.221253,0.239853,0.0186,0.000191,0.007109,0.006918,0.067316,0.058691,-0.008625,0.003873,0.05248,0.048607,6.811536,9.993701,3.182165,0.000473,0.100264,0.099791,2.479884,8.872708,6.392824,3.426728,25.007559,21.580831,0.242078,3.038354,2.796276,0.003477,0.996773,0.993296,0.00009,0.035776,0.035686,14.674144,3.10505,-11.569094,0.165385,1.346766,1.181381,43.344077,150.006478,106.662401,1231.31079,112.493361,-1118.817429,22.302332,31.292856,8.990524,312.442012,38.188108,-274.253904,191.707592,579.579921,387.872329,0.087,7.22276,7.13576,,,,0,0,0,232.464192,23.253831,-209.210361,0.012874,5.350653,5.337779,8.461772,9.169849,0.708077000000001,0.514301,31.556927,31.042626,0.575866,3.227587,2.651721,3.277161,7.629053,4.351892,1.255555,3.929304,2.673749,46.152272,14.71938,-31.432892,28.769073,99.36608,70.597007,0.125178,3.228357,3.103179,0.109693,3.131088,3.021395,0.105297,5.548738,5.443441,2951.140504,287.774684,-2663.36582,0.861016,0.435217,-0.425799,322.165114,13.675491,-308.489623,181.237244,7.878073,-173.359171,0.906239,0.090543,-0.815696,0.108908,2.160879,2.051971,0.01911,36.33374,36.31463,1177.910895,114.357453,-1063.553442,222.592151,39.272187,-183.319964,0,0.094657,0.094657,0.085408,0.500788,0.41538,0.009942,0.26165,0.251708,12.785782,20.098228,7.312446,4.672478,6.072453,1.399975,0.057755,0.736103,0.678348,0.778991,2.210916,1.431925,0.005916,0.578084,0.572168,8.803533,8.499238,-0.304294999999998,0.000447,0.054413,0.053966,0.142285,11.382812,11.240527,2.011703,7.949509,5.937806,38.387434,30.152443,-8.23499099999999,0.751222,1.389043,0.637821,0.069794,0.008716,-0.061078,2.745945,11.659373,8.913428,19.990428,2.395599,-17.594829,3.315193,16.599589,13.284396,4.252674,7.797483,3.544809,0.000071,0.193828,0.193757,0.095319,0.052737,-0.042582,0.405917,1.259096,0.853179,0,0.099045,0.099045,742.303924,807.404678,65.1007539999999,32.088454,13.875612,-18.212842,14.762425,2.659984,-12.102441,4.950766,4.657334,-0.293432,10.539611,1.234388,-9.305223,2.784718,2.100856,-0.683862,1.927239,6.854716,4.927477,34.579199,0.142465,-34.436734,0,61.302693,61.302693,,,
2010-09-01,13311.742298,4325.123173,-8986.619125,26630.291513,20308.372943,-6321.91857,163835,107734,-56101,12391.034323,0,-12391.034323,12291.773503,7383.085096,-4908.688407,32322.076713,22866.684882,-9455.391831,9767.800817,10459.389962,691.589145000002,10963.336808,11377.562427,414.225619000001,42949.393224,35788.005149,-7161.388075,31674.835053,23847.755943,-7827.07911,7886.906229,2673.031571,-5213.874658,60412.819764,27224.803581,-33188.016183,167120.342931,107683.145137,-59437.197794,72649.161043,31645.924131,-41003.236912,2216.979664,2021.248355,-195.731309,995.889689999999,2288.358361,1292.468671,6227.2,1528.2,-4699,0.583861,0.708043,0.124182,23041.413807,21834.579872,-1206.833935,0.237023,0,-0.237023,19907.979417,13953.425277,-5954.55414,272.60708,366.690149,94.0830690000001,13.825574,20.082532,6.256958,211.540026,189.847259,-21.692767,354.081338,373.777793,19.6964549999999,172.637116,83.822322,-88.814794,888.523552,437.947285,-450.576267,30.252042,396.593494,366.341452,0.567939,41.491576,40.923637,66.590957,209.516454,142.925497,0,18.822472,18.822472,23.511171,146.124005,122.612834,1.124579,13.507183,12.382604,0.452968,42.043576,41.590608,60.638073,76.866739,16.228666,317.590552,569.163547,251.572995,0.029822,2.090103,2.060281,2.306809,10.944191,8.637382,3.803146,11.10235,7.299204,0.418968,9.82624,9.407272,0.055642,0.278507,0.222865,0.261512,6.977215,6.715703,1.677864,109.974668,108.296804,0.244489,6.437563,6.193074,0.561341,4.633298,4.071957,4.363778,35.604719,31.240941,550.122323,182.576395,-367.545928,102.3305,210.202649,107.872149,,,,,,,0.455117,25.068186,24.613069,0.052667,18.006689,17.954022,0.054217,25.289859,25.235642,1263.960522,930.787353,-333.173169,2835.922198,943.563036,-1892.359162,27.048992,22.90191,-4.14708199999999,18.969617,33.758848,14.789231,0.00123,5.447586,5.446356,663.476452,399.358808,-264.117644,488.049746,593.192617,105.142871,72.807422,41.697686,-31.109736,424.62931,936.751787,512.122477,1707.274156,2978.885156,1271.611,9.694176,164.646348,154.952172,17.556149,75.407146,57.850997,353.265676,605.772627,252.506951,0,0.082501,0.082501,20.007334,26.712273,6.704939,817.659573,407.497964,-410.161609,0,6.24244,6.24244,422.098741,340.876438,-81.222303,334.815747,238.157216,-96.6585309999999,6.731117,0.660351,-6.070766,562.364957,221.738032,-340.626925,4141.955301,3912.946469,-229.008832,3035.615799,636.160884,-2399.454915,1456.289461,3080.6865,1624.397039,1183.619242,2130.662175,947.042933,30.843896,119.144978,88.301082,0.002964,0.340388,0.337424,2.303303,1.412674,-0.890629,3477.539672,2265.164499,-1212.375173,6766.966448,4107.988514,-2658.977934,552.717139,170.301228,-382.415911,,,,193.828212,122.767004,-71.061208,119.186364,41.85675,-77.329614,302.538163,100.658711,-201.879452,14.70349,1.382589,-13.320901,1516.190032,1408.046739,-108.143293,168.347776,21.379878,-146.967898,13.921727,30.899822,16.978095,76.549082,71.46172,-5.087362,254.375015,269.057803,14.682788,,,,2319.353744,528.148017,-1791.205727,10.842767,10.9365,0.0937329999999985,81.442477,103.891002,22.448525,6.092362,8.368271,2.275909,126.324107,57.8772,-68.446907,7.954417,32.122427,24.16801,123.621278,48.744661,-74.876617,0.102055,3.207712,3.105657,1.220775,1.496174,0.275399,0.022238,1.976619,1.954381,2.729381,3.613768,0.884386999999998,1.573062,6.860766,5.287704,619.77828,850.79032,231.01204,150.157014,63.391704,-86.76531,0.072871,188.343997,188.271126,24.238098,50.702971,26.464873,0.114147,0.207788,0.093641,0.258756,0.063605,-0.195151,2095.479828,1239.771777,-855.708051,,,,48.104255,9.269166,-38.835089,39.046355,19.612075,-19.43428,2.081241,1.973956,-0.107285,2.497311,1.546433,-0.950878,,,,6.766251,6.241083,-0.525168000000003,0.014434,0.761097,0.746663,0.238492,0.561263,0.322771,2.117498,2.372596,0.255098,98.040377,56.083032,-41.957345,92.318759,58.48786,-33.830899,21.333721,15.506899,-5.826822,318.96264,735.125007,416.162367,0.765507,5.496158,4.730651,14.530855,89.595856,75.065001,14.710066,187.813534,173.103468,953.003634,158.752625,-794.251009,39.663414,21.78087,-17.882544,731,407,-324,0.004978,0,-0.004978,0.247351,0,-0.247351,86.21969,76.854858,-9.36483200000002,694.215892,191.059088,-503.156804,,,,2689.742081,899.891716,-1789.850365,32.407985,281.667441,249.259456,103.629787,782.92607,679.296283,0.17461,63.174974,63.000364,73.798025,77.221771,3.42374600000001,25.306913,63.944564,38.637651,3.035636,199.859665,196.824029,2413.304692,1459.217153,-954.087539000001,293.671349,162.320613,-131.350736,5.962263,2.933401,-3.028862,387.29072,52.842495,-334.448225,148.644103,15.089884,-133.554219,0,0.966707,0.966707,2099.99087,708.948905,-1391.041965,1401.355059,316.106628,-1085.248431,7.131314,0.868808,-6.262506,226.61036,9.682359,-216.928001,2199.795176,1208.814499,-990.980677,1735.570546,2327.504137,591.933591,1528.099192,607.783604,-920.315588,0,0.138781,0.138781,0.756354,8.06274,7.306386,711.68641,602.458001,-109.228409,10.481108,21.294809,10.813701,0.009324,0.089536,0.080212,0.12822,1.774788,1.646568,35196.698854,7114.311226,-28082.387628,0.255731,9.506535,9.250804,0,1.073775,1.073775,4276.777074,3028.930472,-1247.846602,450.216519,2742.208999,2291.99248,3305.236678,2360.746354,-944.490324,10057.10918,4959.290902,-5097.818278,742.127715,1974.417524,1232.289809,0,0.030606,0.030606,0.042393,0.007357,-0.035036,0.000283,0.005787,0.005504,0,0,0,11.630632,27.883827,16.253195,186.634326,241.096487,54.462161,0.712771,0.269216,-0.443555,0.322924,0.221047,-0.101877,0,0.70942,0.70942,0.445852,1.538891,1.093039,0.092943,0.586098,0.493155,0.041987,0.594372,0.552385,0.001084,0.001989,0.000905,0.046952,0.121256,0.074304,0.000387,0.087166,0.086779,6.666731,14.694844,8.028113,0.002317,0.021132,0.018815,10.134351,10.081528,-0.0528230000000018,0.349487,3.746807,3.39732,0.377564,3.668576,3.291012,0,1.218181,1.218181,0.00004,0.031283,0.031243,36.119552,5.770112,-30.34944,0.143114,1.484801,1.341687,68.306462,172.207709,103.901247,1251.805529,130.764708,-1121.040821,19.44596,75.909639,56.463679,148.326388,77.893755,-70.432633,161.45011,712.483038,551.032928,0.967219,7.978143,7.010924,,,,0,0,0,279.900382,14.56514,-265.335242,0.072984,5.466784,5.3938,45.625182,8.73529,-36.889892,0.265697,10.403105,10.137408,0.143827,2.024851,1.881024,4.406473,5.799847,1.393374,1.728412,8.846026,7.117614,59.026504,9.332917,-49.693587,7.907332,102.911718,95.004386,0.096241,2.012072,1.915831,24.628725,4.282043,-20.346682,0.068491,7.165235,7.096744,2808.579005,349.975843,-2458.603162,0.349801,0.305919,-0.0438819999999999,276.30814,8.026108,-268.282032,215.489846,9.67125,-205.818596,0.022384,0.028766,0.006382,0.007018,4.784649,4.777631,0.027536,43.498866,43.47133,1082.526131,112.880327,-969.645804,196.653135,23.847566,-172.805569,0.128486,0.178013,0.049527,0.04326,2.459294,2.416034,0.024315,0.006714,-0.017601,4.133775,15.425918,11.292143,96.15516,4.905883,-91.249277,0.002657,2.017553,2.014896,2.878284,0.598135,-2.280149,0.095956,0.032147,-0.063809,3.915717,27.143936,23.228219,0.003124,0.579967,0.576843,0.216483,6.191909,5.975426,2.977399,5.577937,2.600538,31.380912,25.795522,-5.58539,2.025675,0.523647,-1.502028,0.091467,0.029267,-0.0622,2.666771,18.350349,15.683578,17.969008,6.881402,-11.087606,10.858,35.258667,24.400667,5.086438,11.506022,6.419584,0,0.541633,0.541633,0.000027,0.047718,0.047691,1.790883,0.577319,-1.213564,0.000785,0.026513,0.025728,858.860451,599.488399,-259.372052,67.034138,5.621185,-61.412953,15.474154,1.466291,-14.007863,3.95284,3.868582,-0.0842580000000002,29.638468,1.474249,-28.164219,11.640255,2.790607,-8.849648,7.246579,4.986952,-2.259627,37.20681,0.06367,-37.14314,0,61.799512,61.799512,,,
2010-10-01,10495.178945,4882.549567,-5612.629378,28697.708239,21831.258313,-6866.449926,165302,112730,-52572,13101.259216,0,-13101.259216,12203.2791,7382.49493,-4820.78417,32380.044379,23743.360483,-8636.683896,9880.144934,10276.800915,396.655981,10826.80853,12969.503614,2142.695084,44468.484158,37110.650606,-7357.83355199999,34175.524745,26197.926128,-7977.59861700001,6486.77371,2772.96586,-3713.80785,61411.25717,30184.405669,-31226.851501,170320.058499,117262.131026,-53057.9274729997,73415.787037,35745.311933,-37670.475104,2086.767039,2183.043468,96.2764289999996,945.476335,2342.812789,1397.336454,5027.6,1513.1,-3514.5,0.946403,0.308613,-0.63779,23444.450833,22205.151838,-1239.298995,0.257581,0,-0.257581,21024.033325,14905.498768,-6118.534557,283.885639,384.165804,100.280165,15.192737,17.896317,2.70358,205.500647,198.455427,-7.04522000000003,347.991542,451.344636,103.353094,191.477647,127.535129,-63.942518,730.758183,431.694029,-299.064154,29.123983,592.01194,562.887957,0.821492,59.638716,58.817224,50.409269,277.42596,227.016691,0,20.740087,20.740087,20.313748,162.146557,141.832809,1.633814,16.124272,14.490458,0.552269,55.176074,54.623805,51.578677,90.941602,39.362925,327.153381,589.848443,262.695062,0.679058,2.495118,1.81606,1.781283,13.433431,11.652148,3.892359,16.877749,12.98539,0.310204,13.597744,13.28754,0.01552,0.575783,0.560263,0.126506,6.885978,6.759472,1.287798,14.071514,12.783716,0.09644,4.805528,4.709088,0.553847,6.45585,5.902003,5.226323,39.851985,34.625662,599.769643,189.859241,-409.910402,80.493517,284.477011,203.983494,,,,,,,1.120558,37.787978,36.66742,0.134271,40.8807,40.746429,3.085494,20.954333,17.868839,1262.855331,1109.258831,-153.5965,2432.395274,1202.002457,-1230.392817,26.907098,21.943725,-4.963373,19.611841,51.506431,31.89459,0.000848,5.204137,5.203289,595.030553,507.646229,-87.3843240000001,450.496702,622.885006,172.388304,48.526725,48.873562,0.346837000000001,487.014897,1025.335879,538.320982,2087.80413,3201.026794,1113.222664,8.067484,170.718157,162.650673,23.145469,99.017035,75.871566,428.022929,735.807996,307.785067,1.9634,0.122439,-1.840961,16.939988,33.939629,16.999641,966.889867,437.58739,-529.302477,0,0.005894,0.005894,624.598555,242.797273,-381.801282,374.454051,236.505047,-137.949004,8.232881,0.034808,-8.198073,487.490987,206.909905,-280.581082,4225.545133,4279.075198,53.5300649999999,3118.342082,580.815105,-2537.526977,1684.850284,3348.071618,1663.221334,1519.323679,2327.31419,807.990511000001,39.218977,101.124399,61.905422,0.090544,1.463663,1.373119,2.395183,0.386768,-2.008415,3221.671362,2534.508871,-687.162491000001,7692.027055,4374.14669,-3317.880365,613.456978,143.778638,-469.67834,,,,226.189703,110.824394,-115.365309,112.706357,19.77494,-92.931417,209.351225,117.358332,-91.992893,19.827016,1.640189,-18.186827,1910.963883,1910.507982,-0.455900999999585,88.786241,22.357492,-66.428749,27.838486,43.467248,15.628762,69.635744,58.969078,-10.666666,246.333638,293.834792,47.501154,,,,2136.776115,585.403083,-1551.373032,3.500443,13.087464,9.587021,111.113056,106.012644,-5.10041200000003,5.957717,5.315652,-0.642065000000001,166.759952,19.392399,-147.367553,36.235546,22.646131,-13.589415,15.556073,102.17891,86.622837,0.098057,6.061629,5.963572,1.573194,4.371032,2.797838,0.055354,9.843806,9.788452,3.144173,3.237965,0.0937919999999992,0.29688,18.459532,18.162652,721.349527,965.851687,244.50216,171.172714,105.040215,-66.132499,0.007131,208.609499,208.602368,19.489897,21.182937,1.69304,0.369256,0.181307,-0.187949,0.060269,0.254164,0.193895,2658.866423,1289.499552,-1369.366871,,,,25.441538,38.376291,12.934753,43.231029,69.632544,26.401515,1.888552,1.127634,-0.760918,2.452306,3.249125,0.796819,,,,12.415297,7.720596,-4.694701,0.00314,1.059956,1.056816,0.231735,1.623606,1.391871,2.061245,3.903099,1.841854,53.44221,71.514685,18.072475,74.725891,51.086379,-23.639512,30.530283,13.496057,-17.034226,368.771427,1013.776085,645.004658,0.788416,7.53093,6.742514,38.662628,63.334914,24.672286,7.018995,182.730981,175.711986,558.516744,122.427205,-436.089539,1.024091,11.413002,10.388911,615.4,478.9,-136.5,0,0,0,0.225615,0.048854,-0.176761,96.981097,139.467594,42.486497,222.414212,220.545604,-1.86860800000005,,,,2424.214032,1025.676002,-1398.53803,55.961102,124.541253,68.580151,111.869945,1038.54801,926.678065,0.852336,28.438007,27.585671,239.273456,79.783361,-159.490095,35.236715,271.825254,236.588539,1.496296,183.031704,181.535408,2895.709647,1912.464956,-983.244691,307.33316,170.568413,-136.764747,5.678693,2.447,-3.231693,409.252898,37.264159,-371.988739,167.514821,13.293868,-154.220953,0,0.676865,0.676865,2083.971586,806.167641,-1277.803945,1498.001489,349.828828,-1148.172661,6.516949,0.872661,-5.644288,233.089233,14.275972,-218.813261,2165.681687,1280.759389,-884.922298,1742.631159,2443.777201,701.146041999999,1322.889183,660.194002,-662.695181,0,0.452871,0.452871,1.409248,9.598475,8.189227,746.189516,657.975936,-88.21358,11.375323,23.981686,12.606363,0.009148,0.262157,0.253009,0.031884,3.861617,3.829733,35083.299437,9417.288527,-25666.01091,1.012926,9.620895,8.607969,0,1.48221,1.48221,4490.06934,3339.053176,-1151.016164,399.867526,2275.912463,1876.044937,3247.576909,2218.058075,-1029.518834,11281.670462,5551.717531,-5729.952931,715.524762,2030.030717,1314.505955,0,0.081093,0.081093,0.630376,0.233491,-0.396885,0.095838,0.077165,-0.018673,0,0.030346,0.030346,11.508743,17.299962,5.791219,191.563875,258.758529,67.194654,0.074662,0.345941,0.271279,0.299523,0.053566,-0.245957,0.000642,0.035601,0.034959,0.135284,2.059016,1.923732,0.122796,0.634975,0.512179,0.081739,0.505951,0.424212,0.000119,0.001698,0.001579,0.3804,0.006243,-0.374157,0.000038,0.105879,0.105841,2.863719,8.261324,5.397605,0,0.009932,0.009932,2.808662,10.449916,7.641254,0.337907,4.055958,3.718051,0.30041,3.750182,3.449772,0.005,1.316771,1.311771,0.009933,0.053331,0.043398,18.596775,3.513797,-15.082978,0.135289,1.159073,1.023784,59.843076,257.237923,197.394847,1058.068071,149.741448,-908.326623,25.955837,39.692548,13.736711,57.188864,56.894611,-0.294253000000005,198.642574,762.460876,563.818302,0.5225,14.382364,13.859864,,,,0,0,0,240.877333,16.92551,-223.951823,0.005273,5.649683,5.64441,12.033501,14.144485,2.110984,1.040057,7.296696,6.256639,1.756368,2.161016,0.404648,9.567594,8.126138,-1.441456,1.873902,9.938051,8.064149,87.078504,9.017283,-78.061221,12.34088,125.230767,112.889887,0.048506,1.636048,1.587542,0.145903,1.637837,1.491934,0.295979,13.732968,13.436989,2209.273164,349.694095,-1859.579069,0.363028,0.417428,0.0544,478.20619,19.13826,-459.06793,211.282181,8.797265,-202.484916,0.063699,0.086588,0.022889,0.177304,4.396286,4.218982,0,45.230787,45.230787,711.635828,81.113487,-630.522341,129.370191,19.520713,-109.849478,0.001052,0.054525,0.053473,0.094404,0.545385,0.450981,0.011992,0.041138,0.029146,13.285347,33.479865,20.194518,78.962876,10.061286,-68.90159,0.194769,1.3446,1.149831,3.343359,1.829952,-1.513407,0,0.090381,0.090381,8.101625,34.384073,26.282448,0.005922,0.238696,0.232774,0.096325,4.969094,4.872769,3.013774,5.280939,2.267165,40.311055,49.452906,9.14185099999999,0.342023,1.524318,1.182295,0.072971,0.170363,0.097392,2.939235,17.763002,14.823767,18.669084,3.250288,-15.418796,14.39216,18.452309,4.060149,3.047733,4.196215,1.148482,0.000316,0.164589,0.164273,0.248741,0.001179,-0.247562,1.71,0.96102,-0.74898,0.016236,0.016098,-0.000137999999999999,640.465133,468.301094,-172.164039,16.342703,14.287084,-2.055619,17.58594,6.430011,-11.155929,4.899255,5.322817,0.423562,8.395658,1.572589,-6.823069,5.845363,6.77644,0.931077000000004,9.064927,1.324011,-7.740916,25.142122,0.134539,-25.007583,0,122.651483,122.651483,,,
2010-11-01,11579.244816,4620.67746,-6958.567356,28213.353803,20992.744694,-7220.60910899999,164893,113521,-51372,12414.819749,0,-12414.819749,11837.980976,7142.869664,-4695.111312,33778.486163,23232.548379,-10545.937784,10211.588895,10272.755491,61.1665960000046,11228.640145,12386.109456,1157.469311,43439.463526,36016.987741,-7422.47578500001,33779.454776,25471.089432,-8308.36534400001,6092.792795,2594.866218,-3497.926577,61333.158004,29611.337955,-31721.820049,168989.170901,113116.960191,-55872.2107100001,73422.154699,34330.790277,-39091.364422,2026.840688,2109.754257,82.9135690000005,1025.770185,2247.543864,1221.773679,4481.8,1566.9,-2914.9,0.797528,1.029966,0.232438,22909.191368,21101.270095,-1807.921273,0.097247,0,-0.097247,20530.272158,14915.717646,-5614.554512,265.160714,392.533494,127.37278,14.877886,35.21417,20.336284,161.936583,199.903705,37.9671219999999,347.865745,389.281445,41.4157,166.333648,66.837739,-99.495909,769.312612,460.070853,-309.241759,25.453769,517.325511,491.871742,3.483727,50.776387,47.29266,50.134531,288.56279,238.428259,0,35.878561,35.878561,27.601166,139.820255,112.219089,2.19302,15.237375,13.044355,0.646984,58.923394,58.27641,46.377907,90.161057,43.78315,316.231386,601.127021,284.895635,0.219253,3.678029,3.458776,0.684217,12.866334,12.182117,4.104649,20.066348,15.961699,0.438433,23.638437,23.200004,0.030603,0.488147,0.457544,0.066194,5.294646,5.228452,1.174141,16.57165,15.397509,0.167184,10.602004,10.43482,0.527586,8.934982,8.407396,3.597107,33.248056,29.650949,532.52205,155.152205,-377.369845,112.313218,372.019716,259.706498,,,,,,,2.370695,66.638012,64.267317,0.516921,28.763598,28.246677,3.445058,22.87658,19.431522,1631.420049,1028.188672,-603.231377,2691.442627,1106.452197,-1584.99043,37.312684,26.207197,-11.105487,27.921501,31.373742,3.452241,0.025719,3.819386,3.793667,656.143533,490.633973,-165.50956,515.328646,648.167559,132.838913,106.713257,50.812558,-55.900699,435.506791,867.841441,432.33465,1875.240617,3023.001254,1147.760637,8.230187,155.07111,146.840923,23.115183,92.963024,69.847841,359.533895,738.880046,379.346151,0.918469,0.204796,-0.713673,17.920871,24.952851,7.03198,1040.768322,428.138412,-612.62991,0,0,0,534.563066,227.6132,-306.949866,343.068252,194.469269,-148.598983,7.323258,0.010905,-7.312353,472.789569,150.767998,-322.021571,4181.360569,3862.638351,-318.722218,2932.160194,620.865266,-2311.294928,1277.678947,3273.846826,1996.167879,1244.766288,2202.778343,958.012055,31.495991,112.279818,80.783827,0.071142,0.404358,0.333216,2.917279,0.639697,-2.277582,3401.791129,2449.980049,-951.811080000001,7699.750684,4567.269604,-3132.48108,645.650768,157.174719,-488.476049,,,,234.674973,114.6434,-120.031573,98.395308,20.216407,-78.178901,205.56406,100.775625,-104.788435,19.287536,2.678041,-16.609495,1814.85996,2069.771295,254.911335,115.180101,15.864408,-99.315693,23.686336,31.705256,8.01891999999999,57.709518,72.351003,14.641485,320.31765,282.129868,-38.187782,,,,2334.31134,653.690623,-1680.620717,17.853204,14.188882,-3.664322,81.569459,128.828196,47.258737,4.306325,6.015751,1.709426,35.409059,44.154423,8.74536400000001,14.573909,30.069372,15.495463,198.877841,124.637722,-74.240119,0.415775,3.521518,3.105743,0.946796,1.825395,0.878599,0.040517,1.526056,1.485539,17.039203,1.850042,-15.189161,0.956461,5.679555,4.723094,855.43333,799.764226,-55.6691039999998,166.952931,99.10501,-67.847921,0.044746,179.443953,179.399207,18.287278,18.528364,0.241085999999996,0.46468,0.630365,0.165685,0.020536,0.417386,0.39685,2557.160415,1207.174181,-1349.986234,,,,23.218544,30.15394,6.935396,39.903398,14.43979,-25.463608,2.032731,0.830109,-1.202622,3.703637,1.405069,-2.298568,,,,7.422468,11.042665,3.620197,0,0.986864,0.986864,0.457662,1.254311,0.796649,1.988339,3.320616,1.332277,112.757672,78.208971,-34.548701,112.334568,95.96444,-16.370128,22.270094,13.996472,-8.273622,423.504629,906.801578,483.296949,1.445458,7.668618,6.22316,17.039199,58.452087,41.412888,5.868176,159.637328,153.769152,570.873933,103.606113,-467.26782,0.008057,13.928959,13.920902,640.1,454.5,-185.6,0,0,0,0.202031,0.006652,-0.195379,82.900592,90.560405,7.65981300000001,455.714412,195.858304,-259.856108,,,,2986.578588,879.814715,-2106.763873,66.299696,94.769961,28.470265,97.206166,1055.796824,958.590658,19.570679,39.196445,19.625766,161.877842,101.007566,-60.870276,29.828703,74.630515,44.801812,0.768395,155.862113,155.093718,2361.045582,1543.181416,-817.864166000001,326.576828,138.432879,-188.143949,4.876639,2.454801,-2.421838,361.394565,48.006218,-313.388347,156.672786,13.805908,-142.866878,0,1.476518,1.476518,2091.025034,834.554744,-1256.47029,1332.994889,321.41642,-1011.578469,4.699765,1.303575,-3.39619,224.951327,11.438845,-213.512482,2236.463633,1131.654186,-1104.809447,1707.84324,2252.416702,544.573462,1519.511132,656.073527,-863.437605,0,0.51332,0.51332,0.622599,9.333041,8.710442,708.226304,677.312708,-30.913596,9.918938,21.822299,11.903361,0.002235,0.46924,0.467005,0.140109,3.267026,3.126917,34564.293893,9475.844966,-25088.448927,2.747942,21.947273,19.199331,0,0,0,4788.938343,3174.614754,-1614.323589,401.247949,2308.192284,1906.944335,3313.559363,2537.531751,-776.027611999999,11091.652127,5174.609316,-5917.042811,791.813091,1963.772297,1171.959206,0,0.057327,0.057327,0.279988,0.095131,-0.184857,0.001564,0.110184,0.10862,0,0.000203,0.000203,12.405032,6.97202,-5.433012,186.66236,221.188104,34.525744,0.345097,0.27328,-0.071817,0.258532,0.167625,-0.090907,0.001422,0.013685,0.012263,0.35613,2.136696,1.780566,0.064032,0.321368,0.257336,0.064891,0.164908,0.100017,0,0,0,0.048503,0.003925,-0.044578,0,0.005283,0.005283,12.160131,21.878515,9.718384,0,0,0,8.071523,10.24053,2.169007,0.32742,7.813515,7.486095,0.168791,4.463414,4.294623,0.000528,1.095157,1.094629,0.007232,0.256316,0.249084,12.593908,3.779201,-8.814707,0.139045,1.72691,1.587865,103.276314,200.04292,96.766606,1266.18105,130.977577,-1135.203473,23.810294,69.773175,45.962881,0.698764,55.660038,54.961274,148.870565,577.260989,428.390424,0.868231,16.04929,15.181059,,,,0,0,0,150.83101,30.042065,-120.788945,0.126635,3.395292,3.268657,36.538129,6.206205,-30.331924,0.225488,14.446073,14.220585,0.062083,1.558425,1.496342,6.815728,6.086094,-0.729633999999998,6.806272,7.584561,0.778288999999998,81.132729,8.12845,-73.004279,17.590988,85.098821,67.507833,0.08152,0.864008,0.782488,0.415192,2.867312,2.45212,0.159039,7.326649,7.16761,2116.37929,380.066819,-1736.312471,0.32935,0.251627,-0.077723,272.562524,14.714703,-257.847821,92.841038,3.700636,-89.140402,2.161061,0.076159,-2.084902,0.029859,3.673074,3.643215,0.029901,36.174674,36.144773,605.840397,119.373115,-486.467282,95.844511,19.115227,-76.729284,0.000004,0.016017,0.016013,0.000735,1.533654,1.532919,0.037889,0.310011,0.272122,0.554019,14.402269,13.84825,2.19775,10.510339,8.312589,0.609764,1.107828,0.498064,6.534357,6.523585,-0.0107720000000002,0.002374,0.016185,0.013811,3.025368,63.672032,60.646664,0.005526,0.27618,0.270654,0.007192,2.685582,2.67839,4.166352,4.687725,0.521373000000001,25.202096,27.059448,1.857352,0.303685,0.534454,0.230769,0.101891,0.004183,-0.097708,3.848871,13.989748,10.140877,19.626926,2.772588,-16.854338,2.512641,26.041994,23.529353,7.253617,3.942346,-3.311271,0,0.363505,0.363505,0.382185,0.047771,-0.334414,0.04014,0.24595,0.20581,0,0.003469,0.003469,813.461102,423.372797,-390.088305,15.508761,4.092956,-11.415805,9.677718,4.283963,-5.393755,1.202492,6.109832,4.90734,6.559081,7.135455,0.576373999999999,23.141199,3.528326,-19.612873,11.805937,3.091481,-8.714456,28.285944,0.057714,-28.22823,0,68.543237,68.543237,,,
2010-12-01,13296.926533,4978.648104,-8318.278429,28783.578234,22243.210854,-6540.36738,170290,116039,-54251,12250.783953,0,-12250.783953,12322.140888,6788.352503,-5533.788385,31638.272648,26159.3719,-5478.90074799999,9099.994392,11369.127219,2269.132827,11827.095926,12094.790312,267.694385999996,43629.710716,35310.993133,-8318.71758300001,33821.922041,27208.424642,-6613.49739899999,7389.010854,2820.633665,-4568.377189,56551.962028,31876.055294,-24675.906734,166518.144957,117446.887134,-49071.2578230002,68845.931546,37628.381775,-31217.549771,2093.633628,2112.768335,19.1347070000002,1003.577427,2332.021563,1328.444136,5712.5,1724.9,-3987.6,0.709129,0.234847,-0.474282,24273.016773,20667.724609,-3605.29216399999,0.187318,0,-0.187318,19356.693943,14643.268524,-4713.425419,316.849811,413.402796,96.552985,13.883445,22.940417,9.056972,184.587674,223.058295,38.470621,350.781797,391.248424,40.466627,169.579087,97.873298,-71.705789,776.264954,386.162325,-390.102629,29.182173,676.134796,646.952623,1.883512,34.445116,32.561604,58.012104,223.433464,165.42136,0,25.344182,25.344182,20.112081,165.982451,145.87037,1.145004,19.249882,18.104878,0.675599,45.676208,45.000609,56.096524,90.238903,34.142379,295.570305,601.023197,305.452892,0.44559,2.905322,2.459732,0.267133,15.804931,15.537798,4.362191,14.504006,10.141815,0.368395,13.838622,13.470227,0.002525,0.426182,0.423657,0.066003,7.282918,7.216915,1.610972,26.566286,24.955314,0.158711,10.926348,10.767637,0.35869,7.388443,7.029753,2.895516,37.414075,34.518559,463.972336,180.553618,-283.418718,72.35543,312.791406,240.435976,,,,,,,1.008774,60.098914,59.09014,0.425657,29.060618,28.634961,5.511226,16.613628,11.102402,1413.987947,1144.92933,-269.058617,2742.803119,737.72567,-2005.077449,24.063341,24.334996,0.271654999999999,21.318221,27.566533,6.24831200000001,0.026395,0.90483,0.878435,578.405213,447.360893,-131.04432,577.957834,608.594971,30.6371369999999,47.224585,41.863943,-5.360642,734.608036,937.740782,203.132746,2370.0421,3010.200162,640.158062,7.753814,160.969882,153.216068,18.295012,82.827768,64.532756,462.176624,717.142641,254.966017,0.000466,0.23884,0.238374,18.033539,30.937396,12.903857,1022.495274,409.623904,-612.87137,0.000014,0.012418,0.012404,459.37937,332.096961,-127.282409,293.047471,191.990621,-101.05685,6.89736,0.11794,-6.77942,660.822489,179.248202,-481.574287,4488.929252,4162.094226,-326.835026,3118.263666,514.264383,-2603.999283,1853.657799,3279.305768,1425.647969,1137.491547,2267.719563,1130.228016,42.382916,115.227251,72.844335,0.014688,0.29326,0.278572,4.273253,0.204014,-4.069239,3538.555612,2746.259046,-792.296566,7331.420814,4097.267743,-3234.153071,660.877265,464.175972,-196.701293,,,,208.226358,135.904076,-72.3222819999999,108.715888,32.801663,-75.914225,205.968395,130.314628,-75.653767,20.079878,11.365445,-8.714433,1871.548209,2102.433134,230.884924999999,93.207576,15.329512,-77.878064,21.744043,31.963279,10.219236,104.993501,67.251363,-37.742138,234.655295,263.306935,28.65164,,,,1971.387603,603.766236,-1367.621367,4.685486,17.860676,13.17519,84.009138,125.061796,41.052658,7.867106,10.078375,2.211269,153.987032,15.272838,-138.714194,3.665341,25.332803,21.667462,67.433775,67.260484,-0.173290999999992,0.209048,4.06111,3.852062,1.374107,2.9946,1.620493,0.029828,2.226314,2.196486,1.414799,4.411797,2.996998,0.675565,14.764728,14.089163,762.774468,1506.760897,743.986429,143.273273,79.372381,-63.900892,0.042816,200.09036,200.047544,24.114595,26.974989,2.860394,0.545029,0.296128,-0.248901,0.38935,1.036696,0.647346,2476.423939,1298.624047,-1177.799892,,,,30.267821,12.704321,-17.5635,42.144883,17.717593,-24.42729,1.88822,1.419704,-0.468516,7.094422,3.612853,-3.481569,,,,5.547383,12.207959,6.660576,0.001312,2.220203,2.218891,0.273427,1.217958,0.944531,4.229869,3.757377,-0.472492000000001,58.957467,127.114314,68.156847,107.067162,57.130522,-49.93664,41.828609,15.818198,-26.010411,311.099019,1356.097904,1044.998885,1.538677,9.649778,8.111101,79.105225,32.328983,-46.776242,7.610893,105.354522,97.743629,1211.438691,198.647884,-1012.790807,0,24.765799,24.765799,641.9,661.1,19.2,0,0,0,0.835468,0.111467,-0.724001,69.594662,109.263742,39.66908,377.15284,201.686799,-175.466041,,,,2953.102466,1191.836505,-1761.265961,58.870964,267.856249,208.985285,101.122538,1193.015744,1091.893206,9.647972,38.628435,28.980463,83.50951,104.781549,21.272039,58.711085,74.57384,15.862755,0.906575,156.062948,155.156373,2131.838964,1610.150816,-521.688148,271.548492,190.494509,-81.053983,4.75681,1.835732,-2.921078,343.614903,86.716717,-256.898186,141.25648,14.651221,-126.605259,0,1.678592,1.678592,1988.784321,889.035033,-1099.749288,1215.348729,415.027095,-800.321634,5.331073,1.237775,-4.093298,188.289403,10.597686,-177.691717,2147.844511,1329.006829,-818.837682,1407.829713,2720.167332,1312.337619,1469.305779,550.055885,-919.249894,0,0.375626,0.375626,0.679352,12.528544,11.849192,648.877861,666.37401,17.4961489999999,9.973396,25.056564,15.083168,0.000497,0.181997,0.1815,0.048998,2.618741,2.569743,30799.583148,10125.554623,-20674.028525,1.223028,23.020138,21.79711,0,0.012706,0.012706,4068.175097,3457.588523,-610.586573999999,409.403131,2591.4531,2182.049969,3214.586451,2599.918264,-614.668186999999,11399.448415,5498.538538,-5900.909877,712.523734,1875.458708,1162.934974,0,0.021972,0.021972,0.079103,0.015242,-0.063861,0.028752,0.181693,0.152941,0,0.013679,0.013679,7.538859,9.812676,2.273817,256.192581,414.541698,158.349117,0.072117,0.41092,0.338803,0.179772,0.803376,0.623604,0,0.00115,0.00115,0.244838,1.605047,1.360209,0.014609,0.343367,0.328758,0.121508,0.116883,-0.00462500000000002,0.000222,0.002673,0.002451,0.085786,0.068804,-0.016982,0.001744,0.062822,0.061078,9.218095,6.539848,-2.678247,0,0.023045,0.023045,2.389037,10.077315,7.688278,0.523681,3.748133,3.224452,0.277461,2.899747,2.622286,0.00064,1.047497,1.046857,0.045442,0.022285,-0.023157,13.834958,3.237519,-10.597439,0.196438,1.015222,0.818784,64.023831,106.902844,42.879013,1221.197183,67.571657,-1153.625526,42.078276,57.692249,15.613973,1.099683,56.439332,55.339649,122.339926,789.110048,666.770122,0.467,20.326919,19.859919,,,,0,0.005475,0.005475,146.346773,20.374966,-125.971807,0.284557,9.98419,9.699633,7.235911,18.873675,11.637764,0.47301,40.355258,39.882248,0.239573,4.007452,3.767879,4.526869,10.548362,6.021493,0.454392,4.682224,4.227832,117.725626,7.259956,-110.46567,38.476874,70.457058,31.980184,0.103861,1.570106,1.466245,0.158772,1.662159,1.503387,0.098987,6.620061,6.521074,2902.36901,376.009737,-2526.359273,0.318742,0.553191,0.234449,207.908614,12.283943,-195.624671,186.801912,6.114749,-180.687163,0.515631,0.013864,-0.501767,0.268125,6.853174,6.585049,0.010254,46.71568,46.705426,924.434817,199.142048,-725.292769,255.024967,13.937607,-241.08736,0.384748,0.138351,-0.246397,0.345364,2.006901,1.661537,0.013714,0.249437,0.235723,26.811771,19.851058,-6.96071300000001,8.18218,7.234402,-0.947777999999999,1.392986,1.601093,0.208107,3.799875,0.791217,-3.008658,0.006955,0.266064,0.259109,1.55119,60.568089,59.016899,0.000763,0.178274,0.177511,1.375662,3.491843,2.116181,2.736209,6.108557,3.372348,25.144521,31.08326,5.93873900000001,0.319678,1.008018,0.68834,0.24271,0.173343,-0.069367,6.05406,16.071161,10.017101,14.484052,3.21047,-11.273582,6.636351,17.460598,10.824247,4.731723,10.689558,5.957835,0,0.339843,0.339843,0.212441,0.251358,0.038917,0.025719,0.652737,0.627018,0.004812,0.056429,0.051617,740.290314,500.514361,-239.775953,8.59272,10.394756,1.802036,15.26202,14.233557,-1.028463,3.809966,5.63395,1.823984,4.736376,2.650763,-2.085613,1.654839,6.486005,4.831166,7.442744,3.984893,-3.457851,22.513731,10.586,-11.927731,0,51.407197,51.407197,,,
2011-01-01,14357.526685,4321.126309,-10036.400376,26134.287465,20214.644765,-5919.64270000001,178698,117337,-61361,12000.022552,0,-12000.022552,12839.587016,6264.354489,-6575.232527,28321.22755,21125.709458,-7195.518092,9400.627132,10346.722811,946.095679000002,13130.37286,12621.309065,-509.063795,44399.657232,35500.892779,-8898.764453,32046.251963,24503.601681,-7542.65028200001,8273.871645,2584.754387,-5689.117258,55890.658255,27863.769656,-28026.888599,167048.120908,110183.369864,-56864.751044,68272.978032,32833.100009,-35439.878023,1817.31164,2297.34151,480.02987,923.939614,2139.493106,1215.553492,6289.07635,1488.989741,-4800.086609,0.954153,0.218837,-0.735316,24793.241244,20650.576862,-4142.664382,0.095409,0,-0.095409,19606.415988,14850.315917,-4756.100071,320.689493,453.919348,133.229855,8.66908,22.865564,14.196484,166.256579,226.353478,60.0968990000001,275.046045,515.074356,240.028311,155.9975,83.063973,-72.933527,676.170679,457.08701,-219.083669,21.498568,596.988928,575.49036,0.310173,57.608536,57.298363,61.580856,270.2862,208.705344,0,23.231383,23.231383,15.753269,142.62309,126.869821,0.927424,11.76716,10.839736,0.750699,48.375966,47.625267,34.478233,86.020148,51.541915,223.151344,561.843345,338.692001,0.330284,2.036084,1.7058,0.261893,10.277454,10.015561,3.069681,8.0238,4.954119,0.371918,8.940379,8.568461,0.088367,0.226076,0.137709,0.368569,4.014383,3.645814,1.501638,17.275713,15.774075,0.125966,4.037144,3.911178,0.164329,3.278042,3.113713,4.306062,29.792321,25.486259,590.701584,128.24364,-462.457944,162.787329,355.279034,192.491705,0,0,0,0,0,0,48.82732,91.273488,42.446168,0.067702,34.67867,34.610968,0.077672,30.638436,30.560764,1629.083016,1073.771682,-555.311334,3685.285991,814.693772,-2870.592219,25.458172,21.900322,-3.55785000000001,13.893524,33.780881,19.887357,0.000024,2.105646,2.105622,702.447103,506.626082,-195.821021,681.866855,661.713406,-20.153449,63.765335,42.043331,-21.722004,872.563361,1057.235159,184.671798,2206.19446,3225.212951,1019.018491,5.220458,166.839956,161.619498,17.614333,77.346365,59.732032,452.649135,652.670606,200.021471,0.000837,0.245757,0.24492,15.580603,48.676233,33.09563,997.555262,363.045169,-634.510093,0,0.110031,0.110031,580.936895,247.107742,-333.829153,348.622942,195.461633,-153.161309,8.430062,0.23676,-8.193302,493.031556,193.647314,-299.384242,3619.513157,4136.261025,516.747868,2658.862857,716.810314,-1942.052543,1508.130542,3051.809571,1543.679029,1230.41797,2106.071545,875.653575,31.312149,116.623187,85.311038,0.085122,0.066727,-0.018395,4.023823,2.597441,-1.426382,2798.131966,2211.479728,-586.652238,6997.757265,3688.68365,-3309.073615,581.807581,175.899855,-405.907726,,,,237.392656,109.388969,-128.003687,91.219651,24.902165,-66.317486,262.431439,100.465699,-161.96574,21.456782,1.950988,-19.505794,1590.759775,1663.862886,73.1031109999992,117.448163,19.134831,-98.313332,17.864615,52.881855,35.01724,93.020724,82.335627,-10.685097,331.09595,248.613875,-82.482075,,,,2597.753217,451.098697,-2146.65452,20.555322,14.604725,-5.950597,77.993079,133.436051,55.442972,11.329294,6.422291,-4.907003,288.205085,10.892445,-277.31264,40.460048,36.43131,-4.02873799999999,108.601408,44.495971,-64.105437,0.510518,2.666929,2.156411,0.902285,2.419663,1.517378,0.020299,0.974843,0.954544,0.863665,2.945282,2.081617,0.498321,6.572304,6.073983,797.484803,997.944961,200.460158,202.110616,107.734726,-94.37589,0.899576,367.258012,366.358436,17.001182,27.262978,10.261796,0.291965,0.097925,-0.19404,0.006718,0.093976,0.087258,2452.948303,1188.493074,-1264.455229,,,,32.553205,37.003621,4.450416,39.734337,90.190546,50.456209,2.244567,0.77409,-1.470477,5.625422,1.40648,-4.218942,,,,4.551243,6.067405,1.516162,0.018144,0.552136,0.533992,0.119933,0.390281,0.270348,2.849357,3.989098,1.139741,86.508266,75.708023,-10.800243,94.054388,100.99928,6.944892,27.674483,22.759367,-4.915116,493.838765,1193.754573,699.915808,1.154642,10.035798,8.881156,1.476893,18.210381,16.733488,6.997792,132.204966,125.207174,1074.605798,250.6643,-823.941498,0.058448,15.870925,15.812477,731.5,569.6,-161.9,0.092043,0,-0.092043,0.217188,0.057059,-0.160129,84.887075,116.316172,31.429097,352.4427,213.304937,-139.137763,,,,2526.284881,928.892446,-1597.392435,112.007336,103.448781,-8.55855499999996,147.391679,893.809225,746.417546,11.818547,20.381713,8.563166,106.639625,78.026002,-28.613623,29.682557,84.613406,54.930849,1.587416,101.747666,100.16025,2524.44642,1352.516905,-1171.929515,289.141531,267.407903,-21.733628,4.973782,1.923607,-3.050175,428.741681,59.291204,-369.450477,169.085268,17.225744,-151.859524,0,4.228588,4.228588,1944.555669,888.263527,-1056.292142,1382.999483,333.948437,-1049.051046,5.067015,1.555041,-3.511974,221.199624,9.736889,-211.462735,2081.868835,1281.372757,-800.496078,1536.737048,2366.829144,830.092096,1548.528433,509.95887,-1038.569563,0,0.620776,0.620776,0.486706,10.98895,10.502244,685.119908,605.439162,-79.680746,9.425198,24.281261,14.856063,0.011255,0.093311,0.082056,0.134762,1.237192,1.10243,31377.353746,8017.791834,-23359.561912,2.210384,16.387183,14.176799,0,0,0,4198.202054,3195.544833,-1002.657221,349.296535,2508.107985,2158.81145,3316.391495,2276.240849,-1040.150646,9884.63726,4998.190538,-4886.446722,685.237177,1853.57373,1168.336553,0,0.033815,0.033815,0.151033,0.490284,0.339251,0.558583,0.110634,-0.447949,0,0.005368,0.005368,4.101895,5.284755,1.18286,213.271965,210.164988,-3.106977,0.119631,0.173861,0.05423,0.311995,0.152842,-0.159153,0.000213,0.153292,0.153079,0.314793,2.110289,1.795496,0.096551,0.927564,0.831013,0.08509,0.105178,0.020088,0,0.00022,0.00022,0.053651,0.239434,0.185783,0.000013,0.034132,0.034119,8.302982,4.032924,-4.270058,0,0.007445,0.007445,2.908614,9.33514,6.426526,0.40939,45.197468,44.788078,0.222385,2.885769,2.663384,0,1.252772,1.252772,0.069368,0.037067,-0.032301,7.61026,1.853158,-5.757102,0.114038,1.346543,1.232505,59.733572,249.956899,190.223327,1533.946974,73.559376,-1460.387598,21.825893,37.741139,15.915246,0.033242,25.30202,25.268778,171.014851,659.150182,488.135331,0.341,1.364713,1.023713,0,0,0,0,0,0,215.881695,14.35239,-201.529305,0.062046,7.583934,7.521888,8.655998,8.355186,-0.300811999999999,0.278116,27.425933,27.147817,0.105388,3.177783,3.072395,6.516049,7.206664,0.690615000000004,0.931493,7.570394,6.638901,192.232322,5.655478,-186.576844,17.504525,88.411997,70.907472,0.029766,2.173393,2.143627,0.721128,3.399968,2.67884,0.03692,7.090504,7.053584,3231.435325,341.216419,-2890.218906,0.324931,0.743903,0.418972,436.423503,15.985412,-420.438091,271.897041,2.268996,-269.628045,0.761394,0.055473,-0.705921,0.593146,2.710897,2.117751,0.000513,36.77279,36.772277,797.84836,106.071011,-691.777349,186.70753,15.20075,-171.50678,0.000007,4.224503,4.224496,0.109239,1.644619,1.53538,0.001722,0.244498,0.242776,2.196973,10.424759,8.227786,1.543352,7.059613,5.516261,3.009212,0.793321,-2.215891,1.801565,5.983717,4.182152,0.002115,0.268616,0.266501,3.008064,7.812769,4.804705,0.030058,0.214771,0.184713,0.003429,4.397281,4.393852,3.773641,15.024681,11.25104,29.724629,31.474293,1.74966399999999,0.391912,0.558974,0.167062,0.37173,1.00583,0.6341,6.280243,16.892036,10.611793,18.126316,5.313926,-12.81239,2.014464,36.541746,34.527282,5.962999,5.841855,-0.121144,0.000208,0.191051,0.190843,0.240895,0.080095,-0.1608,3.361272,1.065366,-2.295906,0.007519,0.041376,0.033857,761.66901,476.506542,-285.162468,2.854598,7.030212,4.175614,30.931376,1.12469,-29.806686,1.728517,7.47126,5.742743,10.50828,1.121568,-9.386712,0.753228,3.200258,2.44703,4.553814,3.313868,-1.239946,24.71494,0.031938,-24.683002,0,0,0,,,
2011-02-01,13499.016415,4232.058392,-9266.958023,26833.396871,19906.24988,-6927.146991,174228,115705,-58523,11699.180577,0,-11699.180577,11920.874711,6595.180231,-5325.69448,27005.070206,21011.465562,-5993.604644,8613.108467,10129.854697,1516.74623,11707.147694,11778.994184,71.8464899999963,42274.955874,34416.578713,-7858.377161,31174.237461,24387.729464,-6786.50799700001,7085.728169,2828.826652,-4256.901517,51205.588315,28644.904236,-22560.684079,156320.729011,109541.446075,-46779.282936,63243.218957,33657.805776,-29585.413181,2086.328079,2201.212775,114.884696000001,834.961656,2470.981132,1636.019476,5513.453305,1800.151597,-3713.301708,0.476918,0.530154,0.053236,23221.381961,20507.860477,-2713.521484,0.002282,0,-0.002282,19053.573913,13908.718236,-5144.855677,333.939083,471.097179,137.158096,14.554609,26.24253,11.687921,190.512719,257.903421,67.390702,370.141639,464.134287,93.9926479999999,181.085048,102.565424,-78.519624,687.880937,365.219806,-322.661131,23.196668,456.101485,432.904817,0.398294,41.585396,41.187102,78.261527,269.501554,191.240027,0,31.849122,31.849122,28.033342,115.720764,87.687422,0.703343,14.653884,13.950541,1.572723,44.596411,43.023688,58.293937,84.856062,26.562125,322.768653,540.292658,217.524005,0.23908,1.669774,1.430694,0.12384,10.969323,10.845483,4.442821,10.386462,5.943641,0.31537,17.782888,17.467518,0.246476,0.460979,0.214503,0.342232,5.822005,5.479773,1.185725,31.876078,30.690353,0.092304,3.865668,3.773364,0.195465,4.517275,4.32181,2.3347,36.518756,34.184056,453.282634,140.317784,-312.96485,260.378443,355.749004,95.370561,0,0,0,0,0,0,210.609801,76.824896,-133.784905,0.072232,23.048581,22.976349,0.005065,23.048124,23.043059,1178.369382,1124.210895,-54.1584870000002,2822.060683,792.754181,-2029.306502,26.128893,24.415428,-1.713465,30.953344,29.423667,-1.52967700000001,0.013137,29.4821,29.468963,897.893038,384.048631,-513.844407,456.223024,616.812455,160.589431,65.740169,43.450689,-22.28948,731.841053,956.217703,224.37665,1983.415751,2866.345216,882.929465,4.73995,163.287467,158.547517,19.198672,81.056939,61.858267,265.356245,638.20898,372.852735,0.005643,0.102253,0.09661,16.649509,14.628952,-2.02055699999999,787.290876,427.269067,-360.021809,0.002462,0.125302,0.12284,415.669733,299.686984,-115.982749,340.400147,157.262725,-183.137422,6.128286,0.640558,-5.487728,437.020703,165.754519,-271.266184,3510.977398,3677.063509,166.086111,3408.493273,760.098744,-2648.394529,1966.13145,2902.333117,936.201667,1565.855368,2334.646667,768.791299,27.536601,117.52006,89.983459,0.055554,0.78221,0.726656,1.058632,0.406214,-0.652418,2821.025391,2291.086629,-529.938762,7023.552107,3846.209802,-3177.342305,691.989724,184.715462,-507.274262,,,,206.367045,113.183466,-93.1835789999999,71.139526,13.964054,-57.175472,201.306658,118.210786,-83.095872,17.299591,2.436042,-14.863549,1719.55576,1529.876144,-189.679616,101.162205,19.002672,-82.159533,43.978419,30.488608,-13.489811,40.475605,79.219303,38.743698,283.80721,220.366605,-63.4406049999999,,,,1568.917163,581.896577,-987.020586,7.619891,18.140934,10.521043,113.959721,148.885922,34.926201,3.663429,2.922634,-0.740795,0.32756,31.143794,30.816234,12.597255,87.82729,75.230035,48.320217,54.33389,6.01367299999999,0.233379,25.206056,24.972677,0.593429,0.97262,0.379191,0.013003,22.606366,22.593363,1.347742,3.943566,2.595824,0.626422,12.219173,11.592751,662.924817,845.940578,183.015761,146.589023,130.319114,-16.269909,0.000709,201.989909,201.9892,19.883186,28.887444,9.004258,0.476755,0.255401,-0.221354,0.105768,0.241585,0.135817,2256.795653,1246.566129,-1010.229524,,,,23.974898,42.457056,18.482158,35.087051,31.026541,-4.06050999999999,2.048982,1.763267,-0.285715000000001,8.919852,1.372677,-7.547175,,,,5.878206,7.068201,1.189995,0,1.16338,1.16338,0.399592,0.616751,0.217159,2.583338,2.784725,0.201387,64.799269,70.730324,5.93105500000001,88.64922,73.914869,-14.734351,27.312565,13.074423,-14.238142,361.813752,1383.085404,1021.271652,2.846381,7.394663,4.548282,1.254722,34.765637,33.510915,6.624525,122.964204,116.339679,855.715192,145.654445,-710.060747,0.445007,16.377089,15.932082,651.7,698,46.3,0.384661,0,-0.384661,0.428637,0,-0.428637,82.945944,84.716059,1.77011499999999,259.411212,194.577181,-64.834031,,,,3383.901144,812.189675,-2571.711469,17.938325,186.34881,168.410485,122.849045,1149.917984,1027.068939,12.845357,29.314884,16.469527,75.827981,82.0358,6.207819,55.180688,236.393549,181.212861,0.886274,184.021064,183.13479,2229.274266,1440.948674,-788.325592,240.735391,149.165892,-91.569499,5.622195,4.400524,-1.221671,391.576191,78.827507,-312.748684,154.739949,30.195279,-124.54467,0,1.243173,1.243173,1734.568349,986.538356,-748.029993,1243.912845,355.139958,-888.772887,3.428285,2.252113,-1.176172,208.926657,12.03327,-196.893387,1874.733356,1153.96631,-720.767046,1522.583453,2287.115426,764.531973,1452.496957,588.84746,-863.649497,0,0.339525,0.339525,5.846591,10.032226,4.185635,626.205693,651.04968,24.8439870000002,8.091368,20.426158,12.33479,0.012605,0.217784,0.205179,0.076362,2.503014,2.426652,27244.735813,8383.310124,-18861.425689,0.818738,33.428262,32.609524,0,0,0,3882.684605,3068.068314,-814.616291,282.357433,2766.672005,2484.314572,2925.482976,2007.998952,-917.484023999999,10567.412977,5274.354761,-5293.058216,579.930086,1956.691905,1376.761819,0,0.218996,0.218996,0.028283,0.130959,0.102676,0.390794,0.244115,-0.146679,0,0.002958,0.002958,5.973027,4.976468,-0.996559000000002,227.05398,471.394447,244.340467,0.05226,0.128644,0.076384,0.576843,0.044141,-0.532702,0.000241,0.015186,0.014945,0.105599,1.584815,1.479216,0.048124,0.185479,0.137355,0.154136,0.126924,-0.027212,0,0.005292,0.005292,0.074348,0.151627,0.077279,0.000283,0,-0.000283,9.781224,3.57542,-6.205804,0,0.018491,0.018491,1.592955,10.253314,8.660359,0.763182,13.161054,12.397872,0.06588,3.674344,3.608464,0,1.050041,1.050041,0.002296,0,-0.002296,8.247488,2.080444,-6.167044,0.119887,1.23755,1.117663,133.887105,175.628345,41.74124,1133.600618,103.340916,-1030.259702,26.264266,66.417977,40.153711,3.868785,47.358584,43.489799,159.044868,641.343221,482.298353,0.446,3.042491,2.596491,0,0,0,0,0,0,147.140047,14.83477,-132.305277,0.042529,4.336543,4.294014,51.04623,18.108821,-32.937409,0.777626,7.456233,6.678607,0.15613,4.081936,3.925806,5.871091,8.901591,3.0305,1.252959,4.172693,2.919734,205.498342,6.660448,-198.837894,28.726006,60.756653,32.030647,0.002441,2.428073,2.425632,0.169212,4.29067,4.121458,1.920586,7.06434,5.143754,2772.59997,330.196096,-2442.403874,1.196743,0.595676,-0.601067,130.091276,15.479525,-114.611751,79.821187,4.017835,-75.803352,0.528206,0.156751,-0.371455,0.014103,2.561746,2.547643,0.001999,43.963233,43.961234,1115.451102,76.061799,-1039.389303,184.72649,14.908621,-169.817869,0.049435,0.075484,0.026049,0.004718,0.563953,0.559235,0.017372,0.017731,0.000358999999999998,21.682837,8.914,-12.768837,80.81353,8.927633,-71.885897,1.683222,1.102563,-0.580659,1.257488,0.798708,-0.45878,0.197173,0.083958,-0.113215,2.415787,19.225349,16.809562,0.036994,0.183938,0.146944,0.049918,13.495184,13.445266,2.742712,6.032182,3.28947,18.744515,29.354247,10.609732,0.349502,1.322793,0.973291,0.692542,0.034272,-0.65827,7.425408,23.976647,16.551239,13.521849,3.037909,-10.48394,0.535554,26.676224,26.14067,5.520387,2.536799,-2.983588,0,0.417447,0.417447,0.058462,0.074342,0.01588,1.10618,0.643446,-0.462734,0,0.03407,0.03407,560.282062,1002.466835,442.184773,8.181912,8.788929,0.607016999999997,23.741462,1.549049,-22.192413,3.628133,5.929977,2.301844,5.648009,4.434203,-1.213806,1.992304,2.851575,0.859271,3.767713,1.764371,-2.003342,17.461168,0.357893,-17.103275,0,0,0,,,
2011-03-01,16045.4748,5277.281381,-10768.193419,33504.649229,24387.915841,-9116.733388,181256,122617,-58639,14601.898499,0,-14601.898499,13911.008695,8447.095413,-5463.913282,32121.199208,25396.07037,-6725.12883799999,9646.251107,12017.952408,2371.701301,14890.942279,14377.870239,-513.072040000001,51575.17618,43036.362755,-8538.813425,40324.270958,30206.543885,-10117.727073,8178.365168,2840.700928,-5337.66424,55096.098224,32462.707263,-22633.390961,185977.697222,131725.758836,-54251.938386,69802.005922,38976.024431,-30825.981491,2506.881264,2708.093551,201.212286999999,1205.851663,2287.320624,1081.468961,6070.413378,1713.000886,-4357.412492,1.085052,0.935974,-0.149078,28305.645671,25698.478432,-2607.167239,0,0,0,23269.530509,17337.884323,-5931.64618600001,410.850049,573.579405,162.729356,13.949392,33.413468,19.464076,232.302991,299.275673,66.972682,421.898416,573.577437,151.679021,245.06364,76.891783,-168.171857,820.749966,458.500043,-362.249923,24.762407,701.628115,676.865708,0.776983,56.096786,55.319803,101.150958,314.415146,213.264188,0,37.888317,37.888317,60.164066,136.619684,76.455618,0.957662,19.527234,18.569572,3.947064,53.860918,49.913854,63.612247,89.325834,25.713587,376.016202,726.26921,350.253008,0.348964,2.605555,2.256591,0.129493,14.2021,14.072607,4.858126,10.778461,5.920335,0.975254,11.929916,10.954662,0.016087,0.492007,0.47592,0.116421,6.579832,6.463411,1.922856,22.813898,20.891042,0.127664,9.905144,9.77748,0.516376,6.843316,6.32694,3.301253,38.604812,35.303559,711.84137,147.435841,-564.405529,195.103675,373.545008,178.441333,0,0,0,0,0,0,361.91481,33.412503,-328.502307,0.120529,45.763571,45.643042,1.8896,38.028747,36.139147,1979.777432,1306.816244,-672.961188,3851.484013,851.705474,-2999.778539,29.284829,36.590057,7.30522800000001,24.050157,32.05492,8.004763,0,3.197738,3.197738,812.578296,532.002658,-280.575638,513.493148,631.174504,117.681356,106.731217,74.538607,-32.19261,1030.407232,1399.115877,368.708645,2055.068763,3606.763293,1551.69453,5.437782,160.321609,154.883827,30.909922,106.327007,75.417085,392.33319,721.63366,329.30047,0.001777,1.818827,1.81705,19.438341,57.748539,38.310198,1130.088267,481.840154,-648.248113,0,0.262378,0.262378,859.267336,489.99774,-369.269596,420.360664,272.738511,-147.622153,13.691636,0.143247,-13.548389,679.282413,231.19544,-448.086973,4695.753831,5283.124326,587.370495,3311.632215,832.887701,-2478.744514,1812.49819,3729.052617,1916.554427,1935.801535,2675.238863,739.437328,97.829864,140.313042,42.483178,0.020062,0.822978,0.802916,2.922002,3.539951,0.617949000000001,3742.338787,2483.947872,-1258.390915,9065.004266,4394.422878,-4670.581388,841.320557,196.777636,-644.542921,,,,274.179912,130.880929,-143.298983,128.968218,31.91016,-97.058058,252.057995,142.736533,-109.321462,23.539248,1.99883,-21.540418,2099.609041,2462.138735,362.529693999999,104.163974,14.865094,-89.29888,17.229405,53.401162,36.171757,119.192509,132.419971,13.227462,410.20582,256.424985,-153.780835,,,,3036.795892,599.173598,-2437.622294,5.921946,21.338387,15.416441,112.641955,192.150535,79.5085799999999,7.080139,7.404147,0.324008000000002,56.210209,19.674442,-36.535767,14.231229,28.760396,14.529167,94.523826,84.81481,-9.70901600000001,0.252237,9.006168,8.753931,0.689213,1.668002,0.978789,0.011069,1.514232,1.503163,1.666754,6.646614,4.97986,0.895266,15.091311,14.196045,985.465542,1046.343074,60.8775319999997,255.184937,129.546468,-125.638469,0.002286,230.372581,230.370295,30.688233,27.159505,-3.52872800000001,0.342806,0.160679,-0.182127,0.019248,0.066073,0.046825,2968.980593,1494.482096,-1474.498497,,,,21.005568,46.897641,25.892073,41.085002,31.739032,-9.34597000000001,12.922826,1.426319,-11.496507,9.284415,2.342254,-6.942161,,,,8.126706,9.957564,1.830858,0,1.145547,1.145547,0.597874,1.177865,0.579991,2.781168,3.643033,0.861865000000001,68.029201,61.907481,-6.12171999999998,88.581909,81.004649,-7.57726000000001,27.366507,22.816859,-4.549648,415.131431,1517.543448,1102.412017,1.358883,8.738803,7.37992,27.208707,21.516463,-5.692244,6.532055,165.913342,159.381287,1426.87418,292.606033,-1134.268147,0.039524,15.028333,14.988809,761.2,574,-187.2,0.194285,0,-0.194285,0.941454,0.086596,-0.854858,80.122088,121.841918,41.71983,518.490137,206.900914,-311.589223,,,,3757.777737,1271.943606,-2485.834131,120.838133,324.239268,203.401135,158.02559,1010.288456,852.262866,33.707661,70.671523,36.963862,107.167608,99.107651,-8.05995699999998,51.987361,79.226235,27.238874,3.741578,218.426512,214.684934,3164.616442,1736.167885,-1428.448557,352.684365,250.043166,-102.641199,6.475827,2.62137,-3.854457,476.555507,122.671636,-353.883871,178.029344,16.292101,-161.737243,0,2.078589,2.078589,2231.154771,990.711718,-1240.443053,1066.717589,357.155594,-709.561995,5.598075,4.694839,-0.903235999999999,229.691045,14.471607,-215.219438,2255.709718,1348.945303,-906.764415,1503.167327,2441.37039,938.203063,1759.750964,725.464542,-1034.286422,0.001809,0.085725,0.083916,3.801501,10.484613,6.683112,844.3837,631.876639,-212.507061,9.780826,22.754086,12.97326,0.170174,0.179458,0.00928400000000004,0.168569,2.496998,2.328429,27599.666857,9563.728281,-18035.938576,2.747454,18.632902,15.885448,0,0.737926,0.737926,4668.642425,3987.035623,-681.606801999998,359.258037,3099.548199,2740.290162,3115.183318,2489.998196,-625.185122,11806.733698,5919.569094,-5887.164604,857.051762,1987.789008,1130.737246,0.0005,0.085432,0.084932,0.015899,0.01159,-0.004309,0.05944,0.019827,-0.039613,0,0,0,3.874933,13.214226,9.339293,309.093158,220.929063,-88.1640950000001,0.039121,0.370905,0.331784,0.185869,2.137256,1.951387,0.016611,0.151099,0.134488,0.069608,1.98626,1.916652,0.09085,0.446858,0.356008,0.068944,0.221924,0.15298,0,0.001406,0.001406,0.055872,15.664448,15.608576,0.00087,0.099636,0.098766,11.351754,16.317762,4.966008,0,0.074927,0.074927,3.410843,11.508819,8.097976,0.674038,6.116214,5.442176,0.213216,4.845611,4.632395,0,1.255616,1.255616,0.00004,0,-0.00004,19.383798,2.629178,-16.75462,0.19519,1.532779,1.337589,98.572983,250.819148,152.246165,1677.458594,148.346385,-1529.112209,38.200489,52.403922,14.203433,6.110063,49.412549,43.302486,168.178075,610.993738,442.815663,0.49975,1.048856,0.549106,0,0,0,0,0,0,139.67066,31.392168,-108.278492,0.03472,6.83085,6.79613,8.024525,19.488749,11.464224,0.425015,19.640877,19.215862,0.397713,6.888308,6.490595,9.170631,33.741977,24.571346,0.964856,6.866935,5.902079,26.432113,2.167515,-24.264598,183.070928,106.746433,-76.324495,0.006355,5.299135,5.29278,36.623677,7.126719,-29.496958,3.929892,22.977489,19.047597,2972.080646,487.778085,-2484.302561,0.03595,2.351264,2.315314,681.498525,11.515407,-669.983118,221.654905,4.29548,-217.359425,0.504433,0.387155,-0.117278,0.059896,3.916997,3.857101,0.045793,53.988703,53.94291,625.790315,72.548745,-553.24157,96.613984,15.339908,-81.274076,0.019249,0.08756,0.068311,0.005101,1.092503,1.087402,0.141159,0.021938,-0.119221,0.963757,17.719483,16.755726,45.033743,7.785485,-37.248258,0.79295,4.890793,4.097843,1.24989,2.706705,1.456815,0,0.053399,0.053399,5.608113,7.108353,1.50024,0.02226,0.946099,0.923839,0.062438,3.075791,3.013353,2.756561,13.104479,10.347918,27.14178,27.695749,0.553968999999999,0.372954,1.496982,1.124028,0.158814,0.041703,-0.117111,8.557067,17.958432,9.40136499999999,18.372457,3.711738,-14.660719,2.41509,34.540676,32.125586,7.537001,4.679437,-2.857564,0.000316,0.312721,0.312405,0.168077,0.183646,0.015569,0.832831,0.133621,-0.69921,0.004576,0.006294,0.001718,813.984339,598.098382,-215.885957,58.664594,5.259355,-53.405239,15.434247,2.242241,-13.192006,3.838311,8.616207,4.777896,6.711348,2.053742,-4.657606,2.778423,5.594575,2.816152,2.023293,3.384625,1.361332,32.389685,5.75374,-26.635945,0,0,0,,,
2011-04-01,14847.968611,5340.358066,-9507.610545,31133.763218,23446.591858,-7687.17135999999,181060,124393,-56667,13338.4495,0,-13338.4495,13774.073284,7984.122875,-5789.950409,30152.03435,23056.757554,-7095.276796,10407.503289,11887.423503,1479.920214,15006.973146,14030.791986,-976.18116,47296.098795,39901.38076,-7394.71803500001,38785.31802,28296.163546,-10489.154474,7843.892623,3190.438006,-4653.454617,54489.201267,30099.058947,-24390.14232,178293.463043,124052.072376,-54241.3906670001,68094.391972,36268.826531,-31825.565441,2423.992049,2629.258657,205.266607999999,1266.666147,2305.231411,1038.565264,6036.834811,1939.725961,-4097.10885,0.031245,0.384272,0.353027,25936.403247,23868.761526,-2067.641721,0.091095,0.011005,-0.08009,21359.695548,16032.619234,-5327.076314,427.217147,534.099336,106.882189,18.969119,36.060117,17.090998,193.791516,360.546524,166.755008,364.823949,505.249299,140.42535,241.761578,119.013132,-122.748446,828.097013,494.814096,-333.282917,24.837214,743.567471,718.730257,0.964153,40.882963,39.91881,110.193156,215.715622,105.522466,0.005625,33.342183,33.336558,22.038072,193.420326,171.382254,0.585286,18.06101,17.475724,0.928746,45.823954,44.895208,59.842813,81.806512,21.963699,368.300846,615.53627,247.235424,0.463678,2.471708,2.00803,0.167923,14.307133,14.13921,6.593906,8.347372,1.753466,0.563879,9.478238,8.914359,0.010721,0.58244,0.571719,0.044158,5.721706,5.677548,1.491401,12.070589,10.579188,0.269672,5.830725,5.561053,0.845083,6.234768,5.389685,4.297456,37.994432,33.696976,686.691537,153.716162,-532.975375,247.883313,102.520211,-145.363102,0,0,0,0,0,0,366.167183,33.272417,-332.894766,0.173482,27.541905,27.368423,0.084789,37.738049,37.65326,2132.543014,1227.83353,-904.709483999999,3831.58801,1087.449539,-2744.138471,34.413187,33.681397,-0.731790000000004,28.616869,37.315771,8.698902,0,2.83428,2.83428,612.96128,460.798873,-152.162407,490.653792,709.702247,219.048455,82.541164,73.439417,-9.10174699999997,994.561864,1441.727161,447.165297,2494.957197,3437.155701,942.198504,5.474676,171.851187,166.376511,25.432767,82.974844,57.542077,294.453112,768.16697,473.713858,0.6718,0.094399,-0.577401,15.793383,73.928525,58.135142,1032.986734,479.866084,-553.12065,0,0,0,794.884192,277.142292,-517.7419,394.817056,249.20926,-145.607796,8.892639,0.127521,-8.765118,685.730031,203.652414,-482.077617,4036.065018,4716.462679,680.397661000001,3638.270232,582.324082,-3055.94615,2217.366449,3657.39513,1440.028681,1361.038518,2573.515335,1212.476817,33.481443,75.933521,42.452078,0.033986,0.866506,0.83252,2.040891,1.608915,-0.431976,3421.538984,2763.43016,-658.108823999999,8030.766388,4187.259304,-3843.507084,795.31538,194.307067,-601.008313,,,,256.786306,177.851033,-78.935273,127.051492,18.567586,-108.483906,260.597436,119.118449,-141.478987,19.023134,2.11971,-16.903424,2362.038616,1918.563029,-443.475587,83.514846,51.975771,-31.539075,57.810758,57.055092,-0.755665999999998,61.115982,195.444047,134.328065,335.251675,259.419884,-75.8317909999999,,,,2857.051885,818.921595,-2038.13029,7.156173,33.176494,26.020321,116.167705,134.911613,18.743908,10.682029,6.703888,-3.978141,302.707896,25.915424,-276.792472,21.753302,68.225149,46.471847,565.464615,73.282084,-492.182531,0.13618,6.743346,6.607166,0.828329,3.319342,2.491013,0.056614,2.378217,2.321603,1.248377,3.458365,2.209988,0.440876,9.854336,9.41346,1076.357718,1026.235478,-50.1222399999997,154.884991,113.058234,-41.826757,0.00041,212.955107,212.954697,16.058621,81.857121,65.7985,0.832161,0.05899,-0.773171,0.000495,0.183001,0.182506,2797.218583,1448.559532,-1348.659051,,,,35.924775,25.280797,-10.643978,42.345705,18.937392,-23.408313,2.760989,0.777679,-1.98331,1.653949,1.079377,-0.574572,,,,41.734398,11.050776,-30.683622,0.003032,1.699639,1.696607,0.418722,1.622264,1.203542,1.518247,3.243518,1.725271,85.915831,72.472391,-13.44344,107.913231,91.590297,-16.322934,22.217969,23.247191,1.029222,480.306802,1130.374189,650.067387,1.345841,7.847324,6.501483,74.240475,24.509371,-49.731104,6.642327,142.427525,135.785198,1107.079048,225.257237,-881.821811,0.00284,21.308861,21.306021,662.1,515.8,-146.3,0.225841,0,-0.225841,0.397142,0.009738,-0.387404,79.963499,145.955079,65.99158,373.801025,215.252251,-158.548774,,,,3163.44529,1197.096477,-1966.348813,54.202078,284.831803,230.629725,163.492862,1069.947544,906.454682,25.406768,60.071436,34.664668,130.766422,116.336648,-14.429774,33.556782,94.956739,61.399957,2.053332,211.753646,209.700314,3253.2588,1877.410793,-1375.848007,293.039606,205.346235,-87.6933709999999,4.153381,6.032906,1.879525,426.667554,121.617181,-305.050373,160.118101,22.551,-137.567101,0,3.398474,3.398474,2083.531549,801.568041,-1281.963508,1359.419569,383.428921,-975.990648,3.192106,2.681201,-0.510904999999999,193.863114,11.992262,-181.870852,2211.683164,1282.471543,-929.211621,1578.835387,2640.554611,1061.719224,1537.402483,680.284657,-857.117826,0.024693,0.044539,0.019846,0.399886,12.088388,11.688502,671.718492,745.914203,74.1957110000002,11.503779,26.933901,15.430122,0.000882,0.341763,0.340881,0.187835,2.611307,2.423472,29580.282706,8000.503316,-21579.77939,0.421594,41.572176,41.150582,0,1.04,1.04,4901.58922,3887.239571,-1014.349649,336.749424,2963.181163,2626.431739,3590.329258,2396.448158,-1193.8811,8829.185784,5188.415162,-3640.770622,919.240131,2047.285756,1128.045625,0.000299,0.040428,0.040129,0.111444,0,-0.111444,0.119899,0.068307,-0.051592,0.014459,0,-0.014459,5.002758,13.480479,8.477721,315.278795,214.258039,-101.020756,0.028254,0.131837,0.103583,0.428013,0.171381,-0.256632,0.002556,0.134438,0.131882,0.195099,2.141083,1.945984,0.137829,0.18039,0.042561,0.146502,0.643441,0.496939,0.001011,0,-0.001011,0.025052,0.164436,0.139384,0.00697,0.067814,0.060844,5.298277,4.511375,-0.786902,0,0.060021,0.060021,3.530301,9.255448,5.725147,1.833225,4.013793,2.180568,0.302699,3.489964,3.187265,0.090226,0.984649,0.894423,0.047524,0,-0.047524,14.727862,2.476831,-12.251031,0.119185,1.636676,1.517491,55.408486,187.843315,132.434829,1536.333455,256.294494,-1280.038961,26.6045,48.75163,22.14713,0.210317,72.864783,72.654466,182.587533,742.173661,559.586128,1.099177,3.065321,1.966144,0,0,0,0,0,0,38.314157,71.943275,33.629118,0.300626,7.046433,6.745807,5.457572,16.266243,10.808671,0.604262,24.94646,24.342198,0.096063,2.237472,2.141409,7.42733,36.569402,29.142072,0.50745,12.069512,11.562062,7.918896,2.703582,-5.215314,34.053837,147.29143,113.237593,0.006668,1.360044,1.353376,85.131452,5.322342,-79.80911,4.247504,9.142188,4.894684,2944.295849,395.833293,-2548.462556,0.006614,1.869871,1.863257,401.742735,16.515147,-385.227588,146.502133,0.334137,-146.167996,2.539145,0.17665,-2.362495,0.029892,1.64739,1.617498,0.032642,61.961904,61.929262,1060.684596,112.520353,-948.164243,172.067593,21.647816,-150.419777,0.000071,0.197567,0.197496,0.06314,0.806557,0.743417,0.258839,0.181171,-0.077668,23.912113,26.377239,2.465126,159.043987,6.857544,-152.186443,0.136603,1.211222,1.074619,0.53266,0.344523,-0.188137,0.228149,0.304764,0.076615,8.88911,6.345723,-2.543387,0.01589,0.19,0.17411,0.500463,28.722343,28.22188,3.647859,3.947752,0.299893,23.271878,38.691343,15.419465,0.467887,0.458142,-0.009745,0.19154,0.089178,-0.102362,6.707025,19.908435,13.20141,16.833276,4.88564,-11.947636,0.913566,31.319739,30.406173,7.092947,4.409985,-2.682962,0,0.301401,0.301401,0.082572,0.171072,0.0885,3.295182,1.099498,-2.195684,0,0.111891,0.111891,797.167026,642.446781,-154.720245,10.563247,7.48418,-3.079067,24.851083,3.385752,-21.465331,4.705805,16.026786,11.320981,5.42313,1.04202,-4.38111,1.379891,6.110179,4.730288,5.391929,2.130189,-3.26174,21.893644,0.466832,-21.426812,0,58.844859,58.844859,,,
2011-05-01,16915.856485,5504.886747,-11410.969738,31676.945934,22720.191908,-8956.75402600001,185321,123588,-61733,13739.367478,0,-13739.367478,13838.481536,8215.539195,-5622.942341,31410.633893,23442.203764,-7968.43012899999,11210.847807,11194.542236,-16.305570999999,15536.532809,14247.969804,-1288.563005,49935.37032,41291.585431,-8643.784889,39732.199924,27532.456377,-12199.743547,8354.390277,2648.767109,-5705.623168,58163.065928,29524.144972,-28638.920956,188953.370674,124235.660516,-64717.710158,74158.398179,36040.321329,-38118.07685,2447.750581,2718.147945,270.397364,1236.192589,2440.006884,1203.814295,6411.703037,1704.073497,-4707.62954,0.286576,0.286964,0.000387999999999999,26965.168812,24479.804804,-2485.364008,0,0.099598,0.099598,22970.201508,16811.780627,-6158.420881,417.529999,531.269907,113.739908,16.029673,28.490268,12.460595,234.271893,319.101224,84.8293310000001,400.670262,575.886817,175.216555,214.798586,74.289886,-140.5087,809.523947,521.418313,-288.105634,51.022698,585.043184,534.020486,44.983528,65.820163,20.836635,76.511107,331.597107,255.086,0,32.052362,32.052362,42.932008,171.505286,128.573278,0.850312,16.992134,16.141822,1.38992,53.888607,52.498687,64.747758,68.749456,4.00169799999999,370.955894,696.181798,325.225904,0.237088,2.298673,2.061585,0.515272,11.880769,11.365497,5.282918,8.498688,3.21577,0.597117,8.451049,7.853932,0.018185,0.988479,0.970294,0.020079,5.427843,5.407764,1.581591,51.443573,49.861982,0.145613,4.813642,4.668029,0.811206,4.78908,3.977874,3.267014,36.250721,32.983707,648.22536,230.422382,-417.802978,0,0,0,3.15193,38.877492,35.725562,39.990711,28.495809,-11.494902,327.518811,72.201866,-255.316945,0.232502,53.416084,53.183582,0.004252,26.118654,26.114402,2294.820561,1068.197335,-1226.623226,4078.125682,983.929828,-3094.195854,28.53515,27.171352,-1.363798,30.596379,33.267796,2.67141699999999,0.05329,4.195001,4.141711,766.71558,507.580817,-259.134763,367.158394,804.424553,437.266159,55.336647,40.763582,-14.573065,805.565516,1379.310155,573.744639,2909.480069,3620.344565,710.864496,3.399224,150.17466,146.775436,25.206348,94.733094,69.526746,391.729578,877.06383,485.334252,1.993157,0.15192,-1.841237,17.105556,51.063204,33.957648,1077.897566,506.8959,-571.001666,0,0.038188,0.038188,856.995599,318.621394,-538.374205,446.345864,331.615285,-114.730579,13.329464,0.320154,-13.00931,503.365588,182.771465,-320.594123,4728.684248,4787.21731,58.5330620000013,2971.679913,543.192331,-2428.487582,2056.034112,3843.665377,1787.631265,1553.761757,2417.348119,863.586362,51.012467,65.255499,14.243032,0.038776,0.58874,0.549964,2.643535,1.838013,-0.805522,3414.341326,2390.283149,-1024.058177,7864.240515,4083.295108,-3780.945407,807.729848,177.284717,-630.445131,,,,283.572648,164.140512,-119.432136,153.169393,30.509795,-122.659598,227.36055,146.478054,-80.882496,22.17231,1.90235,-20.26996,2274.647896,1790.04608,-484.601816,151.48943,54.306411,-97.183019,63.737036,43.157704,-20.579332,154.755242,123.409591,-31.345651,331.527673,264.52408,-67.003593,,,,3524.768572,767.452908,-2757.315664,89.755889,13.895258,-75.860631,200.784676,153.096118,-47.688558,8.574319,10.190741,1.616422,378.884772,9.892169,-368.992603,16.151869,39.890962,23.739093,132.83798,52.899557,-79.938423,0.56878,4.16095,3.59217,1.122886,3.510647,2.387761,11.568751,1.48547,-10.083281,2.875819,3.670113,0.794294000000001,0.8908,11.590604,10.699804,1061.610452,756.613492,-304.99696,290.06528,96.746001,-193.319279,0.089734,208.464213,208.374479,21.027701,24.788259,3.760558,0.729842,0.123566,-0.606276,0.069464,0.05082,-0.018644,3154.083178,1411.04434,-1743.038838,,,,39.770067,72.769832,32.999765,43.813606,40.427886,-3.38572,3.549017,1.29787,-2.251147,1.129877,2.079049,0.949171999999999,,,,8.685867,11.738061,3.052194,0.22558,0.640214,0.414634,0.025418,3.552127,3.526709,1.606443,3.982398,2.375955,78.698461,100.390454,21.691993,125.464057,90.064,-35.400057,57.884911,35.382083,-22.502828,443.654432,1271.412699,827.758267,3.593112,9.384986,5.791874,49.458242,2.900848,-46.557394,7.860051,135.596878,127.736827,1311.711446,255.327077,-1056.384369,0.11341,15.537109,15.423699,689,511.4,-177.6,0.024518,0.002553,-0.021965,0.366932,0.034533,-0.332399,69.169674,174.12521,104.955536,764.876934,222.600816,-542.276118,,,,3887.124657,1211.621017,-2675.50364,190.24661,122.11003,-68.13658,304.008414,1414.535467,1110.527053,20.951558,47.003644,26.052086,28.767506,120.746056,91.97855,33.504895,76.426478,42.921583,1.459329,290.890965,289.431636,3468.61808,1997.074689,-1471.543391,352.990345,181.143375,-171.84697,5.466398,2.995033,-2.471365,442.017139,90.648363,-351.368776,168.857969,19.384336,-149.473633,0,4.261365,4.261365,2084.719372,922.500625,-1162.218747,1438.728212,351.964018,-1086.764194,4.711895,1.246326,-3.465569,195.992179,17.021026,-178.971153,2097.81252,1178.028409,-919.784110999999,1750.262994,2582.85937,832.596376000001,1734.846558,569.933277,-1164.913281,0,0.086971,0.086971,0.279713,53.433213,53.1535,810.813291,655.706105,-155.107186,8.268407,24.777354,16.508947,0.000645,0.20267,0.202025,0.226579,1.894398,1.667819,32788.071613,7849.159315,-24938.912298,1.782984,27.585017,25.802033,0,0,0,5197.883658,3906.191692,-1291.691966,488.780668,2425.282864,1936.502196,3773.920487,2280.20831,-1493.712177,8317.037438,5625.488884,-2691.548554,881.528656,2127.644644,1246.115988,0,0,0,0.194175,0.013998,-0.180177,0.001715,0.126591,0.124876,0.000026,0.006086,0.00606,4.761779,8.203872,3.442093,308.798146,237.227663,-71.5704829999999,0.022287,0.426318,0.404031,0.530511,0.007259,-0.523252,0.00984,0.086969,0.077129,0.436251,2.067636,1.631385,0.426295,0.020977,-0.405318,0.14632,0.605192,0.458872,0,0.030024,0.030024,0.045548,0.111152,0.065604,0.000013,0,-0.000013,17.647701,7.321862,-10.325839,0,0.16062,0.16062,5.617452,11.103504,5.486052,2.314159,35.472973,33.158814,0.196118,3.502345,3.306227,0.093127,1.3779,1.284773,0.018844,0.069534,0.05069,13.285244,2.693216,-10.592028,0.113821,1.668435,1.554614,54.893795,172.343504,117.449709,1705.601408,125.173944,-1580.427464,21.880635,51.4969,29.616265,0.048808,40.753406,40.704598,157.211097,565.561129,408.350032,0.875,3.821779,2.946779,0,0,0,0,0,0,225.086906,16.613323,-208.473583,0.044672,5.657694,5.613022,7.89335,33.398088,25.504738,0.462239,15.532416,15.070177,0.658648,2.792471,2.133823,1.279434,13.280457,12.001023,0.909659,5.081268,4.171609,12.09819,4.998978,-7.099212,50.971936,114.366576,63.39464,0.004792,1.695548,1.690756,0.05175,5.612623,5.560873,11.533393,9.03457,-2.498823,2802.172469,521.378775,-2280.793694,1.703716,0.804594,-0.899122,457.521014,17.453169,-440.067845,277.212719,1.157704,-276.055015,0.47612,0.079844,-0.396276,0.104102,2.776419,2.672317,0.035475,52.941207,52.905732,1104.783622,96.237232,-1008.54639,245.519626,29.398338,-216.121288,0.000002,0.07963,0.079628,0.114456,0.972939,0.858483,0.397439,0.018179,-0.37926,6.304791,15.199558,8.89476699999999,107.242049,17.54834,-89.693709,0.025618,4.113984,4.088366,1.049746,0.485718,-0.564028,0.286736,0.232535,-0.054201,11.63761,11.805795,0.168184999999999,0.000046,0.360291,0.360245,0.140859,10.615245,10.474386,3.498705,6.239262,2.740557,33.43655,48.817231,15.380681,0.800123,0.83081,0.030687,0.885759,0.007441,-0.878318,8.244209,14.120902,5.876693,22.10859,3.352395,-18.756195,4.054163,34.769428,30.715265,7.742417,3.286746,-4.455671,0.00013,0.145348,0.145218,0.000067,0.077216,0.077149,1.359984,0.582585,-0.777399,0.002189,0.009433,0.007244,831.519104,529.318681,-302.200423,67.146889,15.032478,-52.114411,31.753097,2.553833,-29.199264,5.139016,14.03619,8.897174,11.050978,1.238122,-9.812856,14.412437,8.353278,-6.059159,9.048831,10.187575,1.138744,30.851151,0.834568,-30.016583,0,34.16702,34.16702,,,
2011-06-01,18833.21783,5326.426729,-13506.791101,32344.577756,23324.492173,-9020.08558299999,185391,121316,-64075,14156.178982,0,-14156.178982,13703.088454,8255.394417,-5447.694037,33471.432034,25230.690826,-8240.74120800001,10982.165307,11239.57688,257.411573000003,15191.626374,13872.465379,-1319.160995,49572.332118,41090.513468,-8481.81865000001,39220.887378,28530.071804,-10690.815574,8612.43651,2714.122595,-5898.313915,60522.352951,29836.041474,-30686.311477,191582.14825,125000.642272,-66581.5059780001,77796.604979,36140.470407,-41656.134572,2650.294915,2563.6161,-86.6788150000002,1187.541825,2652.347577,1464.805752,7066.197147,1719.152788,-5347.044359,0.719066,0.643086,-0.0759799999999998,26857.570759,24297.671851,-2559.898908,0,0.007956,0.007956,22714.761359,16792.841617,-5921.91974200001,432.081276,523.283735,91.202459,27.570032,25.77041,-1.799622,226.436798,284.74734,58.3105419999999,418.724809,537.501543,118.776734,227.776642,93.418403,-134.358239,949.988497,510.049547,-439.93895,40.909855,495.792663,454.882808,3.046917,53.508952,50.462035,93.17295,258.061775,164.888825,0,26.56898,26.56898,61.254187,150.165552,88.911365,1.173994,15.672876,14.498882,0.85715,50.746081,49.888931,75.021648,103.031121,28.009473,395.286893,614.615532,219.328639,0.421737,3.421553,2.999816,0.371441,13.101252,12.729811,3.622397,8.519376,4.896979,0.428325,8.507788,8.079463,0.085451,0.886875,0.801424,0.063715,9.373714,9.309999,1.39241,20.007473,18.615063,0.165918,4.771412,4.605494,0.931436,10.810879,9.879443,4.423761,33.305591,28.88183,649.494788,139.840196,-509.654592,0,0,0,1.144629,27.976638,26.832009,79.327095,30.351814,-48.975281,217.237542,63.946032,-153.29151,0.192008,44.216481,44.024473,0.069825,26.130455,26.06063,1460.310094,1194.411365,-265.898729,4354.213033,1109.076005,-3245.137028,26.586682,30.920667,4.333985,24.450618,24.672681,0.222063000000009,0.000127,2.345559,2.345432,943.860138,444.249447,-499.610691,592.081083,691.591366,99.5102829999998,89.305122,38.868055,-50.437067,575.416738,1424.779927,849.363189,2819.764857,3604.422497,784.65764,4.301092,167.068656,162.767564,24.659063,95.23843,70.579367,364.003594,856.651289,492.647695,0.000007,0.067396,0.067389,15.48717,53.638493,38.151323,1113.319386,478.584531,-634.734855,0,0.14191,0.14191,645.867018,356.569038,-289.29798,362.081613,246.54213,-115.539483,10.793758,0.235489,-10.558269,615.038697,164.440743,-450.597954,4275.403914,5100.92328,825.519366,3518.173953,588.598978,-2929.574975,2817.244817,3489.86929,672.624473,1582.699748,2609.588226,1026.888478,50.073099,126.630207,76.557108,0.050004,0.233258,0.183254,2.991473,2.323346,-0.668127,3260.161293,2243.273018,-1016.888275,8086.162455,4378.356012,-3707.806443,770.016381,388.234943,-381.781438,,,,293.110669,135.976087,-157.134582,119.783887,19.285843,-100.498044,246.764686,109.986716,-136.77797,23.846579,1.531762,-22.314817,2017.210917,2042.116835,24.9059179999999,87.985483,23.165596,-64.819887,26.640727,31.399166,4.75843900000001,115.337737,91.277865,-24.059872,343.633979,273.981137,-69.6528419999999,,,,3140.142783,636.412649,-2503.730134,20.518775,5.381929,-15.136846,144.138885,198.483037,54.3441520000001,7.436974,8.168149,0.731174999999998,194.550599,90.912622,-103.637977,14.706904,44.057203,29.350299,98.047116,77.027336,-21.01978,0.223795,3.690421,3.466626,1.939772,4.818095,2.878323,0.384528,1.347886,0.963358,3.252473,6.232264,2.979791,22.626105,7.847627,-14.778478,1033.181411,856.364015,-176.817396,224.332355,164.03533,-60.2970250000001,0.024017,257.979366,257.955349,22.023263,32.375961,10.352698,0.277461,0.190444,-0.087017,0.055596,0.167867,0.112271,3081.194257,1518.523417,-1562.67084,,,,27.310836,21.598002,-5.71283399999999,49.708665,14.708074,-35.000591,2.909362,1.117386,-1.791976,1.832884,1.937406,0.104522,,,,11.464897,11.185225,-0.279672,0.038144,0.51919,0.481046,0.260815,1.905706,1.644891,1.952204,7.533613,5.581409,69.621479,133.540892,63.919413,127.452457,66.911014,-60.541443,51.487452,31.514747,-19.972705,465.967778,1360.276077,894.308299,1.943893,6.404955,4.461062,115.953019,14.320314,-101.632705,6.755876,141.727555,134.971679,1977.451076,196.322506,-1781.12857,0,11.263199,11.263199,710.2,680.1,-30.1,0.285525,0,-0.285525,0.60549,0.071514,-0.533976,93.926619,129.95952,36.032901,917.512829,218.440873,-699.071956,,,,4416.8828,1027.757978,-3389.124822,123.09154,165.8295,42.73796,175.917279,1396.927611,1221.010332,107.276331,65.515652,-41.760679,235.318077,95.240928,-140.077149,33.83444,68.8263,34.99186,1.671345,225.484722,223.813377,3295.506807,2111.768908,-1183.737899,368.247898,134.378908,-233.86899,6.609133,6.833944,0.224811,410.886381,59.418976,-351.467405,159.871492,16.694762,-143.17673,0,3.422955,3.422955,2122.436939,905.059749,-1217.37719,1518.740689,365.188704,-1153.551985,4.838482,3.864728,-0.973754,200.653655,16.668689,-183.984966,2169.93259,1331.010927,-838.921663,1630.38241,2691.005137,1060.622727,1541.252111,656.484094,-884.768017,0,0.017074,0.017074,0.441706,18.966333,18.524627,863.26671,600.252078,-263.014632,9.887452,24.296089,14.408637,0.240017,0.816938,0.576921,0.285202,3.007607,2.722405,34374.830793,7867.005088,-26507.825705,1.138988,24.553162,23.414174,0,0,0,5103.928653,3555.943923,-1547.98473,397.333226,2855.503624,2458.170398,3850.521018,2137.124196,-1713.396822,9421.468533,5483.553258,-3937.915275,801.441508,2283.613328,1482.17182,0,0,0,0.080587,0.210595,0.130008,0.009272,0.171491,0.162219,0.003452,0.005283,0.001831,28.035813,8.703181,-19.332632,329.630428,322.580218,-7.05020999999994,0.017697,0.535317,0.51762,0.287048,0.202019,-0.0850290000000001,0.001353,0.064418,0.063065,0.31553,2.008966,1.693436,0.138603,0.534478,0.395875,0.473337,0.667452,0.194115,0,0,0,0.051454,0.093186,0.041732,0.000856,0,-0.000856,8.863774,7.121378,-1.742396,0.000019,0.019218,0.019199,6.321676,9.115445,2.793769,0.580408,7.996328,7.41592,0.167164,3.550275,3.383111,0.000221,1.441095,1.440874,0.031504,0.031415,-0.0000889999999999919,10.938496,2.540179,-8.398317,0.155952,1.089642,0.93369,138.587036,255.949557,117.362521,1110.48732,133.722149,-976.765171,27.304908,61.163199,33.858291,0.255402,64.088632,63.83323,151.463167,529.318349,377.855182,1.6065,0.986455,-0.620045,0,0,0,0,0.023466,0.023466,12.783486,11.596085,-1.187401,0.052603,7.083252,7.030649,54.056273,10.050267,-44.006006,0.555797,19.975933,19.420136,0.102417,2.110931,2.008514,7.832748,6.209087,-1.623661,2.251442,6.633944,4.382502,193.269019,10.11035,-183.158669,50.571916,130.080958,79.509042,0.014013,1.753106,1.739093,0.343686,4.460829,4.117143,5.064795,5.918572,0.853777,3325.066912,380.225509,-2944.841403,0.253379,0.62538,0.372001,470.764281,9.468858,-461.295423,351.162338,0.898911,-350.263427,0.057422,0,-0.057422,0.095009,2.308822,2.213813,0.025619,45.838202,45.812583,1370.936978,228.728832,-1142.208146,151.448868,13.897072,-137.551796,0.000027,0.314174,0.314147,0.089008,0.675619,0.586611,0.007387,1.061752,1.054365,18.280349,26.999097,8.718748,2.501395,15.532536,13.031141,0.001587,5.069718,5.068131,2.623091,1.106765,-1.516326,0.051275,0.039989,-0.011286,8.725393,5.348601,-3.376792,0.000853,0.168354,0.167501,0.385507,25.032572,24.647065,2.661597,5.837175,3.175578,31.906988,35.470001,3.56301300000001,1.520591,0.517684,-1.002907,0.528481,0.009687,-0.518794,2.976865,19.435327,16.458462,18.421283,2.916057,-15.505226,1.641329,62.478346,60.837017,11.570306,3.380916,-8.18939,0.012816,0.084961,0.072145,0.002472,0,-0.002472,0.013104,0.464408,0.451304,0,0.009901,0.009901,844.061073,573.098864,-270.962209,48.100022,6.231967,-41.868055,27.86168,2.728414,-25.133266,3.478169,10.20175,6.723581,8.748918,1.54423,-7.204688,0.6237,6.395916,5.772216,4.663852,4.472031,-0.191820999999999,19.91795,0.034167,-19.883783,0,0,0,,,
2011-07-01,17156.364684,5278.008403,-11878.356281,30174.658165,21405.88617,-8768.771995,185822,125104,-60718,13636.469992,0,-13636.469992,12414.606378,7564.515006,-4850.091372,32503.167002,23576.267621,-8926.899381,10942.791528,11355.431168,412.639640000003,14613.31301,14678.345496,65.0324860000037,46537.648618,38295.617417,-8242.031201,36780.472099,25896.520603,-10883.951496,8604.027296,2765.880501,-5838.146795,62807.677486,30086.978041,-32720.699445,187230.228969,120262.112698,-66968.1162710001,79483.231734,35732.613543,-43750.618191,2488.708028,2703.856206,215.148178,1210.948145,2891.316961,1680.368816,7221.027192,1895.8043,-5325.222892,0.588067,1.818177,1.23011,25446.380384,22250.223071,-3196.157313,0,0,0,21091.268234,16045.394346,-5045.873888,406.198343,529.021576,122.823233,11.257671,33.700836,22.443165,250.030989,296.111732,46.080743,400.708106,558.853115,158.145009,226.894467,83.787945,-143.106522,864.547364,604.202537,-260.344827,36.909445,766.289113,729.379668,0.88681,39.450709,38.563899,22.448623,342.629089,320.180466,0,36.777916,36.777916,56.581383,167.836756,111.255373,0.595796,17.720983,17.125187,1.055595,49.710372,48.654777,68.206647,85.178284,16.971637,340.328759,631.879301,291.550542,0.633174,2.374317,1.741143,0.060897,11.026928,10.966031,4.065863,7.526575,3.460712,0.233328,9.591174,9.357846,0.028588,0.504976,0.476388,0.485113,6.949076,6.463963,1.69138,12.168898,10.477518,0.241438,9.385149,9.143711,0.734023,9.594273,8.86025,4.353429,33.491137,29.137708,694.526535,254.643985,-439.88255,0,0,0,1.637565,32.979198,31.341633,105.057162,90.820473,-14.236689,311.261993,31.797987,-279.464006,0.081761,31.199624,31.117863,0.038793,41.358006,41.319213,1772.970523,1124.285298,-648.685224999999,3656.198158,1042.838409,-2613.359749,32.616409,31.354182,-1.26222699999999,27.691049,49.874669,22.18362,1.414123,1.00433,-0.409793,709.262979,426.364454,-282.898525,455.688084,683.335487,227.647403,101.441893,48.955367,-52.486526,841.769643,1465.12771,623.358067,2921.522336,3714.035833,792.513497000002,3.784705,210.676373,206.891668,23.195256,111.477586,88.28233,252.29691,940.240668,687.943758,1.679902,0.21309,-1.466812,18.74016,76.613452,57.873292,1047.497244,359.241666,-688.255578,0,1.253384,1.253384,561.488435,237.816992,-323.671443,328.358624,326.359833,-1.99879099999993,6.755597,0.306125,-6.449472,568.910548,170.909808,-398.00074,4289.534363,4596.090056,306.555693000001,3061.387354,538.147392,-2523.239962,1626.870953,3425.530537,1798.659584,1502.608453,2540.010912,1037.402459,43.665348,70.52434,26.858992,0.01829,0.554165,0.535875,1.900523,0.934809,-0.965714,3258.273814,2060.943858,-1197.329956,7953.954102,3641.443259,-4312.510843,857.887297,162.692921,-695.194376,,,,273.867494,128.973864,-144.89363,142.141002,33.042378,-109.098624,224.691342,124.797519,-99.893823,22.202711,1.471745,-20.730966,2004.317383,1780.374294,-223.943089,83.048631,20.700491,-62.34814,12.421732,41.294269,28.872537,17.661567,47.798218,30.136651,361.352778,289.477594,-71.875184,,,,3034.61012,655.837281,-2378.772839,34.788751,6.776036,-28.012715,117.962491,169.757236,51.794745,5.684581,6.511271,0.826689999999998,247.236157,22.711761,-224.524396,9.313246,49.397364,40.084118,39.167617,57.527877,18.36026,0.010409,4.467962,4.457553,2.687557,5.221159,2.533602,0.025088,1.337591,1.312503,3.793574,5.708185,1.914611,21.689456,6.477985,-15.211471,983.897025,1021.966278,38.0692530000002,217.42923,123.034574,-94.394656,0.008822,294.821367,294.812545,19.539843,115.390748,95.850905,0.722638,0.32941,-0.393228,0.009431,0.619556,0.610125,3017.593433,1222.414864,-1795.178569,,,,39.385233,54.948283,15.56305,48.362455,65.788152,17.425697,4.426724,1.31828,-3.108444,6.456634,2.9645,-3.492134,,,,8.692011,8.610544,-0.081467,0.026008,0.831307,0.805299,0.358735,1.242483,0.883748,1.355182,3.760293,2.405111,74.817327,169.19984,94.382513,128.055386,85.368214,-42.687172,28.953479,17.984113,-10.969366,411.98037,1030.131736,618.151366,1.877341,6.760472,4.883131,1.811222,22.536414,20.725192,6.760766,196.723827,189.963061,1853.933473,211.323459,-1642.610014,0.066381,22.092368,22.025987,879.6,518.7,-360.9,0.207362,0.037322,-0.17004,0.232546,0.038063,-0.194483,105.179031,92.541938,-12.637093,732.880781,201.275928,-531.604853,,,,4194.6741,1076.544695,-3118.129405,98.684302,118.277256,19.592954,260.452536,1455.615644,1195.163108,28.872276,10.302889,-18.569387,406.439545,201.965532,-204.474013,46.016341,62.223801,16.20746,1.627072,239.953004,238.325932,3116.77078,1813.124422,-1303.646358,375.495827,117.961526,-257.534301,6.779632,2.61371,-4.165922,413.322715,67.948289,-345.374426,184.848027,18.837433,-166.010594,0,1.629256,1.629256,2247.21393,907.903596,-1339.310334,1619.471205,312.481659,-1306.989546,6.245599,1.771045,-4.474554,230.900984,18.866916,-212.034068,2210.764394,1148.515247,-1062.249147,1658.181327,2827.021272,1168.839945,1660.771248,618.643895,-1042.127353,0,0.988111,0.988111,0.284761,14.698404,14.413643,787.852941,621.337632,-166.515309,8.837732,21.759002,12.92127,0.037137,0.179986,0.142849,0.121209,2.230135,2.108926,35152.243254,8157.901187,-26994.342067,0.452334,24.723245,24.270911,0,0,0,5138.317999,3675.095851,-1463.222148,354.913456,2665.381816,2310.46836,3791.378746,2187.932229,-1603.446517,10858.638558,5315.554905,-5543.083653,843.290796,2510.492762,1667.201966,0.027765,0.043221,0.015456,0.163827,0.022716,-0.141111,0.113159,0.55373,0.440571,0.000021,0,-0.000021,6.565293,16.540618,9.975325,335.636981,306.103221,-29.5337600000001,0.09977,0.3696,0.26983,1.111981,0.359879,-0.752102,0.000466,0.028357,0.027891,0.317486,1.577429,1.259943,0.039544,0.405424,0.36588,0.151114,0.678568,0.527454,0.000164,0,-0.000164,0.051363,0.17653,0.125167,0.001116,0.047096,0.04598,6.51366,23.206565,16.692905,0,0.024299,0.024299,3.0326,11.892146,8.859546,2.410346,9.447491,7.037145,0.068968,2.595471,2.526503,0.001265,1.100678,1.099413,0.004874,0.066987,0.062113,11.211205,4.436068,-6.775137,0.132722,1.110953,0.978231,73.850021,209.479139,135.629118,1143.918883,100.565856,-1043.353027,22.59842,30.868726,8.27030599999999,0.088753,49.672488,49.583735,141.077015,526.811622,385.734607,1.326263,1.432094,0.105831,0,0,0,0.017569,0.007665,-0.00990400000000001,70.49667,13.325602,-57.171068,0.042017,14.895442,14.853425,44.826457,13.599889,-31.226568,0.613495,21.462947,20.849452,0.264888,11.494615,11.229727,5.894924,11.105123,5.210199,0.866638,4.292168,3.42553,149.835141,12.101907,-137.733234,25.520837,93.746187,68.22535,0.006112,3.967588,3.961476,37.406025,2.568578,-34.837447,1.162954,13.748213,12.585259,3255.267661,379.100468,-2876.167193,0.251555,0.251261,-0.000293999999999905,535.024397,14.412573,-520.611824,320.246514,1.614307,-318.632207,0.024534,0,-0.024534,0.076171,2.83308,2.756909,0.012985,41.271425,41.25844,1251.025372,242.336802,-1008.68857,365.911758,20.668117,-345.243641,0.030605,0.230076,0.199471,0.189988,0.697376,0.507388,0,3.304537,3.304537,24.774423,18.950358,-5.82406499999999,4.999724,13.853662,8.853938,0.127185,1.02246,0.895275,1.207915,2.256401,1.048486,0.000012,0.089847,0.089835,7.523921,4.287529,-3.236392,0.024921,0.135276,0.110355,0.329713,5.64779,5.318077,4.383194,10.977999,6.594805,30.913237,39.503528,8.590291,0.193876,1.395391,1.201515,1.017871,0.005035,-1.012836,2.127876,34.799346,32.67147,23.81086,2.34693,-21.46393,5.544248,42.98506,37.440812,8.26975,7.933569,-0.336181,0.005204,0.242699,0.237495,0,0.315018,0.315018,0.49573,0.483064,-0.0126660000000001,0.000003,0.007054,0.007051,872.801743,603.041329,-269.760414,54.497935,17.295409,-37.202526,31.626717,1.296439,-30.330278,1.555739,8.182404,6.626665,7.313532,1.076284,-6.237248,11.573051,5.528158,-6.044893,5.659969,7.262079,1.60211,42.328578,0.343964,-41.984614,0,0,0,,,
2011-08-01,18514.740041,5254.439409,-13260.300632,31368.808409,22366.113863,-9002.69454599999,185727,125120,-60607,14076.370339,0,-14076.370339,13917.590379,8493.861221,-5423.729158,33014.910441,23864.439389,-9150.47105200001,10364.893033,11407.149842,1042.256809,15512.598097,14765.018518,-747.579578999992,50300.459223,42746.786737,-7553.67248599999,37605.367624,27716.481709,-9888.885915,8458.511068,2820.870893,-5637.640175,65622.381981,30302.71417,-35319.667811,196337.836729,126731.947733,-69605.888996,83162.547402,35934.827653,-47227.719749,2593.828546,2538.628122,-55.2004240000001,1297.811187,2747.281836,1449.470649,7089.905284,1694.782555,-5395.122729,0.542128,0.433874,-0.108254,27147.93853,24982.565077,-2165.373453,0,0,0,23152.520693,17764.22166,-5388.299033,415.105581,576.065654,160.960073,19.004954,38.284858,19.279904,201.848353,282.869334,81.020981,441.718245,547.296946,105.578701,262.170154,76.069388,-186.100766,901.523556,485.710672,-415.812884,41.944991,867.811832,825.866841,1.466423,51.528289,50.061866,66.595129,291.257161,224.662032,0,33.15505,33.15505,51.305313,151.437738,100.132425,0.83604,13.964933,13.128893,1.550347,51.468495,49.918148,70.988811,90.283885,19.295074,371.462657,570.616128,199.153471,0.833764,1.666624,0.83286,1.195574,10.032345,8.836771,4.061545,8.45087,4.389325,0.273864,8.510897,8.237033,0.008444,0.365935,0.357491,0.139148,5.218815,5.079667,1.521214,14.402661,12.881447,0.159686,8.844422,8.684736,0.399751,10.739659,10.339908,4.609195,32.191515,27.58232,782.026536,176.406266,-605.62027,0,0,0,3.727501,31.472013,27.744512,77.593966,78.392139,0.798172999999991,362.103513,70.845694,-291.257819,0.130578,19.167421,19.036843,0.13397,23.668087,23.534117,2030.157626,1250.35576,-779.801866,4090.927652,1089.159702,-3001.76795,39.911911,31.439955,-8.471956,22.919811,37.819921,14.90011,0,3.469755,3.469755,1092.414269,503.372505,-589.041764,689.67346,719.327549,29.654089,53.239528,58.5926,5.35307199999999,516.723642,1251.152328,734.428686,2348.63085,3967.105826,1618.474976,14.238964,177.157316,162.918352,19.16554,113.96788,94.80234,508.155833,933.867222,425.711389,0.000208,0.034473,0.034265,13.772944,33.981173,20.208229,810.739142,382.169274,-428.569868,0.001019,0.037735,0.036716,565.37027,298.628119,-266.742151,340.850765,257.635851,-83.2149140000001,5.950444,0.478672,-5.471772,709.274918,197.475936,-511.798982,4400.37519,4606.645326,206.270136,3423.548887,580.908214,-2842.640673,1772.68302,3625.480741,1852.797721,1214.810099,2466.707236,1251.897137,34.353307,79.136372,44.783065,0.006613,0.393586,0.386973,2.775169,3.605019,0.829849999999999,3157.229218,2309.421533,-847.807685,8843.610117,4263.710872,-4579.899245,912.043324,184.811056,-727.232268,,,,303.829936,147.367543,-156.462393,100.733539,36.274466,-64.459073,236.305224,117.780858,-118.524366,20.855133,1.330389,-19.524744,1913.800404,2447.106212,533.305808000001,58.75054,25.187215,-33.563325,24.941382,43.960379,19.018997,127.098543,106.112509,-20.986034,365.630971,235.715567,-129.915404,,,,2860.465605,743.60362,-2116.861985,56.119757,8.054552,-48.065205,126.428772,189.455112,63.02634,10.482523,10.987805,0.505281999999999,0.401651,18.969,18.567349,10.826812,64.639718,53.812906,128.504227,94.434237,-34.06999,0.241183,5.465958,5.224775,1.766179,2.305974,0.539795,0.01119,4.344503,4.333313,2.881452,9.464787,6.583335,1.277234,5.845935,4.568701,953.807563,1003.282811,49.4752480000003,249.121429,84.05112,-165.070309,0.014506,139.825596,139.81109,20.595504,102.964379,82.368875,0.461874,0.087375,-0.374499,0.002484,0.037263,0.034779,3028.803461,1208.059246,-1820.744215,,,,29.105662,81.063452,51.95779,45.415094,70.072775,24.657681,5.122292,4.471564,-0.650728,1.97259,1.24188,-0.73071,,,,6.647507,10.080746,3.433239,0.000171,1.856392,1.856221,0.705855,1.603466,0.897611,2.994522,3.002618,0.0080960000000001,66.94311,98.697044,31.753934,131.04096,106.474039,-24.566921,33.627338,18.628368,-14.99897,467.593171,1163.965388,696.372217,2.645828,7.383133,4.737305,49.286063,77.956551,28.670488,6.388017,171.285182,164.897165,2281.610933,140.179692,-2141.431241,0.0456,37.026147,36.980547,644.4,563.8,-80.6,0.240471,0,-0.240471,0.314952,0.105925,-0.209027,115.848054,92.793968,-23.054086,583.406346,180.763989,-402.642357,,,,4244.338199,1032.949716,-3211.388483,135.659512,165.021576,29.362064,276.425065,1418.760604,1142.335539,118.812448,14.769998,-104.04245,240.551552,112.311943,-128.239609,71.228081,109.126621,37.89854,2.868773,240.205755,237.336982,3362.045879,1848.098292,-1513.947587,383.918403,107.198778,-276.719625,7.012124,1.952692,-5.059432,505.000001,54.634926,-450.365075,187.663288,19.475268,-168.18802,0,2.409782,2.409782,2380.702345,983.327618,-1397.374727,1776.695978,318.761407,-1457.934571,8.449962,1.673045,-6.776917,268.42225,16.740405,-251.681845,2218.992894,1060.954765,-1158.038129,1885.071816,2883.154215,998.082399,1687.626873,619.019424,-1068.607449,0,0.977053,0.977053,0.41381,8.351406,7.937596,850.980862,634.159589,-216.821273,9.821846,27.85999,18.038144,0.005145,0.408393,0.403248,0.122559,3.218266,3.095707,37374.136523,8421.642066,-28952.494457,0.204121,32.476342,32.272221,0,0.343439,0.343439,4536.183038,3798.855214,-737.327824,295.6125,2661.11949,2365.50699,3648.025679,2064.020923,-1584.004756,11828.941834,5413.674846,-6415.266988,1027.218197,2411.859138,1384.640941,0.058687,0.02974,-0.028947,0.08443,0.007185,-0.077245,0.02398,0.015828,-0.00815200000000001,0.000057,0,-0.000057,14.245918,7.67513,-6.570788,245.110191,290.367974,45.257783,0.00573,0.172719,0.166989,0.325545,0.093429,-0.232116,0.010568,0.010848,0.000280000000000001,0.102459,1.524113,1.421654,0.053013,0.422937,0.369924,0.268868,0.503355,0.234487,0.000082,0,-0.000082,0.057335,0.376284,0.318949,0.0034,0.019653,0.016253,0.492633,3.290056,2.797423,0,0.10094,0.10094,2.687062,10.470619,7.783557,0.43311,10.581662,10.148552,0.081818,3.816918,3.7351,0,1.403438,1.403438,0.018345,0.041876,0.023531,6.424657,2.830178,-3.594479,0.107236,1.594012,1.486776,68.087189,250.898076,182.810887,1119.126082,181.208961,-937.917121,42.331852,51.541097,9.209245,36.760307,67.962604,31.202297,135.429884,493.425149,357.995265,0,0,0,0,0.241985,0.241985,0.000082,0,-0.000082,33.147813,23.619492,-9.52832099999999,0.026705,9.72169,9.694985,50.454204,20.609618,-29.844586,0.95482,34.519456,33.564636,0.240593,3.586267,3.345674,9.101746,25.253117,16.151371,0.897931,14.423834,13.525903,207.022205,28.640464,-178.381741,52.40301,84.757193,32.354183,0.009499,1.661607,1.652108,0.588857,0.753135,0.164278,0.047065,29.365452,29.318387,3374.501511,388.478442,-2986.023069,0.535529,1.456237,0.920708,330.175282,14.13147,-316.043812,320.673534,0.846231,-319.827303,0.085123,0,-0.085123,1.332563,1.958891,0.626328,0.014629,79.972503,79.957874,1313.889898,116.389463,-1197.500435,320.360426,14.978135,-305.382291,0.160901,0.053723,-0.107178,0.276813,0.806083,0.52927,0.107993,0.234685,0.126692,1.350841,10.380636,9.029795,0.269275,14.666135,14.39686,0.000693,2.8656,2.864907,2.138554,51.917147,49.778593,0.074261,3.656056,3.581795,5.36649,7.787468,2.420978,0.00316,1.265538,1.262378,0.777635,7.691713,6.914078,6.073394,8.794917,2.721523,42.64864,41.575173,-1.073467,0.486077,1.88271,1.396633,0.757589,0.005116,-0.752473,3.857662,15.641445,11.783783,22.402861,3.644982,-18.757879,1.780089,33.080095,31.300006,7.080244,5.677795,-1.402449,0.005052,0.643662,0.63861,0.000006,0.015249,0.015243,0.392938,147.584943,147.192005,0,0.102556,0.102556,819.99131,548.180784,-271.810526,43.134982,11.450068,-31.684914,30.624331,2.88449,-27.739841,5.738868,8.649194,2.910326,12.970821,1.146573,-11.824248,15.078516,8.97622,-6.102296,5.493586,1.611852,-3.881734,33.184689,0.032392,-33.152297,0,0.246513,0.246513,,,
2011-09-01,16419.590275,5897.05416,-10522.536115,29528.954713,23188.014411,-6340.940302,185718,127409,-58309,14204.110673,0,-14204.110673,14138.494237,8087.691532,-6050.802705,32686.182958,24254.649373,-8431.533585,10282.188556,12790.48082,2508.292264,15301.056092,14403.756223,-897.299869000002,49538.202135,41054.642144,-8483.559991,36297.340935,28431.029895,-7866.31104,7357.202183,2649.100701,-4708.101482,63080.59221,31818.972496,-31261.619714,189566.839517,127032.073622,-62534.765895,79916.268111,37649.137258,-42267.130853,2569.516487,2336.341062,-233.175425,1156.035146,2833.547923,1677.512777,6027.877875,1777.030087,-4250.847788,0.734893,0.608088,-0.126805,27234.691852,23959.308348,-3275.38350400001,0.000022,0,-0.000022,22303.510283,17095.333796,-5208.176487,420.532849,486.641355,66.1085059999999,17.539562,20.921323,3.381761,237.23517,226.152898,-11.082272,367.172864,480.543777,113.370913,233.790922,71.75727,-162.033652,941.122371,494.498067,-446.624304,36.029436,753.204159,717.174723,1.277084,58.077682,56.800598,40.746507,179.243241,138.496734,0,22.032389,22.032389,73.40015,192.730163,119.330013,0.203651,14.779666,14.576015,1.290356,51.582686,50.29233,75.286622,93.736563,18.449941,369.662311,576.747695,207.085384,0.340835,2.444842,2.104007,0.244965,14.605247,14.360282,3.591713,8.611871,5.020158,0.510975,10.467257,9.956282,0.001982,0.460904,0.458922,0.080227,5.96227,5.882043,1.527227,12.323853,10.796626,0.149681,6.376276,6.226595,0.711103,4.645119,3.934016,3.057112,34.237053,31.179941,791.730765,192.560993,-599.169772,0,0,0,0.962919,32.715719,31.7528,72.577944,56.863716,-15.714228,430.664839,38.491913,-392.172926,0.126336,32.895776,32.76944,2.607826,23.006509,20.398683,2025.725023,1174.441205,-851.283818,3335.167214,1179.608042,-2155.559172,40.134473,30.980718,-9.153755,32.510036,31.002133,-1.50790299999998,1.208601,0.906603,-0.301998,890.556737,553.304483,-337.252254,639.301946,573.797313,-65.504633,86.810545,66.092097,-20.718448,822.082701,1342.789653,520.706952,2891.922172,4069.888942,1177.96677,11.396316,162.237268,150.840952,23.095322,138.224451,115.129129,376.968702,880.646122,503.67742,0,0.518941,0.518941,13.847071,79.347494,65.500423,733.054783,434.802873,-298.25191,0,0,0,684.010215,264.418278,-419.591937,439.678201,314.962974,-124.715227,8.99728,0.032115,-8.965165,525.068028,192.107272,-332.960756,4120.646633,5258.21718,1137.570547,3052.457487,658.184655,-2394.272832,2115.687996,3824.922859,1709.234863,1436.974216,2511.518457,1074.544241,23.649929,160.762064,137.112135,0.00027,0.415596,0.415326,2.470723,1.431664,-1.039059,3105.398799,2295.450894,-809.947905000001,8188.918254,4015.637387,-4173.280867,788.372588,172.885553,-615.487035,,,,290.595128,144.495511,-146.099617,126.04451,22.589934,-103.454576,266.371588,131.471969,-134.899619,17.330223,1.852648,-15.477575,2078.534819,2197.608571,119.073752,41.574281,16.430338,-25.143943,15.702008,36.602933,20.900925,59.587506,69.070422,9.482916,432.142845,275.98321,-156.159635,,,,2903.104832,776.82233,-2126.282502,8.616724,8.592873,-0.0238509999999987,145.499667,233.082876,87.583209,9.748762,10.235243,0.486481000000001,246.359959,63.707811,-182.652148,18.866822,39.591664,20.724842,151.903713,91.13141,-60.772303,0.056778,16.153485,16.096707,1.322941,2.71859,1.395649,0.000744,52.596985,52.596241,16.478709,4.225486,-12.253223,0.79477,9.21912,8.42435,833.787023,868.75019,34.9631669999997,161.635499,65.628097,-96.0074020000001,0.000844,195.367711,195.366867,23.342316,88.92824,65.585924,0.13215,0.410235,0.278085,0.125201,0.12682,0.00161899999999998,2460.741045,1353.450022,-1107.291023,,,,47.807531,15.067298,-32.740233,45.527601,75.994928,30.467327,4.133611,0.902873,-3.230738,1.740854,5.728937,3.988083,,,,8.905473,10.823488,1.918015,0,1.393229,1.393229,0.441724,0.949682,0.507958,2.352882,2.571389,0.218506999999999,56.323755,83.947715,27.62396,143.526948,81.576344,-61.950604,40.884209,23.049564,-17.834645,394.80093,1156.489583,761.688653,1.261537,10.592826,9.331289,65.127717,3.427852,-61.699865,6.943214,151.215947,144.272733,1354.456856,174.545538,-1179.911318,0.010174,17.191123,17.180949,728.7,545.7,-183,0.493348,0.002778,-0.49057,0.481292,0.012977,-0.468315,103.252285,125.30397,22.051685,713.338627,218.675514,-494.663113,,,,5148.354253,1185.2058,-3963.148453,34.545971,430.463877,395.917906,188.167166,1368.910753,1180.743587,122.481906,13.361728,-109.120178,192.925732,112.734082,-80.19165,32.097413,74.704665,42.607252,1.041388,284.920385,283.878997,3108.476595,1726.624356,-1381.852239,349.878451,116.640771,-233.23768,9.014088,1.967691,-7.046397,373.862174,49.738076,-324.124098,198.779365,39.682927,-159.096438,0,2.562916,2.562916,2237.969049,1079.529507,-1158.439542,1570.255893,395.871562,-1174.384331,4.777034,1.259059,-3.517975,260.560455,21.212302,-239.348153,2114.568157,1160.861452,-953.706705,1546.149039,2807.456014,1261.306975,1556.55925,568.541286,-988.017964,0,2.197066,2.197066,0.942665,12.045897,11.103232,709.119261,638.783442,-70.335819,10.576739,22.674737,12.097998,0,0.635136,0.635136,0.222875,2.261894,2.039019,36418.64286,8370.063556,-28048.579304,0.60868,25.006603,24.397923,0,1.69186,1.69186,4920.763182,3427.401767,-1493.361415,382.963312,4580.553378,4197.590066,3432.313023,1975.069661,-1457.243362,10858.271037,5458.752289,-5399.518748,909.597046,2348.566145,1438.969099,0.083199,0.029795,-0.053404,0,0.006918,0.006918,0.011325,0.036981,0.025656,0.000048,0.444238,0.44419,18.622446,82.093524,63.471078,201.504193,366.109348,164.605155,0.007521,1.354691,1.34717,1.603515,0.220216,-1.383299,0.002613,0.043883,0.04127,0.217991,2.61973,2.401739,0.054661,1.20234,1.147679,0.053622,0.146302,0.09268,0.000007,0,-0.000007,0.05082,0.336263,0.285443,0.008084,0.116597,0.108513,6.176561,6.832786,0.656224999999998,0,0.004952,0.004952,8.429801,11.102361,2.67256,0.626242,2.398253,1.772011,0.093934,3.468498,3.374564,0.0049,1.118696,1.113796,0.105545,0.133426,0.027881,8.679287,3.433679,-5.245608,0.106523,2.210074,2.103551,107.137337,289.754965,182.617628,994.192295,206.400742,-787.791553,22.982342,32.196306,9.213964,0.072254,12.754016,12.681762,190.189789,334.434101,144.244312,0,0,0,0,0.406257,0.406257,0,0,0,137.342024,23.269611,-114.072413,0.083584,12.143842,12.060258,9.114299,26.338452,17.224153,0.654737,24.300099,23.645362,0.219237,5.649859,5.430622,7.680709,30.731754,23.051045,0.924916,9.396439,8.471523,39.983772,12.448663,-27.535109,27.758871,79.126275,51.367404,0.00006,1.810028,1.809968,0.138003,3.15744,3.019437,1.137689,5.835343,4.697654,2335.962672,472.104298,-1863.858374,0.114573,0.374307,0.259734,398.550689,32.810594,-365.740095,320.479776,4.871007,-315.608769,0.044549,0.006527,-0.038022,0.589032,2.43717,1.848138,0.022448,42.720268,42.69782,1410.69073,82.586866,-1328.103864,188.860593,18.811801,-170.048792,0.000014,5.890944,5.89093,0.113994,1.684858,1.570864,0.013003,0.049318,0.036315,23.739749,14.955449,-8.7843,97.395578,15.625329,-81.770249,0.002159,4.586335,4.584176,2.897797,0.753538,-2.144259,0.213481,0.579974,0.366493,16.384069,13.147411,-3.236658,0.0002,0.13643,0.13623,0.359716,9.371846,9.01213,4.087608,7.883483,3.795875,47.401187,33.51441,-13.886777,0.44723,0.793267,0.346037,0.628197,0.022543,-0.605654,3.872551,26.694194,22.821643,26.294499,2.629601,-23.664898,4.198249,58.069172,53.870923,5.731654,6.506617,0.774963000000001,0,0.707674,0.707674,0.142732,0.072685,-0.070047,0,0.572416,0.572416,0.002219,0.084257,0.082038,763.568115,595.352929,-168.215186,68.24671,15.132496,-53.114214,13.377362,4.589584,-8.787778,2.997626,7.998269,5.000643,6.610661,2.102014,-4.508647,0.962309,3.576264,2.613955,3.14751,7.549908,4.402398,59.751814,0,-59.751814,0,10.25139,10.25139,,,
2011-10-01,14422.884074,6334.593341,-8088.290733,31525.195659,23353.849123,-8171.346536,186685,127268,-59417,14040.938442,0,-14040.938442,13986.557906,8360.204071,-5626.353835,36105.498217,25712.081103,-10393.417114,10385.898933,11340.21286,954.313926999997,14470.813837,15261.116492,790.302654999996,49534.954434,42211.984853,-7322.969581,38535.493808,28475.450822,-10060.042986,6642.884247,2581.959239,-4060.925008,66377.244591,33099.002761,-33278.24183,191809.563154,131099.391557,-60710.171597,81549.07339,39087.995457,-42461.077933,2486.685613,2501.093561,14.407948,1075.339545,3421.06054,2345.720995,5559.581318,1843.938003,-3715.643315,1.003893,0.612973,-0.39092,26681.278004,24578.940925,-2102.337079,0,0,0,22853.67643,17633.043928,-5220.632502,401.565402,394.493494,-7.07190800000001,11.284988,25.301751,14.016763,196.646782,273.130005,76.483223,363.456909,533.360567,169.903658,254.557141,105.018863,-149.538278,915.241574,563.958232,-351.283342,33.678573,827.411079,793.732506,1.533846,49.289156,47.75531,39.849747,361.308412,321.458665,0,30.980708,30.980708,29.141698,184.641839,155.500141,0.936058,17.215327,16.279269,1.014025,47.207816,46.193791,65.8233,91.372358,25.549058,355.217805,631.1324,275.914595,0.416956,3.790769,3.373813,0.2909,10.609592,10.318692,4.402286,13.51992,9.117634,0.437892,20.5379,20.100008,0.000551,0.767524,0.766973,0.058017,7.921079,7.863062,1.612498,56.609796,54.997298,0.130581,10.155167,10.024586,0.768092,6.960633,6.192541,4.039084,41.549897,37.510813,756.469141,212.926362,-543.542779,0,0,0,3.354253,59.428027,56.073774,81.798995,85.955508,4.15651299999996,216.419501,81.634695,-134.784806,0.007754,49.177087,49.169333,0.147168,20.421144,20.273976,2281.040315,1182.598672,-1098.441643,3395.574644,1243.773251,-2151.801393,49.857101,35.490713,-14.366388,20.671432,46.454469,25.783037,0.000256,2.60363,2.603374,778.362036,554.339489,-224.022547,528.873965,755.958615,227.08465,71.281684,55.524193,-15.757491,579.399211,1476.452725,897.053514,2583.527845,3941.519479,1357.991634,20.298597,141.072302,120.773705,26.570315,139.368867,112.798552,394.791573,868.134179,473.342606,0.263346,0.038801,-0.224545,20.077831,42.107475,22.029644,908.57798,490.744248,-417.833732,0,0,0,926.507906,326.572411,-599.935495,331.219856,295.600843,-35.6190130000001,9.214482,0.742134,-8.472348,502.425894,196.597412,-305.828482,4429.150584,4507.520943,78.3703590000005,3395.489133,518.982433,-2876.5067,1515.147514,3651.661842,2136.514328,1461.390142,2678.490423,1217.100281,34.271522,417.320591,383.049069,0.255617,0.04865,-0.206967,2.477759,0.86688,-1.610879,3899.351596,2364.334993,-1535.016603,8704.792159,4505.428673,-4199.363486,876.558434,381.518098,-495.040336,,,,290.788139,131.193122,-159.595017,126.457825,20.32131,-106.136515,248.678795,135.218698,-113.460097,22.85655,1.485871,-21.370679,2061.844944,2037.80454,-24.0404039999992,34.16995,22.208738,-11.961212,27.399968,68.339389,40.939421,80.156619,72.845413,-7.31120600000001,353.665073,301.410387,-52.254686,,,,2983.918382,778.018639,-2205.899743,43.275973,6.872138,-36.403835,87.686076,175.714151,88.028075,2.819708,7.521714,4.702006,126.040791,14.519544,-111.521247,14.491238,38.637416,24.146178,158.832275,55.392971,-103.439304,0.183527,5.229536,5.046009,1.458188,4.31002,2.851832,0.100126,36.717853,36.617727,5.409279,10.83618,5.426901,0.341968,9.872579,9.530611,861.549481,936.593077,75.0435959999998,265.385707,113.12711,-152.258597,0.016091,466.285479,466.269388,19.156661,77.842742,58.686081,0.162487,0.111983,-0.050504,0.003059,0.372556,0.369497,2857.135105,1321.613836,-1535.521269,,,,43.329929,45.291202,1.96127299999999,42.902701,27.766236,-15.136465,2.978403,2.884173,-0.09423,2.429059,5.529606,3.100547,,,,8.067122,19.217701,11.150579,0,1.572975,1.572975,0.401284,1.421465,1.020181,2.190401,4.048137,1.857736,73.950278,48.707217,-25.243061,149.789019,45.922686,-103.866333,34.953625,13.781438,-21.172187,482.927694,1021.59572,538.668026,0.681899,8.757225,8.075326,2.322305,3.76391,1.441605,5.483678,154.854728,149.37105,1411.6723,175.940523,-1235.731777,0.12235,16.141432,16.019082,709.4,557,-152.4,0.262539,0,-0.262539,0.311179,0.726259,0.41508,101.706692,102.256594,0.549902000000003,817.196503,289.875576,-527.320927,,,,3303.972467,1353.369978,-1950.602489,141.038306,536.30959,395.271284,155.733373,1552.481498,1396.748125,70.395575,28.450512,-41.945063,210.806595,127.412488,-83.394107,35.66682,97.864225,62.197405,1.641458,394.648122,393.006664,3289.297964,1720.169369,-1569.128595,285.598764,110.265509,-175.333255,7.650744,1.490815,-6.159929,376.725156,200.727803,-175.997353,185.883093,19.210926,-166.672167,0,17.074811,17.074811,2248.00665,1038.832835,-1209.173815,1604.026412,381.265733,-1222.760679,3.39456,1.910335,-1.484225,280.496775,14.491631,-266.005144,2289.380418,1135.190741,-1154.189677,1594.15716,2501.928088,907.770928,1626.621186,643.722812,-982.898374,0,0.752556,0.752556,5.870074,10.565153,4.695079,797.454646,683.675149,-113.779497,9.09472,21.78005,12.68533,0,0.366717,0.366717,0.429214,3.268249,2.839035,37824.071703,9745.556144,-28078.515559,0.206053,25.962316,25.756263,0,2.451243,2.451243,4762.130251,3467.032763,-1295.097488,476.240351,3493.116239,3016.875888,3553.371171,1878.13577,-1675.235401,12387.552278,6141.966579,-6245.585699,833.378586,3009.966737,2176.588151,0.081617,0.014814,-0.066803,0.289107,0.002789,-0.286318,0.008049,0.0078,-0.000249000000000003,0.000092,0.015849,0.015757,15.526489,54.61377,39.087281,202.395558,311.752766,109.357208,0.052618,0.348613,0.295995,0.461068,0.15818,-0.302888,0.004278,0.0043,0.0000219999999999995,0.212946,1.967276,1.75433,0.084198,0.248016,0.163818,0.154046,0.468081,0.314035,0.003198,0.003403,0.000205,0.055913,0.101019,0.045106,0.003775,0.017859,0.014084,5.698723,12.623408,6.924685,0,0.004945,0.004945,3.385478,11.600273,8.214795,1.424228,4.578903,3.154675,0.083323,3.469755,3.386432,0.010093,1.934344,1.924251,0.004948,0.038213,0.033265,11.795661,5.110844,-6.684817,0.232499,1.968864,1.736365,64.195927,181.183015,116.987088,786.677201,81.454058,-705.223143,24.363468,54.339369,29.975901,0.585004,23.664434,23.07943,199.852766,414.687551,214.834785,0,0,0,0.00015,0.664742,0.664592,0,0,0,23.005372,15.059882,-7.94549,0.161773,69.432154,69.270381,17.476668,19.825727,2.349059,0.725958,28.423819,27.697861,0.622388,7.579261,6.956873,5.083023,11.12655,6.043527,0.377261,14.456193,14.078932,111.742183,17.511182,-94.231001,95.700298,88.698126,-7.00217199999999,0.000432,1.663869,1.663437,34.348698,7.670232,-26.678466,0.467026,8.910166,8.44314,2330.166957,362.756286,-1967.410671,0.611545,1.983587,1.372042,271.294677,15.314382,-255.980295,257.757275,1.852131,-255.905144,0.011447,0.1452,0.133753,0.527354,2.816582,2.289228,1.629274,58.867396,57.238122,1295.144,163.052828,-1132.091172,49.522196,14.145498,-35.376698,0.000055,0.39403,0.393975,0.258344,0.976119,0.717775,0.000908,0.903945,0.903037,1.205158,11.063176,9.858018,1.422576,25.186606,23.76403,0.57313,4.484668,3.911538,3.80369,49.033496,45.229806,0.022946,0.404781,0.381835,3.40265,26.053725,22.651075,0.00004,0.10735,0.10731,0.39493,9.259854,8.864924,4.163925,5.327073,1.163148,37.444712,28.803624,-8.64108800000001,0.49532,1.254579,0.759259,0.414853,0.026763,-0.38809,1.531378,19.077835,17.546457,24.575476,4.526426,-20.04905,2.889095,38.689144,35.800049,7.750079,3.980754,-3.769325,0,7.050832,7.050832,0.178025,0.050947,-0.127078,0.563014,0.778045,0.215031,0,0.143814,0.143814,856.983406,618.724833,-238.258573,18.047152,16.612774,-1.434378,19.083115,12.149044,-6.93407099999999,8.896553,14.526213,5.62966,4.970119,1.705555,-3.264564,1.05988,4.521624,3.461744,8.959343,6.907987,-2.051356,44.101851,0.03759,-44.064261,0,59.211181,59.211181,,,
2011-11-01,14734.497024,5536.244248,-9198.252776,31741.910542,22003.896572,-9738.01397,187195,125713,-61482,14438.053173,0,-14438.053173,14170.684367,7569.96881,-6600.715557,35625.012863,24823.970034,-10801.042829,10022.564956,11646.721994,1624.157038,14369.995861,14569.870402,199.874541000005,49323.72104,40963.693653,-8360.02738700001,38880.326858,26783.411655,-12096.915203,7200.538674,2366.81854,-4833.720134,64689.587599,32380.214377,-32309.373222,190317.759608,125752.046666,-64565.7129420001,79350.548668,38090.344384,-41260.204284,2336.408733,2607.040288,270.631555,1191.850877,2953.521289,1761.670412,5973.574531,1623.178481,-4350.39605,0.777015,0.52559,-0.251425,26176.959619,23299.422929,-2877.53669,0.000615,0,-0.000615,23146.761421,17664.270724,-5482.49069699999,380.72075,598.845541,218.124791,12.399785,31.160028,18.760243,174.876982,302.695369,127.818387,366.499933,500.483169,133.983236,199.482647,77.641247,-121.8414,862.569164,578.656891,-283.912273,28.537946,782.869461,754.331515,1.944854,66.3309,64.386046,28.379482,290.44476,262.065278,0,31.74514,31.74514,61.084458,155.205334,94.120876,1.121713,21.01339,19.891677,2.317569,62.340308,60.022739,54.438951,86.937139,32.498188,352.259257,548.718071,196.458814,0.243578,3.189216,2.945638,1.084874,15.432038,14.347164,5.942483,11.040579,5.098096,0.870769,15.219503,14.348734,0.09264,0.585339,0.492699,0.046166,5.27954,5.233374,1.683422,16.088717,14.405295,0.168137,5.55343,5.385293,0.359972,7.707722,7.34775,4.022187,45.203674,41.181487,644.33988,170.104652,-474.235228,0,0,0,4.1545,96.72712,92.57262,68.543595,42.039882,-26.503713,300.817447,43.99427,-256.823177,0.122677,33.99202,33.869343,2.740759,26.001233,23.260474,2138.59684,1365.622506,-772.974334,2997.511284,1081.41749,-1916.093794,41.404988,29.948757,-11.456231,22.719731,35.635644,12.915913,0.000002,3.759926,3.759924,825.006689,601.711469,-223.29522,569.160563,789.428851,220.268288,55.442807,53.979467,-1.46334000000001,552.835833,1257.990677,705.154844,3094.982155,3578.233375,483.251219999999,16.273656,152.974608,136.700952,27.60933,108.329383,80.720053,464.715499,837.162555,372.447056,1.869907,0.430011,-1.439896,24.642513,31.618658,6.976145,959.80886,400.151631,-559.657229,0.000003,0.023136,0.023133,777.591476,221.717709,-555.873767,296.271694,274.32825,-21.9434440000001,7.129882,0.060638,-7.069244,601.72302,155.697646,-446.025374,4415.824082,4454.049078,38.2249959999999,3498.388383,566.942644,-2931.445739,1900.013817,3380.3332,1480.319383,1194.024151,2657.233543,1463.209392,35.69732,62.943416,27.246096,0.000608,0.297157,0.296549,2.851067,1.13327,-1.717797,3639.843137,2276.762726,-1363.080411,8864.103979,4223.909618,-4640.194361,772.864504,324.18982,-448.674684,,,,330.472232,147.045816,-183.426416,111.969798,22.451121,-89.518677,250.146857,106.547857,-143.599,18.975893,1.92274,-17.053153,2127.373303,2126.49684,-0.876462999999603,45.604181,21.915601,-23.68858,29.812172,57.464377,27.652205,96.724551,71.697653,-25.026898,328.620009,252.930112,-75.6898969999999,,,,3235.41197,717.53932,-2517.87265,36.595463,5.668674,-30.926789,95.659997,186.090653,90.4306559999999,9.441742,5.395901,-4.045841,238.85587,13.446844,-225.409026,1.881366,41.17674,39.295374,82.523253,67.765395,-14.757858,0.04113,11.68525,11.64412,1.385866,5.170728,3.784862,0.029894,51.989093,51.959199,2.496584,5.943411,3.446827,0.334566,4.34896,4.014394,887.063239,860.59769,-26.465549,175.327782,99.879942,-75.44784,0.006612,223.93212,223.925508,17.211205,36.218596,19.007391,0.259482,0.067191,-0.192291,0.032873,0.049817,0.016944,2995.155886,1292.40937,-1702.746516,,,,48.415015,18.872999,-29.542016,56.985552,104.508308,47.522756,2.965576,2.405478,-0.560098000000001,6.52175,1.506739,-5.015011,,,,9.284624,8.44607,-0.838554,0.00321,0.827241,0.824031,0.516904,1.75295,1.236046,1.790207,3.957322,2.167115,62.411033,85.063136,22.652103,141.975944,42.028783,-99.947161,32.847715,19.086812,-13.760903,405.397617,1018.206039,612.808422,1.019439,7.509826,6.490387,3.190606,1.679354,-1.511252,7.298189,159.577299,152.27911,981.730968,189.998875,-791.732093,0.070103,12.723931,12.653828,791.9,583.4,-208.5,0.220032,0.004644,-0.215388,0.323937,0,-0.323937,75.157382,111.14145,35.984068,629.395189,296.992232,-332.402957,,,,4335.580398,1314.240867,-3021.339531,112.904395,126.779772,13.875377,220.666189,1369.182722,1148.516533,0.010703,11.876043,11.86534,258.313664,119.767649,-138.546015,50.724105,113.324242,62.600137,2.507943,274.271334,271.763391,2722.460571,1949.983141,-772.47743,295.52185,202.208708,-93.313142,7.237507,3.269868,-3.967639,339.782404,190.942154,-148.84025,184.666687,39.724628,-144.942059,0,4.328331,4.328331,1796.650354,663.686806,-1132.963548,1484.710996,391.412283,-1093.298713,3.345597,1.611764,-1.733833,232.569897,16.330274,-216.239623,2174.25192,1084.87465,-1089.37727,1521.186949,2529.371427,1008.184478,1631.446416,526.352159,-1105.094257,0,1.948045,1.948045,0.466659,8.533208,8.066549,795.046412,615.284147,-179.762265,8.48377,30.459223,21.975453,0.040831,0.201471,0.16064,0.280236,3.188697,2.908461,36764.911636,9997.195589,-26767.716047,0.154338,25.335772,25.181434,0,0,0,4860.961031,3586.149631,-1274.8114,341.822781,3570.072488,3228.249707,3298.594195,1961.128448,-1337.465747,12123.560783,5563.587239,-6559.973544,913.216693,2437.508543,1524.29185,0.018286,0.007017,-0.011269,0.114538,0.060184,-0.054354,0.17701,0.053892,-0.123118,0.020838,0,-0.020838,15.973808,79.492551,63.518743,239.664546,390.205074,150.540528,0.240872,0.383856,0.142984,0.491305,0.274127,-0.217178,0.001759,0.00284,0.001081,0.49608,1.890779,1.394699,0.058908,1.147486,1.088578,0.04087,0.248731,0.207861,0.000008,0.000182,0.000174,0.084115,0.009296,-0.074819,0.008723,0.063022,0.054299,4.715864,14.032302,9.316438,0,0.052623,0.052623,8.375498,11.411017,3.035519,2.325837,1.698888,-0.626949,0.054109,4.132118,4.078009,0.003456,1.654056,1.6506,0.014037,0,-0.014037,5.682633,7.425315,1.742682,0.100649,1.883014,1.782365,71.230963,260.523883,189.29292,833.504109,65.013245,-768.490864,51.905887,54.595039,2.68915200000001,127.607371,39.395246,-88.212125,229.476603,339.941438,110.464835,0,0,0,0.001678,5.025956,5.024278,0,0,0,0.821859,21.917233,21.095374,0.063912,40.014434,39.950522,60.559307,18.358308,-42.200999,0.259374,13.133082,12.873708,0.12814,2.55903,2.43089,4.711654,36.608081,31.896427,16.014188,12.435184,-3.579004,32.219362,15.545191,-16.674171,70.786163,77.236325,6.45016199999998,0.002024,2.018313,2.016289,24.030943,1.674479,-22.356464,0.409416,8.176751,7.767335,2579.782668,376.83894,-2202.943728,0.26329,0.520261,0.256971,286.841414,25.988179,-260.853235,390.425297,7.502034,-382.923263,3.288539,0.02558,-3.262959,0.026391,4.545967,4.519576,0.024558,41.390284,41.365726,1181.056422,80.711442,-1100.34498,270.044073,27.741933,-242.30214,0.000175,0.101878,0.101703,0.166114,0.933993,0.767879,0.001955,0.053649,0.051694,30.78836,12.704686,-18.083674,1.726403,11.475343,9.74894,1.131731,1.212479,0.0807480000000003,9.146628,3.640677,-5.505951,0.012237,0.047128,0.034891,4.501099,6.762086,2.260987,0.005517,0.527816,0.522299,0.53475,6.580535,6.045785,5.889668,5.037746,-0.851922000000001,30.58687,48.239848,17.652978,0.383682,1.984701,1.601019,0.252422,0.854722,0.6023,3.04996,24.256454,21.206494,26.82164,2.601769,-24.219871,1.295973,28.157675,26.861702,6.425028,4.593659,-1.831369,0,0.503536,0.503536,0.538832,0.055008,-0.483824,0.016972,0.827106,0.810134,0.000038,0.862278,0.86224,845.858596,506.416839,-339.441757,7.567432,14.413123,6.845691,28.709561,4.568384,-24.141177,3.483998,7.045176,3.561178,6.207652,1.371211,-4.836441,0.547013,3.874443,3.32743,4.571678,4.568174,-0.0035040000000004,31.549063,5.269514,-26.279549,0,23.861153,23.861153,,,
2011-12-01,15722.981012,6506.410945,-9216.570067,32496.783256,22750.837411,-9745.94584499999,190853,126937,-63916,13503.645102,0,-13503.645102,14112.933303,7372.26312,-6740.670183,34022.605363,26227.281337,-7795.32402600001,9333.160902,11719.212099,2386.051197,14559.533582,14404.756188,-154.777394000002,47909.77328,39070.22939,-8839.54389,39221.402257,28711.058515,-10510.343742,6397.145395,2890.729082,-3506.416313,59667.981005,32278.610214,-27389.370791,184516.589231,126891.233011,-57625.3562199998,75150.365641,38829.198703,-36321.166938,2209.020081,2367.992637,158.972556,1278.062713,2946.151387,1668.088674,5062.309909,1965.357621,-3096.952288,0.287168,0.304176,0.017008,26558.093208,22717.91652,-3840.176688,0.019195,0,-0.019195,21351.680072,16352.31287,-4999.367202,347.549939,478.853146,131.303207,19.310002,33.47124,14.161238,180.401436,242.673162,62.2717260000001,310.097532,374.409069,64.3115370000001,159.756176,95.06799,-64.688186,857.889731,565.135301,-292.75443,26.052274,674.939004,648.88673,2.353822,31.262237,28.908415,45.919449,317.523343,271.603894,0,23.692929,23.692929,64.401999,172.236705,107.834706,0.443181,23.584525,23.141344,1.831944,56.898431,55.066487,51.438975,97.651419,46.212444,353.325267,611.853969,258.528702,0.322482,3.224421,2.901939,1.887403,15.030086,13.142683,4.774971,12.13667,7.361699,1.002888,25.375019,24.372131,0.01085,0.58155,0.5707,0.109679,5.405169,5.29549,0.870557,48.570169,47.699612,0.162369,7.064542,6.902173,0.288245,5.713639,5.425394,4.456106,40.736802,36.280696,703.660421,238.519622,-465.140799,0,0,0,5.669712,77.501852,71.83214,32.931325,71.281647,38.350322,108.058968,75.572582,-32.486386,0.167825,35.854289,35.686464,0.217162,23.438518,23.221356,2190.817936,1243.147546,-947.67039,3158.385715,1107.020553,-2051.365162,50.208691,29.547751,-20.66094,22.512272,42.616285,20.104013,1.319945,0.813676,-0.506269,590.232606,603.662199,13.4295929999998,620.847945,704.598123,83.750178,69.899665,71.599621,1.699956,752.868161,1541.131927,788.263766,3427.055536,3387.811308,-39.2442280000005,15.391998,153.684443,138.292445,28.797716,109.274567,80.476851,345.423805,924.347512,578.923707,0.408901,0.24163,-0.167271,24.609399,64.702257,40.092858,890.766068,460.397158,-430.36891,0,0.060389,0.060389,636.302553,291.377759,-344.924794,386.628084,237.003286,-149.624798,6.638044,0.237215,-6.400829,439.282323,193.698109,-245.584214,4740.573146,4909.533635,168.960489,3432.131012,770.547359,-2661.583653,2147.113644,3645.064734,1497.95109,1391.921462,2420.094548,1028.173086,32.229916,152.88282,120.652904,0.051421,0.091699,0.040278,2.261049,0.37849,-1.882559,3531.414006,2166.399157,-1365.014849,9061.476292,4065.832856,-4995.643436,786.827188,349.984665,-436.842523,,,,303.185276,154.208244,-148.977032,108.95948,28.592856,-80.366624,271.964367,126.525146,-145.439221,20.90107,42.34321,21.44214,2112.770409,2490.248219,377.47781,53.342995,20.710042,-32.632953,25.032558,69.917233,44.884675,79.30318,70.305459,-8.997721,501.585332,264.263429,-237.321903,,,,2876.108927,791.662036,-2084.446891,31.607222,14.041879,-17.565343,118.140491,223.761674,105.621183,5.635496,11.852473,6.216977,344.736448,16.09914,-328.637308,0.770874,41.374024,40.60315,70.575659,74.033384,3.457725,0.203132,7.402677,7.199545,1.497969,3.134622,1.636653,0.06647,0.953257,0.886787,1.115666,7.892795,6.777129,0.747663,3.620998,2.873335,880.850417,810.958146,-69.8922709999999,240.444829,88.829592,-151.615237,0.031652,349.339656,349.308004,17.532744,108.751038,91.218294,0.154288,0.116637,-0.037651,0.083,0.281947,0.198947,2903.091327,1331.873577,-1571.21775,,,,49.376497,50.1332,0.756703000000002,53.56882,97.006776,43.437956,3.628718,2.192806,-1.435912,4.922529,2.267801,-2.654728,,,,11.670687,12.386491,0.715803999999999,0,3.370866,3.370866,0.139775,1.437969,1.298194,2.439953,5.046018,2.606065,77.426201,130.605446,53.179245,108.557339,52.697506,-55.859833,30.526648,17.264856,-13.261792,397.43194,1448.379516,1050.947576,1.048602,6.889738,5.841136,1.908867,4.577741,2.668874,5.045353,132.820174,127.774821,1322.937356,142.545158,-1180.392198,0.03135,32.622643,32.591293,680.8,665.9,-14.9,0.287138,0,-0.287138,0.213725,0.003152,-0.210573,68.358162,152.736266,84.378104,1145.981072,290.991342,-854.98973,,,,5114.00033,1511.852418,-3602.147912,58.548154,243.021456,184.473302,266.662194,1821.251909,1554.589715,9.130724,18.02501,8.894286,214.778007,170.988102,-43.789905,44.932084,116.720897,71.788813,5.053481,255.538603,250.485122,2619.723034,1968.296947,-651.426087000001,244.863463,147.025069,-97.838394,6.449533,4.252102,-2.197431,291.968035,47.682019,-244.286016,153.217647,44.273412,-108.944235,0,2.311643,2.311643,1720.063549,761.950649,-958.1129,1422.161357,368.602144,-1053.559213,5.804167,1.565322,-4.238845,189.148684,17.003018,-172.145666,2077.153258,1097.827727,-979.325531,1389.180857,2723.697923,1334.517066,1373.593652,714.153338,-659.440314,0,0.088757,0.088757,4.180816,14.183844,10.003028,702.897394,644.393113,-58.5042809999999,9.316062,23.497978,14.181916,0,0.195004,0.195004,0.625273,16.917632,16.292359,32872.285127,9747.667135,-23124.617992,0.258195,19.513836,19.255641,0,3.141366,3.141366,4490.073345,3907.076853,-582.996491999999,344.245785,2810.245377,2465.999592,3109.660915,2278.191946,-831.468969,12044.449296,5416.629158,-6627.820138,991.722751,2651.190628,1659.467877,0,0.540726,0.540726,0.278515,0,-0.278515,0.007825,0.076885,0.06906,0,0.02,0.02,19.001631,9.750149,-9.251482,240.220116,240.105045,-0.115071000000029,0.058169,0.207957,0.149788,0.385915,1.065664,0.679749,0.002297,0.020539,0.018242,0.187258,2.308455,2.121197,0.084608,0.33464,0.250032,0.117358,0.737127,0.619769,0.000041,0,-0.000041,0.040037,0.24334,0.203303,0.000035,0.094451,0.094416,6.285755,12.474112,6.188357,0,0.073759,0.073759,4.738796,9.570723,4.831927,1.144624,3.128735,1.984111,0.05228,4.640972,4.588692,0.006964,2.257745,2.250781,0.002652,0.080678,0.078026,13.560497,5.11944,-8.441057,0.164443,1.991032,1.826589,70.075654,338.92722,268.851566,1034.438426,121.895009,-912.543417,25.787227,55.492379,29.705152,49.1508,38.803117,-10.347683,173.154664,370.388366,197.233702,0,0,0,0.015374,1.022965,1.007591,0,0,0,147.090165,27.470419,-119.619746,0.049955,58.564698,58.514743,12.826809,16.168306,3.341497,0.454828,28.333573,27.878745,1.087004,2.919679,1.832675,10.093226,35.426466,25.33324,0.651534,5.393409,4.741875,92.384603,12.861536,-79.523067,141.932944,127.868413,-14.064531,0.00028,3.535408,3.535128,69.122535,2.115272,-67.007263,0.579385,82.425451,81.846066,1930.853732,468.882441,-1461.971291,0.700742,0.759105,0.0583630000000001,166.723513,16.076334,-150.647179,216.195961,5.791563,-210.404398,0.161869,0.86871,0.706841,0.157629,2.746259,2.58863,0.124952,57.886923,57.761971,1070.172034,125.977176,-944.194858,188.303612,20.555012,-167.7486,0.000828,0.189088,0.18826,0.076669,0.608051,0.531382,0.033847,0.032563,-0.00128400000000001,2.980896,21.519383,18.538487,103.57865,21.407164,-82.171486,2.073981,1.435701,-0.63828,3.148864,0.624387,-2.524477,0.01691,0.320496,0.303586,3.658135,21.5817,17.923565,0.000528,0.073009,0.072481,0.513734,5.285346,4.771612,2.202863,5.831307,3.628444,28.333813,58.302337,29.968524,0.356255,0.560796,0.204541,0.013176,0.110125,0.096949,4.323984,27.422328,23.098344,20.418121,7.402568,-13.015553,7.684974,31.935183,24.250209,6.447765,3.45577,-2.991995,0,1.008811,1.008811,0.366751,0,-0.366751,0.446427,0.648434,0.202007,0.02,0.012734,-0.007266,719.034008,577.62959,-141.404418,49.224748,11.833161,-37.391587,15.175475,5.201671,-9.973804,2.130713,21.101209,18.970496,3.120555,1.239681,-1.880874,0.260933,2.615888,2.354955,7.64174,3.820623,-3.821117,26.206553,0.018573,-26.18798,0,38.80557,38.80557,,,
2012-01-01,15766.906329,5852.834901,-9914.071428,29591.823121,21096.977506,-8494.845615,191550.695566178,125887.953706342,-65662.7418598355,12536.648924,0,-12536.648924,14423.693343,6906.944481,-7516.748862,29359.219301,22563.007503,-6796.211798,9331.338907,9562.118746,230.779838999999,14270.538336,13706.755496,-563.78284,48290.835629,39089.721744,-9201.11388499999,35584.927064,26278.62466,-9306.30240399998,6331.812158,2269.280056,-4062.532102,60908.534413,28344.287326,-32564.247087,183533.24906,117838.62866,-65694.6204,78019.425196,33672.055524,-44347.369672,2189.474607,2437.894728,248.420121,1035.442274,2821.769835,1786.327561,5084.547126,1504.711309,-3579.835817,0.268403,0.414791,0.146388,26786.98551,22078.483818,-4708.501692,0,0.006554,0.006554,21503.850119,17011.237926,-4492.612193,376.323569,491.231523,114.907954,13.922079,34.28551,20.363431,196.402966,278.132903,81.729937,266.655009,469.3576,202.702591,200.465989,79.955703,-120.510286,882.042869,654.164708,-227.878161,28.41265,708.69554,680.28289,0.8361,29.121805,28.285705,29.862408,204.202615,174.340207,0,53.142653,53.142653,33.942257,200.044444,166.102187,0.761363,16.989067,16.227704,0.826176,54.116378,53.290202,34.378523,67.110178,32.731655,267.584205,465.052291,197.468086,0.280854,2.458063,2.177209,0.464445,11.265063,10.800618,4.243155,7.012983,2.769828,1.402097,13.6812,12.279103,0.201582,0.391158,0.189576,0.084854,5.150265,5.065411,1.577843,67.656343,66.0785,0.28576,7.784978,7.499218,0.156255,3.656359,3.500104,4.291066,31.907903,27.616837,809.892864,211.257626,-598.635238,,,,6.136117,88.409352,82.273235,70.515997,27.240134,-43.275863,180.33838,46.748943,-133.589437,0.464502,32.203352,31.73885,3.23515,30.527752,27.292602,2015.728593,1182.767222,-832.961371,3224.633651,1162.670822,-2061.962829,34.341479,26.455422,-7.886057,28.155019,30.83147,2.676451,0,2.257848,2.257848,584.118984,526.851314,-57.26767,573.254593,702.938225,129.683632,110.57352,62.971934,-47.601586,798.996638,1371.603023,572.606385,3003.843179,3052.854262,49.0110829999999,10.742334,132.052077,121.309743,28.948033,89.571639,60.623606,441.215229,967.408166,526.192937,0,2.56768,2.56768,15.625468,27.180686,11.555218,846.505799,420.531576,-425.974223,0,0,0,460.780478,344.130907,-116.649571,535.121558,186.051737,-349.069821,3.253888,0.030787,-3.223101,502.022698,183.872373,-318.150325,4287.530489,4581.027787,293.497298,2992.632595,602.088538,-2390.544057,1955.058042,3433.490105,1478.432063,1279.119082,2211.582699,932.463617,31.560143,71.064906,39.504763,0.070849,0.122668,0.051819,2.421247,1.800045,-0.621202,3346.75033,2249.842064,-1096.908266,7693.893025,3666.374207,-4027.518818,759.409232,212.575561,-546.833671,,,,312.525995,131.75615,-180.769845,113.37184,30.097591,-83.274249,255.252837,121.012903,-134.239934,19.711376,1.203033,-18.508343,1958.940913,2613.27812,654.337207,48.51013,22.085772,-26.424358,22.840313,62.782057,39.941744,74.583724,44.569092,-30.014632,379.729553,266.872289,-112.857264,,,,2545.082461,633.598408,-1911.484053,30.045384,6.033485,-24.011899,149.197856,154.544511,5.346655,10.508106,5.289186,-5.21892,110.485768,20.013587,-90.472181,9.864327,50.337681,40.473354,56.167241,46.395486,-9.771755,0.122457,11.653572,11.531115,2.151669,1.815991,-0.335678,19.612631,0.889794,-18.722837,6.272149,5.500966,-0.771183,0.72115,2.845307,2.124157,819.597735,865.468596,45.8708610000001,296.861533,69.842745,-227.018788,0.007243,227.100944,227.093701,13.79225,11.217693,-2.574557,0.19706,0.13336,-0.0637,0.003704,0.448613,0.444909,2739.8839,1467.512879,-1272.371021,,,,31.85532,12.311573,-19.543747,43.324519,17.130416,-26.194103,3.454398,0.711263,-2.743135,9.119812,0.72758,-8.392232,,,,11.028666,10.478344,-0.550322,0.004708,1.300058,1.29535,0.165995,1.582224,1.416229,1.629316,2.399957,0.770641,83.632934,44.650933,-38.982001,123.258696,100.149977,-23.108719,34.225877,17.704453,-16.521424,534.602303,997.789018,463.186715,0.828292,5.622407,4.794115,1.40569,6.197173,4.791483,7.130965,70.119385,62.98842,1391.302945,210.893039,-1180.409906,0.005395,10.898753,10.893358,800.8,664.5,-136.3,0.246487,0,-0.246487,0.222031,0.162875,-0.059156,108.970099,109.095982,0.125883000000002,1207.330172,198.617005,-1008.713167,,,,5090.344401,1505.732108,-3584.612293,89.470316,114.569149,25.098833,284.010342,1590.218276,1306.207934,18.941066,19.793546,0.85248,164.991529,137.149601,-27.841928,64.305349,94.929135,30.623786,3.144245,165.061909,161.917664,3108.762195,1350.820684,-1757.941511,294.91289,112.110822,-182.802068,11.601192,2.045712,-9.55548,483.709191,35.904123,-447.805068,226.87027,13.775071,-213.095199,0,1.727364,1.727364,1976.030307,841.017483,-1135.012824,1763.432986,335.066035,-1428.366951,1.092514,2.063073,0.970559,250.652972,17.568002,-233.08497,2048.049429,899.285158,-1148.764271,1372.850084,2200.160252,827.310168,1581.919417,558.924067,-1022.99535,0,0.285879,0.285879,0.459336,13.480705,13.021369,749.363542,543.344422,-206.01912,9.452633,18.487253,9.03462,0.000715,0.133542,0.132827,1.033376,2.450721,1.417345,34417.54042,8359.472713,-26058.067707,0.235487,20.845252,20.609765,0,4.864279,4.864279,4549.926567,3169.565119,-1380.361448,341.848543,2456.10257,2114.254027,3066.713713,1736.290805,-1330.422908,11755.682392,5600.741926,-6154.940466,734.081233,2312.129376,1578.048143,0.005315,0.083828,0.078513,0.111853,0.020711,-0.091142,0.12921,0.005422,-0.123788,0.000009,0,-0.000009,19.858548,93.637269,73.778721,260.788556,382.665691,121.877135,0.020718,0.152309,0.131591,0.357604,0.105611,-0.251993,0.001829,0.039283,0.037454,0.124271,1.320739,1.196468,0.024592,0.264456,0.239864,0.054877,1.19488,1.140003,0,0,0,0.042692,0.011139,-0.031553,0.000335,0.063997,0.063662,1.953127,6.288446,4.335319,0,0.031117,0.031117,3.751499,9.696739,5.94524,0.83845,4.055266,3.216816,0.36364,4.113285,3.749645,0.028606,1.507402,1.478796,0.008905,0,-0.008905,12.836312,2.225178,-10.611134,0.060437,2.169884,2.109447,92.77452,201.010428,108.235908,898.022832,65.734774,-832.288058,68.839616,77.390208,8.55059199999999,23.176057,18.482937,-4.69312,152.404726,388.377359,235.972633,0,0,0,0.000862,1.819443,1.818581,0,0,0,177.72086,19.784449,-157.936411,0.22214,17.191479,16.969339,60.741385,18.021314,-42.720071,1.860098,15.183241,13.323143,0.19983,2.522946,2.323116,10.926986,11.081954,0.154968,2.602784,5.806508,3.203724,179.010064,10.582598,-168.427466,19.377594,91.922002,72.544408,0.015074,2.280296,2.265222,78.093204,1.819534,-76.27367,0.194089,7.245363,7.051274,1501.876403,310.935096,-1190.941307,0.573523,0.018225,-0.555298,168.965956,17.867775,-151.098181,199.580001,2.420574,-197.159427,1.326775,0.124502,-1.202273,0.092422,2.210985,2.118563,0.002108,24.771518,24.76941,1465.097687,125.376395,-1339.721292,267.598301,16.934066,-250.664235,0.001797,0.1202,0.118403,0.105165,0.612193,0.507028,0.017241,0.082775,0.065534,18.153727,22.011363,3.857636,1.531719,9.374492,7.842773,0.616038,2.626206,2.010168,6.090661,1.026879,-5.063782,0.206979,1.478272,1.271293,2.765859,5.103782,2.337923,0.006647,0.283491,0.276844,1.27969,12.048101,10.768411,3.054499,4.07248,1.017981,25.305204,56.358088,31.052884,0.299001,0.650481,0.35148,1.169332,0.819746,-0.349586,8.127797,26.073505,17.945708,20.843086,5.161437,-15.681649,1.623165,20.974099,19.350934,8.869964,5.033081,-3.836883,0,0.665414,0.665414,0.284239,0.106609,-0.17763,2.031714,0.55656,-1.475154,0.002108,0.025949,0.023841,772.866301,574.191703,-198.674598,4.169369,11.229168,7.059799,11.054447,4.161623,-6.892824,3.144087,12.806993,9.662906,5.147815,2.870175,-2.27764,16.023736,3.984789,-12.038947,6.209744,2.249662,-3.960082,29.438831,4.640599,-24.798232,0,0,0,,,
2012-02-01,12162.501543,5716.262425,-6446.239118,28539.361611,22540.050388,-5999.311223,186726.53279955,127269.721853121,-59456.8109464285,13490.262366,0,-13490.262366,14340.329146,7746.140054,-6594.189092,29230.156193,23432.853907,-5797.302286,9234.555446,11747.571471,2513.016025,13904.33274,13342.3124,-562.020340000003,48847.796904,40445.94941,-8401.847494,34534.302625,28215.165242,-6319.13738300002,4520.479501,2405.387709,-2115.091792,54964.526215,30969.79531,-23994.730905,171831.072786,123612.302071,-48218.770715,69003.314015,36438.135329,-32565.178686,2482.703763,2514.285292,31.581529,1020.288147,2764.98947,1744.701323,3338.223394,1543.154942,-1795.068452,0.558854,0.332964,-0.22589,26230.561403,23510.000548,-2720.560855,0,0.029547,0.029547,22617.235501,16935.948862,-5681.286639,341.497955,435.639165,94.14121,23.858524,34.086059,10.227535,198.024183,293.168149,95.143966,378.047917,525.74275,147.694833,222.564089,96.192942,-126.371147,972.088163,580.267979,-391.820184,29.720895,800.177168,770.456273,1.390441,71.302347,69.911906,25.820762,271.334438,245.513676,0,69.648897,69.648897,31.927805,150.725216,118.797411,0.662116,17.56156,16.899444,0.961286,44.340072,43.378786,55.458149,73.817009,18.35886,370.481456,583.274307,212.792851,0.380463,1.314858,0.934395,0.216069,33.403145,33.187076,4.874753,8.486363,3.61161,0.402322,30.39121,29.988888,0.377636,0.52001,0.142374,0.074121,14.654781,14.58066,1.388815,11.871025,10.48221,0.151339,6.490028,6.338689,0.149141,5.588529,5.439388,4.877971,33.019039,28.141068,652.007257,152.270793,-499.736464,,,,5.327753,67.761377,62.433624,88.025811,32.16446,-55.861351,211.559896,33.228128,-178.331768,0.0404,38.138771,38.098371,2.675236,34.683325,32.008089,2047.136602,1100.637747,-946.498855,3065.826907,1209.692682,-1856.134225,48.921095,31.404537,-17.516558,20.813673,33.951383,13.13771,0.308155,3.967184,3.659029,739.221917,431.559478,-307.662439,546.710348,660.875634,114.165286,60.250507,53.804479,-6.446028,822.736614,1495.094743,672.358129,2634.947294,3149.222902,514.275608,6.349281,138.478703,132.129422,19.640629,95.67958,76.038951,262.540259,386.665936,124.125677,3.896735,0.013512,-3.883223,23.99781,28.140672,4.142862,850.000291,395.06193,-454.938361,0.000147,0,-0.000147,719.366485,202.46935,-516.897135,554.37302,231.510233,-322.862787,4.848554,0.047552,-4.801002,519.063961,169.758277,-349.305684,4240.040256,5272.725923,1032.685667,2808.595879,675.467005,-2133.128874,1738.024502,2943.643203,1205.618701,1226.337868,2502.104348,1275.76648,25.771221,188.227706,162.456485,0.025338,0.166921,0.141583,6.513657,1.349737,-5.16392,3082.304942,2536.751089,-545.553853,7933.268043,4189.602013,-3743.66603,744.576483,175.804983,-568.7715,,,,285.170082,142.958796,-142.211286,80.278759,25.184054,-55.094705,227.719517,131.943608,-95.775909,19.630926,1.299999,-18.330927,1982.93117,2167.831756,184.900586,48.894603,20.365441,-28.529162,15.291548,39.384389,24.092841,67.120736,71.983217,4.862481,384.12705,263.11588,-121.01117,,,,2308.154227,942.767041,-1365.387186,3.86308,9.230954,5.367874,51.938532,215.730666,163.792134,3.059209,5.430697,2.371488,117.839399,47.959492,-69.879907,14.048957,42.507971,28.459014,132.452287,79.788599,-52.663688,0.151311,19.853323,19.702012,1.768992,2.320898,0.551906,0.009904,7.384195,7.374291,0.718225,4.638753,3.920528,0.716443,159.7456,159.029157,845.166501,715.265102,-129.901399,195.46942,85.15028,-110.31914,0.146262,718.543628,718.397366,17.791884,195.250789,177.458905,0.568061,0.10492,-0.463141,0.003813,0.507066,0.503253,2400.800222,1321.542715,-1079.257507,,,,34.311629,25.349594,-8.962035,48.256561,53.392235,5.135674,4.051692,1.406009,-2.645683,15.026403,0.994931,-14.031472,,,,8.919627,9.066277,0.146649999999999,0,0.743506,0.743506,0.147104,1.721618,1.574514,1.631268,2.919383,1.288115,70.515639,117.508798,46.993159,87.78388,47.926176,-39.857704,40.57744,21.782641,-18.794799,538.100502,975.093746,436.993244,2.041303,6.639557,4.598254,1.63635,3.821053,2.184703,4.553468,70.128618,65.57515,975.398847,111.915206,-863.483641,0.006849,16.442808,16.435959,681.5,748.2,66.7,0.06318,0,-0.06318,0.207371,0.0594,-0.147971,93.226414,198.519392,105.292978,525.854433,213.537894,-312.316539,,,,4063.460354,1329.836453,-2733.623901,32.049483,182.825781,150.776298,136.6515,1666.423421,1529.771921,7.854696,31.726644,23.871948,89.518551,136.116622,46.598071,40.026919,91.607604,51.580685,0.494411,119.80397,119.309559,3034.80004,1495.959037,-1538.841003,253.659335,130.694399,-122.964936,5.668681,7.515278,1.846597,440.666169,35.099362,-405.566807,206.146498,15.553593,-190.592905,0.038,1.871883,1.833883,1873.441491,791.704118,-1081.737373,1335.199595,331.848412,-1003.351183,1.374037,1.742959,0.368922,223.883229,17.883144,-206.000085,2012.387663,1000.903378,-1011.484285,1645.773847,2318.093705,672.319858,1408.690847,599.457236,-809.233611,0,0.016415,0.016415,1.701609,12.679502,10.977893,764.717505,610.053887,-154.663618,7.864572,18.613453,10.748881,0.000172,0.727085,0.726913,1.041332,1.989188,0.947856,28105.186419,8785.662778,-19319.523641,0.230076,24.171966,23.94189,0,0.048922,0.048922,4402.993769,3995.815632,-407.178137,512.500866,3589.332956,3076.83209,2673.286964,1844.329178,-828.957786,12433.037237,5468.251405,-6964.785832,733.375151,2429.596254,1696.221103,0.018078,0.667949,0.649871,0.058897,0,-0.058897,0.050261,0.023844,-0.026417,0,0,0,18.235145,80.946,62.710855,244.774621,216.059946,-28.714675,0.004508,0.354992,0.350484,0.496154,3.005008,2.508854,0.001335,0.054632,0.053297,0.085643,1.641335,1.555692,0.044474,0.812231,0.767757,0.175459,0.499799,0.32434,0.000113,0,-0.000113,0.054335,0.30274,0.248405,0.002925,0.047254,0.044329,6.961777,6.212744,-0.749033,0,0.037128,0.037128,8.05197,9.133231,1.081261,1.01804,2.837338,1.819298,0.103341,4.823936,4.720595,0.004319,1.373174,1.368855,0.018033,0.003429,-0.014604,6.658695,3.674845,-2.98385,0.097911,2.869128,2.771217,69.50586,211.992279,142.486419,744.433872,110.374372,-634.0595,58.12046,61.968379,3.847919,0.623699,7.833973,7.210274,242.031756,452.425361,210.393605,0,0,0,0.000402,7.660861,7.660459,0.000472,0.014094,0.013622,162.960759,20.749881,-142.210878,0.051839,35.640753,35.588914,58.113268,12.069807,-46.043461,0.38402,25.179969,24.795949,0.75639,2.505764,1.749374,9.859942,8.449083,-1.410859,1.090632,10.118667,9.028035,180.98904,13.825484,-167.163556,24.212048,148.832157,124.620109,0.017213,1.535941,1.518728,0.045317,1.684942,1.639625,0.139256,8.081886,7.94263,1208.358917,321.399254,-886.959663,0.26364,1.665792,1.402152,56.673545,19.839545,-36.834,220.60928,2.010291,-218.598989,0.138349,0.089282,-0.049067,0.086034,4.117781,4.031747,0.057502,35.011823,34.954321,604.663947,97.969888,-506.694059,137.429711,19.682248,-117.747463,0.000978,0.207649,0.206671,2.710834,0.723001,-1.987833,0.048051,0,-0.048051,1.335713,14.37536,13.039647,1.367327,14.923109,13.555782,0.382906,2.773205,2.390299,1.553101,2.51464,0.961539,0.001471,4.332831,4.33136,3.726111,18.087122,14.361011,0.000108,1.006367,1.006259,2.278005,10.368104,8.090099,3.331535,5.437311,2.105776,26.796418,59.326398,32.52998,0.500893,0.506169,0.00527599999999995,0.258053,0.138077,-0.119976,37.892775,21.042389,-16.850386,18.727747,4.850136,-13.877611,4.851674,7.486634,2.63496,10.421424,2.482068,-7.939356,0.004249,0.431211,0.426962,0.346423,0.15667,-0.189753,1.192768,0.486117,-0.706651,0,0.042171,0.042171,490.114973,534.271778,44.156805,5.401071,11.937375,6.536304,7.885504,10.941574,3.05607,8.462793,10.744285,2.281492,5.091823,2.79135,-2.300473,7.903226,2.077806,-5.82542,7.314486,1.856538,-5.457948,21.645476,3.138979,-18.506497,0,0,0,,,
2012-03-01,16584.028656,7290.985689,-9293.042967,34910.021854,25209.867034,-9700.15481999999,196615.375406,130489.058578442,-66126.3168275579,15010.801908,0,-15010.801908,15979.585648,8891.849113,-7087.736535,35082.844907,28025.449727,-7057.39518,10218.509013,12791.97339,2573.464377,16629.517339,15841.917814,-787.599524999996,54299.969262,45425.387391,-8874.581871,41508.433493,31736.969652,-9771.46384099998,6101.381372,3045.606329,-3055.775043,60767.700306,34356.91916,-26410.781146,197350.132105,140219.065283,-57131.066822,77618.007196,40998.048566,-36619.95863,2824.097969,2773.481995,-50.6159740000007,1192.252001,3160.628541,1968.37654,3996.066627,1968.740383,-2027.326244,0.571442,10.506581,9.935139,29184.998618,26418.441638,-2766.55698,0,0.000409,0.000409,25114.970644,19006.945753,-6108.024891,411.757961,489.085037,77.327076,16.040859,18.865336,2.824477,251.046722,322.257816,71.211094,411.302679,510.53799,99.235311,247.641843,103.370947,-144.270896,1129.305999,740.548844,-388.757155,35.360541,806.016173,770.655632,1.6126,41.152802,39.540202,96.387023,354.884179,258.497156,0.079195,42.027484,41.948289,44.466272,166.588758,122.122486,0.731629,23.786556,23.054927,0.77052,60.646069,59.875549,59.992466,114.940995,54.948529,373.042765,607.681361,234.638596,0.294373,2.60816,2.313787,0.083991,14.531904,14.447913,4.354223,8.369069,4.014846,0.664984,20.082357,19.417373,0.244124,0.833703,0.589579,0.136736,9.987316,9.85058,1.342681,15.770217,14.427536,0.156902,10.182757,10.025855,0.501617,5.211583,4.709966,4.771033,40.659911,35.888878,758.688128,165.203528,-593.4846,,,,9.899267,76.78029,66.881023,73.926357,122.12699,48.200633,272.120167,70.256812,-201.863355,0.068248,38.716612,38.648364,3.791663,32.550411,28.758748,2334.310624,1423.988022,-910.322602,4062.798798,1312.46514,-2750.333658,37.625341,44.25308,6.627739,27.573815,34.268529,6.694714,0.22074,2.125146,1.904406,797.784954,558.484549,-239.300405,430.378117,864.284186,433.906069,101.74679,64.813836,-36.932954,898.923288,1555.667966,656.744678,3303.40589,3935.941279,632.535389,8.732536,175.74487,167.012334,26.952058,120.528666,93.576608,387.876305,713.0013,325.124995,0.604515,0.089278,-0.515237,24.471622,16.951192,-7.52043,1007.581211,534.418009,-473.163202,0,0,0,754.002421,397.631902,-356.370519,415.545661,266.278436,-149.267225,5.957479,0.078571,-5.878908,528.783533,213.486124,-315.297409,5066.280655,5380.431782,314.151127,2857.283225,795.029603,-2062.253622,2161.623232,3510.026202,1348.40297,1500.098613,2931.693911,1431.595298,73.773315,306.763645,232.99033,0.001038,0.218021,0.216983,1.746959,0.889021,-0.857938,3863.470966,2796.485038,-1066.985928,10209.418557,4599.154808,-5610.263749,857.439398,204.574598,-652.8648,,,,388.989505,205.547238,-183.442267,169.70068,45.186968,-124.513712,272.64374,133.604553,-139.039187,23.511913,1.804846,-21.707067,2899.17309,2879.338921,-19.8341689999997,65.204907,20.339161,-44.865746,18.013556,60.111223,42.097667,143.922232,71.968171,-71.954061,401.373588,263.683856,-137.689732,,,,1851.439796,837.070921,-1014.368875,8.720075,7.97657,-0.743505,82.981382,252.559896,169.578514,7.409478,4.387077,-3.022401,262.406948,23.261207,-239.145741,3.338404,55.364753,52.026349,54.738613,97.905424,43.166811,0.350986,8.548285,8.197299,0.764535,3.918641,3.154106,0.000791,0.461265,0.460474,0.809116,5.17131,4.362194,0.339715,12.730256,12.390541,1046.578325,788.195214,-258.383111,284.378838,126.792064,-157.586774,0,663.477929,663.477929,24.200296,83.792475,59.592179,0.707494,0.099373,-0.608121,0.012939,0.441268,0.428329,3216.446801,1578.98567,-1637.461131,,,,36.20534,26.195057,-10.010283,43.220159,35.32282,-7.897339,3.2659,1.149295,-2.116605,6.215693,2.000351,-4.215342,,,,9.005862,11.593094,2.587232,0.0216,0.363238,0.341638,0.624146,0.567303,-0.056843,1.147923,3.552899,2.404976,137.43593,85.60689,-51.82904,119.222721,112.316275,-6.906446,36.034799,33.138015,-2.896784,559.040381,1211.394732,652.354351,1.357411,26.934285,25.576874,1.654014,4.746227,3.092213,6.323437,77.897164,71.573727,921.042494,88.419533,-832.622961,0.0214,13.857651,13.836251,795.2,603.4,-191.8,0,0,0,0.225775,0.100374,-0.125401,80.610517,123.981311,43.370794,1576.158275,232.090556,-1344.067719,,,,4949.488862,1695.725091,-3253.763771,77.976542,524.163681,446.187139,187.741186,2081.62214,1893.880954,0.00559,53.857304,53.851714,120.250929,133.657726,13.406797,89.376493,120.40514,31.028647,0.280988,142.229076,141.948088,3365.323336,1757.130934,-1608.192402,288.969907,175.938658,-113.031249,8.275997,7.212796,-1.063201,443.608817,41.818519,-401.790298,219.366944,20.440315,-198.926629,0,3.896723,3.896723,2219.744784,790.522359,-1429.222425,1391.774549,359.143591,-1032.630958,1.311566,5.281549,3.969983,219.418664,23.661252,-195.757412,2204.707897,1036.410808,-1168.297089,2005.251964,2855.750675,850.498711,1569.85144,768.648882,-801.202558,0,0.037374,0.037374,0.701297,12.772201,12.070904,863.281114,679.182736,-184.098378,8.370291,30.070663,21.700372,0.069873,0.345116,0.275243,2.240176,5.43826,3.198084,31431.348931,9811.576526,-21619.772405,0.216962,60.110336,59.893374,0,0.106052,0.106052,4788.190506,4226.833136,-561.35737,317.553716,3305.415866,2987.86215,3107.512827,2403.973713,-703.539114,13310.04541,6121.863238,-7188.182172,801.939877,2836.547857,2034.60798,0,0.093487,0.093487,0.016545,0,-0.016545,0.147927,0.082582,-0.065345,0,0,0,14.80104,15.535372,0.734332,344.143996,252.337487,-91.806509,0.180566,0.271849,0.091283,0.56853,4.536775,3.968245,0.001819,0.008039,0.00622,0.211813,1.298652,1.086839,0.122876,1.140441,1.017565,0.056263,18.497877,18.441614,0.001999,0,-0.001999,0.056573,0.359127,0.302554,0.002149,0.07863,0.076481,5.093284,6.681217,1.587933,0,0.06771,0.06771,3.327985,10.614626,7.286641,0.603155,3.977232,3.374077,0.054211,3.684517,3.630306,0.002488,1.143092,1.140604,0.02553,0.323608,0.298078,20.213934,2.547533,-17.666401,0.650386,0.870838,0.220452,86.618613,301.553033,214.93442,1405.860637,129.916598,-1275.944039,31.607752,58.032954,26.425202,21.977457,12.869929,-9.107528,330.765405,550.891624,220.126219,0,0,0,0.00021,5.701887,5.701677,0.016738,0,-0.016738,80.324151,19.65985,-60.664301,0.013076,9.528734,9.515658,16.401244,15.273529,-1.127715,0.672798,13.842004,13.169206,0.031767,12.766758,12.734991,12.958671,36.772772,23.814101,0.427988,8.512922,8.084934,105.225952,19.12805,-86.097902,27.192732,128.311611,101.118879,0.005347,1.824086,1.818739,0.292106,2.496055,2.203949,0.574955,6.982675,6.40772,1543.092162,418.295292,-1124.79687,0.272892,0.349655,0.076763,13.056238,25.050486,11.994248,317.910586,5.969095,-311.941491,1.842726,0.03568,-1.807046,0.044996,2.098757,2.053761,0.136136,56.528228,56.392092,817.097267,200.435674,-616.661593,27.235629,22.096004,-5.139625,0.010363,1.878501,1.868138,0.003605,0.577902,0.574297,0.027538,0.08021,0.052672,21.348386,11.856895,-9.491491,9.427199,13.42859,4.001391,0.431935,2.289747,1.857812,1.454126,3.086152,1.632026,0.08714,4.094964,4.007824,4.923494,4.992865,0.0693710000000012,0.02734,0.130926,0.103586,1.144676,8.727452,7.582776,4.09046,6.461754,2.371294,30.587797,36.115537,5.52774,0.230792,1.092625,0.861833,2.923622,0.004935,-2.918687,6.243079,21.368917,15.125838,20.127027,3.367347,-16.75968,1.303633,64.244502,62.940869,8.167377,7.076813,-1.090564,0.002553,0.804667,0.802114,0.671034,0.159846,-0.511188,0.712857,0.369065,-0.343792,0,0.239552,0.239552,825.61023,707.531302,-118.078928,24.740118,9.075169,-15.664949,23.750549,4.059532,-19.691017,3.725974,12.308396,8.582422,3.923369,1.229912,-2.693457,4.507521,3.022025,-1.485496,5.048344,6.571212,1.522868,27.481452,0.059345,-27.422107,0,0,0,,,
2012-04-01,17768.914919,6309.106118,-11459.808801,31285.834449,22360.974728,-8924.859721,192329.297392469,129049.123497659,-63280.1738948099,13530.438039,0,-13530.438039,15230.744926,8511.547047,-6719.197879,30483.361551,23767.267075,-6716.094476,10851.259117,11828.521553,977.262435999997,15065.268594,15588.30732,523.038726000004,50560.14121,41704.192434,-8855.948776,37160.635526,27519.392359,-9641.24316699999,6132.868124,2781.833509,-3351.034615,61258.088316,31135.870807,-30122.217509,189466.165326,127411.442243,-62054.723083,79450.085713,37105.48024,-42344.605473,2548.727567,2561.671809,12.9442419999996,1096.719628,2700.803796,1604.084168,4583.212927,1864.927191,-2718.285736,0.445987,0.334474,-0.111513,27802.767047,24495.603566,-3307.163481,0.000544,0.073785,0.073241,22757.374163,17208.588868,-5548.785295,418.283358,516.409391,98.126033,11.629222,19.656477,8.027255,172.668268,226.438856,53.770588,340.694496,526.522297,185.827801,237.776929,99.381882,-138.395047,988.936292,612.062311,-376.873981,28.131725,860.112439,831.980714,1.143952,33.717792,32.57384,41.280684,392.617107,351.336423,0,23.761355,23.761355,43.840096,156.611104,112.771008,0.803899,15.698068,14.894169,2.491028,53.981603,51.490575,67.206993,86.144887,18.937894,390.368224,580.857072,190.488848,0.345235,2.029325,1.68409,0.189169,9.711727,9.522558,6.550744,8.253991,1.703247,0.243878,21.239939,20.996061,0.029931,0.617501,0.58757,0.072871,4.492441,4.41957,0.96298,59.899922,58.936942,0.096504,5.454334,5.35783,1.593886,4.862098,3.268212,4.874995,42.842134,37.967139,556.358406,276.994424,-279.363982,,,,6.208322,51.251043,45.042721,94.377854,94.306131,-0.0717230000000058,89.804635,34.250626,-55.554009,0.675546,23.728702,23.053156,0.00013,42.489486,42.489356,2165.286949,1304.271202,-861.015747,3544.336243,1392.13331,-2152.202933,38.756866,24.720364,-14.036502,27.339471,37.0663,9.726829,0,4.497906,4.497906,1143.063775,675.841661,-467.222114,408.986233,790.40178,381.415547,97.017838,59.89592,-37.121918,900.185165,1516.311922,616.126757,2908.317143,3641.023173,732.70603,10.61872,153.812132,143.193412,29.874634,123.519528,93.644894,282.712651,978.386098,695.673447,1.132654,0.029559,-1.103095,25.300584,22.27798,-3.022604,885.183424,461.588164,-423.59526,0.000018,0,-0.000018,453.826579,213.972329,-239.85425,382.447153,239.249158,-143.197995,7.139875,0.086717,-7.053158,555.62614,172.233432,-383.392708,4466.91487,4709.443871,242.529001000001,2758.500016,717.686479,-2040.813537,1990.713923,3268.136247,1277.422324,1397.64105,2369.205301,971.564251,35.111005,72.902395,37.79139,0.015903,0.131686,0.115783,2.110714,6.246057,4.135343,3358.409109,2612.194491,-746.214618,8867.710893,4183.09059,-4684.620303,728.148467,229.038122,-499.110345,,,,340.874535,134.344226,-206.530309,156.712492,28.468346,-128.244146,244.178796,117.845196,-126.3336,59.675701,1.6225,-58.053201,2069.705025,2084.855772,15.1507469999997,37.091519,22.127983,-14.963536,23.503055,34.94329,11.440235,66.383951,58.802853,-7.581098,410.764567,263.032699,-147.731868,,,,2361.28915,1074.307937,-1286.981213,5.674713,8.385524,2.710811,57.377449,179.897457,122.520008,4.101245,6.569382,2.468137,36.830197,26.675059,-10.155138,23.34886,34.63995,11.29109,156.618756,61.912847,-94.705909,1.536002,17.292367,15.756365,1.044276,2.946188,1.901912,0.31629,12.818908,12.502618,1.321982,6.225339,4.903357,0.298947,28.282857,27.98391,902.692147,897.073519,-5.61862799999994,149.269674,116.237874,-33.0318,0.175621,154.176926,154.001305,19.285155,17.179608,-2.105547,0.439174,0.181877,-0.257297,0.04294,0.34717,0.30423,3212.628531,1411.28397,-1801.344561,,,,22.434671,38.735626,16.300955,47.733807,32.508529,-15.225278,3.462861,2.043976,-1.418885,6.504825,1.710224,-4.794601,,,,12.759605,14.37792,1.618315,0.028718,1.613283,1.584565,0.386515,0.852383,0.465868,2.246971,4.12647,1.879499,82.596183,62.269367,-20.326816,135.69137,60.066178,-75.625192,26.818082,22.139612,-4.67847,558.78691,1151.10492,592.31801,3.204535,47.883228,44.678693,1.546734,1.158065,-0.388669,5.004783,132.555271,127.550488,1446.236265,299.521595,-1146.71467,0.118354,44.06052,43.942166,653.1,662.3,9.19999999999993,0,0.0246,0.0246,0.282479,0.123703,-0.158776,85.938244,109.721928,23.783684,1596.917039,228.165684,-1368.751355,,,,5784.0983,1432.153636,-4351.944664,87.819539,144.082876,56.263337,167.142508,1482.229794,1315.087286,12.599381,46.133801,33.53442,113.655006,166.00118,52.346174,62.108369,94.81219,32.703821,1.081918,114.406721,113.324803,3328.139252,1758.580753,-1569.558499,269.658664,117.084699,-152.573965,5.709343,2.275539,-3.433804,438.776089,41.255107,-397.520982,191.299075,22.358858,-168.940217,0,2.602564,2.602564,2222.835921,863.844896,-1358.991025,1624.974331,367.147487,-1257.826844,2.605459,2.147116,-0.458343,222.941152,21.53025,-201.410902,1986.440644,1079.122288,-907.318356,1702.584245,2514.910693,812.326448,1482.147688,632.078273,-850.069415,0,0.032366,0.032366,0.73338,14.068888,13.335508,752.022552,662.909556,-89.1129960000001,8.101639,30.993319,22.89168,0.000347,0.180606,0.180259,3.420208,2.317001,-1.103207,33016.253834,8468.141982,-24548.111852,2.343494,32.027773,29.684279,0,1.796901,1.796901,5473.701186,3693.75569,-1779.945496,324.39079,3619.483578,3295.092788,3350.582896,2000.371592,-1350.211304,12086.693223,5812.396643,-6274.29658,753.856654,2352.37093,1598.514276,0.00678,0.003968,-0.002812,0.099687,0.109039,0.009352,0.036245,0.065456,0.029211,0,0.183304,0.183304,12.248867,26.761361,14.512494,308.330718,228.506014,-79.824704,0.183021,0.158089,-0.024932,0.515677,1.143032,0.627355,0.007849,0.013542,0.005693,0.156033,1.936023,1.77999,0.018855,1.468114,1.449259,0.250063,39.341104,39.091041,0,0,0,0.048632,0.109197,0.060565,0.000171,0.044486,0.044315,3.137707,7.980218,4.842511,0,0.033641,0.033641,2.891371,9.816136,6.924765,1.165416,9.232433,8.067017,0.051291,2.761159,2.709868,0.021692,1.100752,1.07906,0.114954,0.052805,-0.062149,13.375486,9.678895,-3.696591,0.18716,8.058822,7.871662,81.030032,179.19189,98.161858,1011.952617,83.414119,-928.538498,28.598959,54.346625,25.747666,6.552332,29.580361,23.028029,292.904771,516.360727,223.455956,0,0,0,0.00005,1.883045,1.882995,0,0,0,73.646078,13.366651,-60.279427,0.059202,47.456892,47.39769,11.96222,20.99087,9.02865,1.007798,8.265674,7.257876,0.215401,14.684128,14.468727,5.596282,12.286434,6.690152,1.323603,5.965898,4.642295,185.00383,19.910606,-165.093224,29.559448,111.997353,82.437905,0.003121,3.149669,3.146548,0.325611,7.715378,7.389767,0.436459,111.722633,111.286174,1981.286345,353.819279,-1627.467066,0.135815,2.72833,2.592515,147.83209,13.237794,-134.594296,259.607297,3.404474,-256.202823,0.109219,4.526269,4.41705,0.078638,6.373371,6.294733,0.126,48.165934,48.039934,874.935868,95.749601,-779.186267,157.583031,16.57679,-141.006241,0.000219,0.518286,0.518067,0.087581,0.541189,0.453608,0.006249,0.098931,0.092682,7.172581,21.300678,14.128097,9.622283,14.612435,4.990152,0.279484,1.084884,0.8054,2.657487,1.304759,-1.352728,0.113212,0.879878,0.766666,6.465968,7.086068,0.6201,0.000122,0.091152,0.09103,0.567523,6.824286,6.256763,4.630298,13.063943,8.433645,28.957628,31.21191,2.254282,0.287286,0.577643,0.290357,1.142834,0.000808,-1.142026,11.36991,15.600956,4.231046,20.686049,52.618402,31.932353,3.565716,29.307959,25.742243,7.270031,5.013126,-2.256905,0,0.612746,0.612746,0.261444,0.132284,-0.12916,2.908699,0.731431,-2.177268,0,0.099005,0.099005,663.275254,663.862281,0.587027000000035,32.598711,8.500074,-24.098637,12.641224,2.573186,-10.068038,5.104895,11.194252,6.089357,3.994737,1.479087,-2.51565,1.421875,4.776329,3.354454,5.203173,1.498623,-3.70455,19.517554,3.112549,-16.405005,0,11.024326,11.024326,,,
2012-05-01,17677.303146,6442.844321,-11234.458825,33452.229392,22855.209461,-10597.019931,191026.564856353,129327.668414053,-61698.8964422998,14923.555737,0,-14923.555737,14816.759493,8970.903921,-5845.855572,33723.800762,24883.566295,-8840.234467,10962.758993,11252.721659,289.962666000001,14555.796615,15362.445764,806.649148999995,52427.780259,44339.482665,-8088.297594,40049.929777,28022.237711,-12027.692066,6465.480736,3072.097035,-3393.38370100001,63780.623099,31534.584214,-32246.038885,198409.592556,131233.078684,-67176.513872,83623.57181,37446.148839,-46177.422971,2851.173153,2511.274534,-339.898619,1286.733051,2979.457631,1692.72458,4704.576728,2106.895903,-2597.680825,0.3,0.319719,0.019719,27612.779609,25912.565173,-1700.214436,0.000308,0.000237,-0.000071,24815.00065,18426.917492,-6388.083158,417.849535,568.241262,150.391727,11.286947,18.767014,7.480067,221.306053,216.05686,-5.24919299999999,427.876413,484.634849,56.758436,240.009756,80.332223,-159.677533,1173.34192,586.950022,-586.391898,93.397696,889.182852,795.785156,2.274735,45.763408,43.488673,40.142956,258.760458,218.617502,0,37.32572,37.32572,24.153063,146.513584,122.360521,0.901746,15.66755,14.765804,2.443031,50.653045,48.210014,75.37637,72.543697,-2.832673,370.789476,575.059318,204.269842,0.265509,1.789608,1.524099,0.489035,10.367166,9.878131,4.91188,6.862746,1.950866,1.711655,10.773913,9.062258,0.070314,0.445663,0.375349,0.113136,3.516437,3.403301,1.553927,23.06145,21.507523,0.20559,10.582724,10.377134,2.28371,4.771337,2.487627,4.260605,34.520146,30.259541,814.341472,262.27472,-552.066752,,,,4.603862,40.432405,35.828543,81.963273,106.170091,24.206818,3.382141,94.618213,91.236072,0.807553,21.755475,20.947922,0.298869,35.579817,35.280948,2348.278034,1361.448934,-986.8291,2909.824139,1336.825387,-1572.998752,37.423154,31.072467,-6.350687,16.800483,56.53149,39.731007,0.013149,6.005713,5.992564,928.498705,574.740826,-353.757879,482.717562,733.555184,250.837622,104.492647,61.402246,-43.090401,763.556972,1608.040075,844.483103,2483.939388,3488.069765,1004.130377,11.211409,149.330173,138.118764,38.93996,99.995581,61.055621,406.008711,1141.324979,735.316268,1.680074,0.129171,-1.550903,23.190938,30.79537,7.604432,982.614628,438.965675,-543.648953,0,0.03335,0.03335,741.433888,273.942787,-467.491101,456.740074,228.073142,-228.666932,5.982369,0.047015,-5.935354,712.070175,238.857163,-473.213012,4845.268865,4440.650053,-404.618812,3369.663272,531.813887,-2837.849385,1752.974844,3391.324808,1638.349964,1867.876244,2639.373397,771.497153,35.144913,308.680584,273.535671,0.093761,0.187612,0.093851,3.381284,3.243747,-0.137537,3463.913191,2912.955858,-550.957333,9014.805169,4226.638566,-4788.166603,818.302256,220.027199,-598.275057,,,,363.715558,186.442247,-177.273311,143.609445,18.118628,-125.490817,283.811352,136.866526,-146.944826,26.412918,3.054037,-23.358881,2239.962,2091.682623,-148.279377,33.847722,19.841908,-14.005814,16.918189,40.169202,23.251013,56.717334,56.504692,-0.212642000000002,348.794715,251.607644,-97.187071,,,,2566.596246,814.87578,-1751.720466,7.293282,5.925369,-1.367913,112.627204,169.518446,56.891242,6.037454,3.294964,-2.74249,133.523401,25.460738,-108.062663,19.451207,39.165777,19.71457,95.704532,105.13573,9.43119799999999,0.612306,9.06393,8.451624,1.863168,2.249533,0.386365,6.586701,0.525855,-6.060846,3.729183,4.91604,1.186857,0.498727,9.29339,8.794663,1084.957697,837.340845,-247.616852,158.249789,103.164487,-55.085302,0,302.5243,302.5243,26.611184,5.448084,-21.1631,0.212859,0.051726,-0.161133,0.00098,0.373017,0.372037,3290.519955,1470.593618,-1819.926337,,,,33.419592,28.228742,-5.19085,55.548001,12.658006,-42.889995,3.813519,0.95252,-2.860999,3.129975,0.636272,-2.493703,,,,14.366933,15.031341,0.664408,0.003,0.686736,0.683736,0.4113,1.560337,1.149037,1.140524,6.700259,5.559735,83.350438,56.541903,-26.808535,154.073482,53.236731,-100.836751,30.845083,23.06242,-7.782663,546.221134,1217.870907,671.649773,1.285817,6.252188,4.966371,2.847388,0.820022,-2.027366,11.208922,77.650537,66.441615,2325.775951,105.682082,-2220.093869,0.015209,44.454145,44.438936,697.5,696.1,-1.39999999999998,0,0,0,0.607131,0.396861,-0.21027,79.435921,180.613074,101.177153,1347.152382,175.739911,-1171.412471,,,,5713.27734,1231.703076,-4481.574264,134.415845,121.417233,-12.998612,244.620358,1889.642271,1645.021913,0.142026,30.360266,30.21824,100.517628,158.273278,57.75565,40.043058,85.870328,45.82727,2.952451,126.035984,123.083533,3569.848541,1769.122037,-1800.726504,318.048667,124.264881,-193.783786,5.74118,1.736963,-4.004217,407.845899,72.291942,-335.553957,161.11597,17.72818,-143.38779,0,2.596136,2.596136,2252.550652,966.389548,-1286.161104,1630.044044,372.877522,-1257.166522,2.369298,2.267949,-0.101349,167.897806,18.958956,-148.93885,2194.052356,1212.901626,-981.15073,1750.109477,2502.12632,752.016843,1492.520386,827.825361,-664.695025,0.024,0.054378,0.030378,0.296878,13.214544,12.917666,810.930971,623.509554,-187.421417,7.350157,29.678972,22.328815,0.29615,0.085701,-0.210449,1.268807,1.615123,0.346316,34937.829923,8960.154977,-25977.674946,1.235412,73.92103,72.685618,0,0,0,5466.244545,3489.789033,-1976.455512,396.837072,3247.227466,2850.390394,3349.567899,2013.57884,-1335.989059,12111.403738,5685.98942,-6425.414318,905.896675,2627.291048,1721.394373,0,0.0277,0.0277,0.015448,0.144036,0.128588,0.039088,2.053246,2.014158,0.000004,0.166045,0.166041,8.546922,80.034593,71.487671,349.0361,221.26246,-127.77364,0.344293,0.605882,0.261589,0.133383,0.65288,0.519497,0.004648,0.006915,0.002267,0.174524,1.953576,1.779052,0.03567,0.923561,0.887891,0.064287,3.239551,3.175264,0.000075,0,-0.000075,0.082309,0.570081,0.487772,0.000741,0.016909,0.016168,2.214082,7.494651,5.280569,0.294131,0.071471,-0.22266,6.081776,10.659442,4.577666,1.256987,11.515449,10.258462,0.031177,3.869464,3.838287,0.012219,1.451763,1.439544,0.018876,0.058546,0.03967,12.604304,3.881136,-8.723168,0.139771,1.532507,1.392736,65.681647,205.338497,139.65685,1072.0867,262.524715,-809.561985,94.676352,45.297301,-49.379051,23.921295,32.347663,8.426368,313.945602,398.390482,84.44488,0,0,0,0.00001,0.488649,0.488639,0,0,0,273.587092,12.384884,-261.202208,0.027765,42.970707,42.942942,8.416701,26.860814,18.444113,1.306459,11.731652,10.425193,0.73789,3.492593,2.754703,7.27602,12.449216,5.173196,1.950536,10.987838,9.037302,45.524438,14.635374,-30.889064,17.6949,153.557468,135.862568,0.019782,3.740122,3.72034,0.182997,2.242166,2.059169,0.485839,11.514931,11.029092,1936.581467,506.495016,-1430.086451,0.072931,0.857353,0.784422,132.596089,72.81102,-59.785069,262.492763,2.342393,-260.15037,1.089936,0.00628,-1.083656,0.237009,6.786381,6.549372,0.151983,102.550415,102.398432,852.85256,140.842444,-712.010116,253.428989,15.816905,-237.612084,0.007631,15.634025,15.626394,0.016127,0.436604,0.420477,0.275954,0.119107,-0.156847,0.075794,52.460694,52.3849,2.054299,13.015188,10.960889,0.0024,2.196903,2.194503,1.375294,7.638005,6.262711,0.074455,0.601992,0.527537,9.312759,22.541552,13.228793,0.035323,0.315624,0.280301,2.145024,8.148969,6.003945,5.299802,10.069889,4.770087,30.672689,102.015607,71.342918,1.041074,0.392882,-0.648192,0.807504,0.095953,-0.711551,8.962259,15.754313,6.792054,16.857106,4.250542,-12.606564,3.56289,45.677574,42.114684,7.825883,7.944731,0.118848,0,0.634342,0.634342,0.000001,0,-0.000001,0.411705,0.601493,0.189788,0.001942,0.023848,0.021906,737.740842,591.007426,-146.733416,6.003821,17.142006,11.138185,25.062337,4.623898,-20.438439,7.433271,8.648911,1.21564,5.177282,1.833673,-3.343609,5.411941,3.692361,-1.71958,5.855231,5.829833,-0.025398,19.188898,3.084702,-16.104196,0,10.889083,10.889083,,,
2012-06-01,15727.201906,7225.102269,-8502.099637,31454.954659,23210.015604,-8244.93905500001,188829.751256966,129422.465710949,-59407.2855460166,14211.654163,0,-14211.654163,14877.475712,9058.894326,-5818.581386,33401.430276,26559.977348,-6841.452928,10555.910683,11980.219401,1424.308718,13803.260729,14987.976146,1184.715417,50844.782528,43333.657894,-7511.12463399999,38076.494425,29053.433909,-9023.06051600002,6307.51807,2656.960793,-3650.557277,64108.328697,32187.364116,-31920.964581,191786.70463,132578.896665,-59207.8079649998,81506.212363,39417.894655,-42088.317708,2632.604499,2514.641461,-117.963038,1247.91233,3128.681425,1880.769095,4851.313527,1756.070201,-3095.243326,0.522159,0.291843,-0.230316,27330.870113,25857.643716,-1473.226397,0.002026,0,-0.002026,23513.912415,17476.014178,-6037.898237,346.909137,521.003127,174.09399,10.318424,28.583536,18.265112,234.859004,259.631583,24.772579,412.032941,426.6447,14.611759,225.791081,90.208945,-135.582136,1023.138003,587.472719,-435.665284,39.433861,867.439515,828.005654,1.336696,87.993799,86.657103,70.672966,213.348357,142.675391,0.01516,30.185326,30.170166,24.771164,169.669419,144.898255,0.73314,16.713738,15.980598,1.464875,62.379559,60.914684,67.355255,96.371935,29.01668,389.874333,629.680387,239.806054,0.203907,1.934451,1.730544,1.099355,10.886974,9.787619,4.234911,9.091382,4.856471,0.373652,9.619682,9.24603,0.031511,0.343815,0.312304,0.143961,5.236193,5.092232,1.089772,33.01442,31.924648,0.195311,8.46362,8.268309,1.013067,7.376003,6.362936,4.221386,36.017668,31.796282,712.658979,200.392941,-512.266038,,,,3.962431,34.417199,30.454768,60.445791,59.628777,-0.817014,44.457748,39.115694,-5.342054,1.07058,47.292084,46.221504,0.280028,35.827386,35.547358,1933.534628,1269.372683,-664.161945,2521.549755,1534.315482,-987.234273,47.221914,28.844015,-18.377899,22.206544,51.961286,29.754742,0.005857,3.77145,3.765593,926.858069,466.672168,-460.185901,488.666653,699.345013,210.67836,165.947068,55.788786,-110.158282,718.053234,1495.212932,777.159698,2908.428669,3591.085282,682.656613,10.495737,138.442961,127.947224,32.84287,151.95196,119.10909,343.261301,875.091275,531.829974,0,0.135919,0.135919,27.070144,50.301787,23.231643,914.29116,405.713494,-508.577666,0.008095,0,-0.008095,530.733793,316.279111,-214.454682,327.265356,215.081646,-112.18371,4.311924,0.140308,-4.171616,674.214725,186.287238,-487.927487,4420.720516,4550.735757,130.015241,2960.385788,667.799438,-2292.58635,2191.613655,3755.831386,1564.217731,1383.160437,2578.921582,1195.761145,44.725047,66.136819,21.411772,0.012555,0.584471,0.571916,2.607479,3.205079,0.5976,3438.616986,2646.31874,-792.298246,8462.628813,4246.623053,-4216.00576,776.473539,647.007365,-129.466174,,,,329.45936,147.790468,-181.668892,128.000229,31.587185,-96.413044,304.619385,131.505935,-173.11345,21.99957,2.173637,-19.825933,2002.583732,2821.663591,819.079859,39.671713,14.509317,-25.162396,20.325074,40.951084,20.62601,52.614097,61.802395,9.188298,374.909165,247.004318,-127.904847,,,,2905.853859,816.662908,-2089.190951,21.42151,10.358408,-11.063102,130.467437,157.5447,27.077263,8.725397,6.467612,-2.257785,0.441492,26.784547,26.343055,39.772019,34.261682,-5.510337,286.757273,110.477873,-176.2794,0.128292,18.099465,17.971173,2.784633,6.433919,3.649286,0.29547,4.072745,3.777275,20.452796,9.909921,-10.542875,0.722535,10.726097,10.003562,895.133648,862.868335,-32.265313,190.359204,79.064109,-111.295095,0.005933,300.102631,300.096698,19.282023,7.052976,-12.229047,0.573971,0.030275,-0.543696,0.024207,0.792089,0.767882,3201.208771,1441.632006,-1759.576765,,,,35.62623,15.826088,-19.800142,43.803825,14.821083,-28.982742,3.067185,1.020972,-2.046213,2.600603,4.164755,1.564152,,,,13.003697,6.374852,-6.628845,0.040889,3.861108,3.820219,0.894508,1.054846,0.160338,1.139804,6.532923,5.393119,89.983541,89.112857,-0.870683999999997,128.911703,46.368894,-82.542809,41.720996,17.462826,-24.25817,557.412734,1097.509905,540.097171,0.855903,10.025298,9.169395,1.23853,0.850195,-0.388335,6.141974,92.666758,86.524784,2407.897851,147.035768,-2260.862083,0.15326,29.769779,29.616519,845.8,724.8,-121,0,0,0,0.442844,0.057013,-0.385831,86.183776,146.089405,59.905629,728.542783,268.661528,-459.881255,,,,4619.074974,1630.494123,-2988.580851,101.39166,178.81954,77.42788,231.799364,2260.922735,2029.123371,0.0964,48.302093,48.205693,60.162357,144.791925,84.629568,54.661066,108.691993,54.030927,2.1807,113.713973,111.533273,3465.534194,1807.163676,-1658.370518,344.915235,136.460291,-208.454944,6.591791,1.860181,-4.73161,383.717011,48.499043,-335.217968,154.036342,19.979101,-134.057241,0,2.515018,2.515018,2305.494737,943.984608,-1361.510129,1763.88992,411.040821,-1352.849099,1.617095,5.163401,3.546306,189.454048,20.141392,-169.312656,2106.149193,1129.749302,-976.399891,1641.820048,2853.957032,1212.136984,1441.934116,695.822275,-746.111841,0,0.276836,0.276836,0.749853,15.194604,14.444751,829.552069,790.033942,-39.5181269999999,10.090102,40.58461,30.494508,0.032602,0.479232,0.44663,0.553305,3.035643,2.482338,35949.359451,8478.117308,-27471.242143,0.123386,145.856834,145.733448,0,0,0,4817.088242,3644.477322,-1172.61092,581.370647,3132.652224,2551.281577,3515.631746,2349.132823,-1166.498923,11997.988382,5995.759705,-6002.228677,847.708701,2784.211913,1936.503212,0,0.004749,0.004749,0.373491,0.253562,-0.119929,0.000593,0.737572,0.736979,0,0.019494,0.019494,4.351523,8.379615,4.028092,364.534624,269.291441,-95.243183,0.144669,0.756834,0.612165,0.64766,0.234174,-0.413486,0.013453,0.014355,0.000902,0.275249,3.118849,2.8436,0.025451,0.24575,0.220299,0.225523,13.526372,13.300849,0,0,0,0.041524,0.639155,0.597631,0.047006,0.055517,0.008511,4.575884,5.87229,1.296406,0,0.071399,0.071399,7.563489,8.876519,1.31303,1.367131,23.214095,21.846964,0.098624,3.052094,2.95347,0.0114,1.244539,1.233139,0.061935,0.019383,-0.042552,15.678607,3.796597,-11.88201,0.209328,1.151328,0.942,57.948855,272.104849,214.155994,688.546412,116.48203,-572.064382,82.001919,24.415306,-57.586613,0.011478,25.209571,25.198093,313.196922,446.685789,133.488867,0,0,0,0.000005,0.62416,0.624155,0,0,0,153.427788,17.48158,-135.946208,0.060186,37.876734,37.816548,11.068756,15.659664,4.590908,7.120421,8.155687,1.035266,0.029029,3.335728,3.306699,9.869929,9.305882,-0.564047,0.447229,6.065458,5.618229,43.817372,12.580604,-31.236768,39.821634,91.981228,52.159594,0.037329,2.647009,2.60968,0.185578,3.65517,3.469592,0.085361,7.105563,7.020202,1788.977016,423.415571,-1365.561445,0.538036,0.372402,-0.165634,111.289634,17.69208,-93.597554,179.442194,3.137397,-176.304797,0.185557,0,-0.185557,0.451985,3.470931,3.018946,0.068169,48.473702,48.405533,1399.08847,128.38473,-1270.70374,122.503438,20.082996,-102.420442,0.000983,0.229538,0.228555,0.260016,0.7825,0.522484,0.000173,0.068211,0.068038,29.351038,27.019146,-2.331892,2.554175,13.050155,10.49598,0.134797,2.936614,2.801817,0.369668,1.063581,0.693913,0.212642,0.74735,0.534708,11.130811,13.805783,2.674972,0.067779,0.893188,0.825409,0.871664,10.903707,10.032043,1.223258,10.056012,8.832754,26.311509,29.687029,3.37552,0.209297,0.588277,0.37898,0.989657,0.048818,-0.940839,4.808878,14.844379,10.035501,23.708515,3.768824,-19.939691,2.375011,26.847689,24.472678,9.873783,6.6448,-3.228983,0,0.164343,0.164343,0,0,0,0.000113,0.788734,0.788621,0,0.15129,0.15129,775.774416,589.394794,-186.379622,30.738466,13.822549,-16.915917,25.087559,3.956229,-21.13133,4.296598,9.337225,5.040627,3.040564,2.077371,-0.963193,0.991325,4.999485,4.00816,2.785769,14.710592,11.924823,19.175284,0.037513,-19.137771,0,0,0,,,
2012-07-01,14737.982181,6366.172357,-8371.809824,33343.965486,20608.113031,-12735.852455,187644.617534558,128698.009426389,-58946.6081081695,13735.805536,0,-13735.805536,12839.471181,8058.266332,-4781.204849,33016.680041,24588.198903,-8428.481138,10910.83609,10167.293916,-743.542174,13663.092885,14266.274729,603.181843999995,47499.968105,40314.582845,-7185.38526,39540.191494,25720.54148,-13819.650014,4953.153633,2453.206151,-2499.947482,67320.258901,29726.092785,-37594.166116,192838.67408,121408.136228,-71430.5378520001,86041.554526,35540.087166,-50501.46736,2660.184702,2320.851211,-339.333490999999,1140.552813,3112.164736,1971.611923,3576.54527,1719.67302,-1856.87225,0.160624,1.275001,1.114377,24973.683714,22774.697237,-2198.986477,0,0.00412,0.00412,22526.284391,17539.885608,-4986.398783,402.767316,494.892652,92.125336,10.719134,16.34098,5.621846,214.504528,187.419668,-27.08486,439.604039,441.164427,1.56038799999999,224.971136,82.942003,-142.029133,980.08101,547.770735,-432.310275,43.740177,680.790998,637.050821,20.540034,62.779085,42.239051,39.14509,320.170342,281.025252,0,22.478168,22.478168,35.218377,165.724872,130.506495,0.465084,14.933652,14.468568,0.907937,45.621894,44.713957,72.178041,67.009358,-5.16868299999999,398.256673,566.661726,168.405053,0.1986,1.733713,1.535113,1.012256,10.864124,9.851868,4.968209,7.090077,2.121868,0.51197,8.414944,7.902974,0.381097,0.419988,0.038891,0.135072,4.070534,3.935462,1.276972,10.048267,8.771295,0.244522,10.650786,10.406264,0.60502,5.483099,4.878079,4.864546,28.665239,23.800693,750.006541,198.426116,-551.580425,,,,2.955047,31.801893,28.846846,128.29009,59.041696,-69.248394,1.583107,59.764426,58.181319,1.280479,32.750747,31.470268,2.447727,16.572489,14.124762,1800.171233,1212.348543,-587.82269,2787.202535,1374.290439,-1412.912096,47.630099,19.720547,-27.909552,24.278302,49.437948,25.159646,0.007901,2.995017,2.987116,697.643629,484.139516,-213.504113,599.28751,831.726142,232.438632,136.122214,61.488676,-74.633538,753.847644,1464.281847,710.434203,2659.192783,3472.399137,813.206354,11.430274,134.261749,122.831475,30.678776,112.130924,81.452148,331.740146,844.52534,512.785194,0.000008,0.030206,0.030198,19.160242,44.55661,25.396368,845.787326,372.906531,-472.880795,0,0,0,438.147944,278.795514,-159.35243,415.031001,161.734293,-253.296708,5.064632,0.087031,-4.977601,728.325603,147.653908,-580.671695,4606.344657,4423.224508,-183.120148999999,3044.207573,420.330354,-2623.877219,1690.984149,3176.602861,1485.618712,1519.377279,2217.666024,698.288745,40.522434,85.019247,44.496813,0.014171,0.271752,0.257581,72.202703,1.35014,-70.852563,3749.246061,2463.236115,-1286.009946,9115.972448,3628.828807,-5487.143641,772.99867,480.931392,-292.067278,,,,335.098429,133.618932,-201.479497,211.583494,15.186219,-196.397275,275.138633,107.91333,-167.225303,25.810996,1.246649,-24.564347,1995.754289,1815.487114,-180.267175,47.810499,20.6607,-27.149799,19.587634,36.474495,16.886861,116.635485,55.569511,-61.065974,412.190111,249.484952,-162.705159,,,,2635.692986,874.61959,-1761.073396,3.900394,6.019756,2.119362,132.568379,130.775579,-1.7928,7.764477,4.020329,-3.744148,71.526796,113.265022,41.738226,11.261756,45.831334,34.569578,191.062034,60.096217,-130.965817,0.631961,5.182442,4.550481,2.315233,2.245796,-0.0694370000000002,0.000828,1.878822,1.877994,4.422451,5.553616,1.131165,0.241266,28.23018,27.988914,1159.082953,777.506407,-381.576546,200.758735,62.64296,-138.115775,0.010055,561.504361,561.494306,15.185632,4.574396,-10.611236,0.849451,0.241056,-0.608395,0.005632,0.136815,0.131183,3726.434975,1312.157652,-2414.277323,,,,41.536292,37.085156,-4.45113600000001,54.15864,62.930923,8.772283,9.540343,0.902741,-8.637602,18.38297,0.973505,-17.409465,,,,14.623192,7.49501,-7.128182,0.005425,1.509994,1.504569,0.265393,0.915107,0.649714,0.471559,3.930584,3.459025,75.811633,52.517067,-23.294566,127.329534,108.36628,-18.963254,36.977456,19.457278,-17.520178,492.992158,1078.220627,585.228469,1.384442,10.917889,9.533447,1.564787,0.682696,-0.882091,5.052705,80.803203,75.750498,1352.844132,155.058037,-1197.786095,0.231153,16.161018,15.929865,930.1,568.1,-362,0.000033,0.012048,0.012015,0.25603,0.133717,-0.122313,114.617138,136.18055,21.563412,1257.230184,232.576019,-1024.654165,,,,5437.914958,1499.396672,-3938.518286,97.899579,155.754866,57.855287,145.173638,1828.082177,1682.908539,0.133406,19.949198,19.815792,56.807593,107.006453,50.19886,64.805794,88.710722,23.904928,2.991464,109.883985,106.892521,4140.330457,1775.008033,-2365.322424,342.913149,117.763615,-225.149534,5.71345,2.395549,-3.317901,464.128364,37.285963,-426.842401,191.961762,17.479921,-174.481841,0,1.364674,1.364674,2162.591073,817.510035,-1345.081038,1942.728644,408.777541,-1533.951103,2.077996,1.438563,-0.639433,254.526772,16.117882,-238.40889,2336.18244,1090.027126,-1246.155314,1559.931597,2242.25752,682.325923,1638.70933,603.222248,-1035.487082,0,0.057739,0.057739,0.482656,11.403415,10.920759,898.996193,674.837557,-224.158636,8.246494,36.73013,28.483636,0.112331,0.097205,-0.015126,0.388889,2.633235,2.244346,37930.755206,8515.095501,-29415.659705,0.336362,100.523639,100.187277,0,1.531869,1.531869,5397.836239,3533.791208,-1864.045031,468.880374,2385.414305,1916.533931,3484.18788,2005.830883,-1478.356997,12490.183476,5572.831982,-6917.351494,769.389089,2814.378836,2044.989747,0,0.003492,0.003492,0.014049,0.246463,0.232414,0.028506,0.00104,-0.027466,0,0.11927,0.11927,5.221945,14.372273,9.150328,331.255982,225.899801,-105.356181,0.021003,0.488691,0.467688,0.5025,2.449332,1.946832,0.02468,0.044815,0.020135,0.2537,2.422989,2.169289,0.08799,0.392128,0.304138,0.119387,4.051813,3.932426,0.000048,0,-0.000048,0.030592,0.388417,0.357825,0.000583,0.033599,0.033016,8.210786,4.289634,-3.921152,0.001884,0.066808,0.064924,3.411686,14.093816,10.68213,1.570148,17.702793,16.132645,0.033682,4.17358,4.139898,0,1.283005,1.283005,0.043684,0.113721,0.070037,20.177767,4.111839,-16.065928,0.155178,1.198343,1.043165,65.60664,105.234394,39.627754,507.678961,111.235638,-396.443323,104.197339,29.75326,-74.444079,5.94418,22.041037,16.096857,231.793975,451.441049,219.647074,0,0,0,0.004073,0.536566,0.532493,0,0,0,61.699255,11.377568,-50.321687,0.076911,33.517737,33.440826,42.816479,13.244285,-29.572194,1.194998,10.959345,9.764347,0.101601,1.929427,1.827826,7.396552,11.140279,3.743727,2.821232,15.906928,13.085696,48.112386,17.789188,-30.323198,28.907213,88.885288,59.978075,0.008926,1.686431,1.677505,0.191558,2.681762,2.490204,1.170232,20.844732,19.6745,1176.5176,392.641877,-783.875723,0.220927,0.318625,0.097698,232.165839,44.204625,-187.961214,131.185143,1.175459,-130.009684,0.153313,0.000938,-0.152375,0.31673,5.4276,5.11087,1.271877,37.314567,36.04269,812.625159,82.223897,-730.401262,80.310604,13.111403,-67.199201,0.051353,0.336874,0.285521,0.156154,0.83753,0.681376,0.025715,0.038461,0.012746,1.02461,13.541418,12.516808,1.092864,68.37715,67.284286,0.051337,3.152085,3.100748,0.642599,5.591066,4.948467,0.064535,0.850077,0.785542,8.823264,6.822584,-2.00068,0.011751,0.149091,0.13734,0.888595,5.433032,4.544437,4.01019,5.458829,1.448639,41.771472,49.474537,7.703065,0.28468,0.219873,-0.064807,1.564351,0.291944,-1.272407,11.132139,17.710558,6.578419,19.161917,3.168018,-15.993899,4.732621,37.352615,32.619994,7.895914,4.780612,-3.115302,0.001547,0.637753,0.636206,0.00002,0.000056,0.000036,0.587926,0.631525,0.0435990000000001,0.000001,0.089483,0.089482,757.408847,588.178539,-169.230308,9.976946,48.301465,38.324519,11.608591,1.507006,-10.101585,3.27684,22.1276,18.85076,8.582935,1.618896,-6.964039,0.864815,6.641923,5.777108,7.676611,4.608848,-3.067763,36.97522,0.02999,-36.94523,0,0,0,,,
2012-08-01,14752.0634,6635.146907,-8116.916493,33040.791772,21479.159136,-11561.632636,187209.20583508,127030.178721824,-60179.0271132565,14691.256626,0,-14691.256626,14485.693103,8803.630812,-5682.062291,32320.72593,25600.753022,-6719.972908,10203.18314,10140.802599,-62.3805410000004,15208.197051,15531.118517,322.921466,50791.384085,44054.670433,-6736.71365199999,38736.300773,26132.124429,-12604.176344,5556.625943,2707.892445,-2848.733498,66226.418027,30677.383541,-35549.034486,194941.530944,128583.019076,-66358.5118679999,83514.159265,37123.601708,-46390.557557,2706.927028,2388.252377,-318.674651,1134.618329,3032.906193,1898.287864,3729.902953,1860.036416,-1869.866537,0.245498,0.670981,0.425483,27027.583682,24835.647615,-2191.936067,0,0.03437,0.03437,23763.800403,19219.022818,-4544.777585,390.391172,392.649572,2.25839999999999,10.745965,17.031934,6.285969,242.53791,222.276533,-20.261377,432.8475,494.515277,61.667777,250.113413,75.303763,-174.80965,1013.097157,560.660746,-452.436411,33.236298,799.951151,766.714853,3.746533,31.589678,27.843145,54.323666,221.167128,166.843462,0,37.869923,37.869923,50.434033,135.325193,84.89116,0.592378,20.083175,19.490797,1.143303,57.262698,56.119395,71.720165,96.781645,25.06148,377.939876,642.846486,264.90661,0.426335,2.100642,1.674307,0.566752,9.140043,8.573291,4.273847,8.416888,4.143041,0.603573,10.882282,10.278709,0.176152,0.84718,0.671028,0.351494,7.205332,6.853838,1.569946,12.707407,11.137461,0.111449,7.39458,7.283131,0.652888,3.947055,3.294167,4.660821,41.928492,37.267671,705.093957,187.13365,-517.960307,,,,1.518581,40.802844,39.284263,38.111662,43.421068,5.309406,1.66308,32.775108,31.112028,1.127648,36.530529,35.402881,1.496248,28.547303,27.051055,2120.651265,1387.185721,-733.465544,3646.327647,1459.179525,-2187.148122,39.971309,28.500509,-11.4708,27.183786,41.418207,14.234421,0,1.22575,1.22575,799.153966,620.922849,-178.231117,531.278752,843.856463,312.577711,153.285201,54.157133,-99.128068,671.605276,1699.701966,1028.09669,3059.825408,3957.695864,897.870456,20.085946,128.933743,108.847797,25.890852,113.833184,87.942332,415.998101,915.344107,499.346006,1.66574,0.068191,-1.597549,17.628963,21.491667,3.862704,688.183187,448.355577,-239.82761,0,0.001066,0.001066,545.890745,287.877759,-258.012986,439.566302,249.595305,-189.970997,4.790391,0.374559,-4.415832,574.72661,169.548329,-405.178281,4913.899673,4249.581702,-664.317970999999,2950.953237,547.758331,-2403.194906,1883.808831,3435.476743,1551.667912,1309.128299,2534.658404,1225.530105,52.676667,59.233247,6.55658,0.002965,0.06859,0.065625,1.59004,0.868475,-0.721565,3422.443562,2562.214855,-860.228707,9729.520506,4053.811701,-5675.708805,782.963422,380.644144,-402.319278,,,,326.700211,152.364455,-174.335756,175.444868,34.931254,-140.513614,267.728209,128.806933,-138.921276,20.603042,1.922505,-18.680537,1725.843779,2031.438472,305.594693,28.177514,14.104769,-14.072745,29.509788,36.500213,6.990425,130.754581,55.212865,-75.541716,389.50265,232.958431,-156.544219,,,,2136.214243,752.480342,-1383.733901,4.453636,7.219374,2.765738,128.577258,124.650679,-3.926579,10.033307,4.616887,-5.41642,240.084254,57.427943,-182.656311,24.988553,49.198532,24.209979,174.064831,47.233052,-126.831779,0.514606,5.99885,5.484244,2.819621,3.785772,0.966151,0.000939,3.404001,3.403062,3.332778,12.9695,9.636722,0.416483,13.040132,12.623649,1082.596526,733.40833,-349.188196,257.437692,65.887612,-191.55008,0.015964,363.008052,362.992088,22.646475,6.021572,-16.624903,0.246665,0.152964,-0.093701,0.015873,0.595916,0.580043,3227.738117,1196.416727,-2031.32139,,,,40.44188,34.718897,-5.722983,43.949121,11.309813,-32.639308,4.600573,0.595277,-4.005296,8.72632,1.498901,-7.227419,,,,14.361337,12.352406,-2.008931,0.010405,1.942647,1.932242,0.396247,0.868122,0.471875,1.522859,4.51136,2.988501,85.230574,46.878917,-38.351657,154.103895,46.19839,-107.905505,68.221532,16.9701,-51.251432,583.320444,806.652594,223.33215,3.179723,10.310417,7.130694,3.242417,0.187012,-3.055405,9.516476,68.691896,59.17542,1384.845355,152.403098,-1232.442257,0.53825,24.851006,24.312756,821,580.9,-240.1,0,0.01837,0.01837,0.376286,0.272296,-0.10399,112.264452,207.748913,95.484461,895.044123,183.964811,-711.079312,,,,4199.826666,1333.669458,-2866.157208,47.250876,334.072054,286.821178,191.469916,1722.344016,1530.8741,0.398559,77.172568,76.774009,205.539394,137.79735,-67.742044,46.344797,94.947511,48.602714,2.048013,113.141598,111.093585,3922.689032,2082.695978,-1839.993054,360.224029,120.261392,-239.962637,8.14804,1.399948,-6.748092,448.767303,51.718847,-397.048456,185.719295,18.359689,-167.359606,0,3.511334,3.511334,2290.749942,1135.270049,-1155.479893,1814.303309,398.203479,-1416.09983,4.869695,3.443764,-1.425931,236.865226,23.174056,-213.69117,2241.540937,1199.783788,-1041.757149,1783.880567,2680.648971,896.768404,1596.785741,760.727875,-836.057866,0,0.199702,0.199702,1.049585,8.134889,7.085304,832.81247,679.93147,-152.881,7.874531,26.949491,19.07496,0.037294,0.14999,0.112696,0.561221,2.28151,1.720289,37280.629144,8613.335319,-28667.293825,0.42811,66.925208,66.497098,0,3.492725,3.492725,4781.063165,3163.968423,-1617.094742,305.983464,2385.765568,2079.782104,3332.255944,1910.419637,-1421.836307,12957.727896,6266.207694,-6691.520202,839.211564,2649.606978,1810.395414,0,0,0,0.064315,0.032701,-0.031614,0.024216,0,-0.024216,0,0,0,6.482834,13.372759,6.889925,259.120185,318.530679,59.410494,0.080715,0.336705,0.25599,0.359949,0.277577,-0.082372,0.025816,0,-0.025816,0.057189,2.818442,2.761253,0.059513,0.267668,0.208155,0.083054,0.317642,0.234588,0.000076,0,-0.000076,0.05704,1.194615,1.137575,0.004669,0.017299,0.01263,4.151976,6.872826,2.72085,0,0.034487,0.034487,3.180267,10.021486,6.841219,1.672073,16.47056,14.798487,0.031508,3.709396,3.677888,0.28116,1.296195,1.015035,0.081367,1.469384,1.388017,19.380866,4.321906,-15.05896,0.20871,1.835254,1.626544,81.136596,138.892146,57.75555,1131.154084,122.713393,-1008.440691,28.406651,32.500703,4.094052,4.916949,24.528767,19.611818,320.90825,518.379486,197.471236,0.952848,1.120427,0.167579,0.000862,4.053777,4.052915,0,0,0,83.57119,31.913623,-51.657567,0.016304,9.604568,9.588264,10.487898,28.121216,17.633318,0.502294,8.160741,7.658447,0.500662,8.494011,7.993349,7.518878,6.226828,-1.29205,1.188139,8.993397,7.805258,34.89625,12.876887,-22.019363,44.011652,121.534053,77.522401,0.13062,2.913218,2.782598,0.601442,3.108625,2.507183,39.286528,8.584416,-30.702112,1566.739055,471.315864,-1095.423191,0.110936,0.901952,0.791016,214.131861,19.954985,-194.176876,145.493485,1.838896,-143.654589,0.589711,0.002589,-0.587122,0.25724,3.461692,3.204452,0.114591,42.518705,42.404114,626.252531,176.009449,-450.243082,118.809238,21.84332,-96.965918,0.002611,0.814703,0.812092,0.056805,0.730206,0.673401,0.043528,0.01873,-0.024798,0.569067,23.43795,22.868883,7.358019,8.124342,0.766323000000001,0.006273,1.206621,1.200348,0.160836,2.134206,1.97337,0.052271,0.035726,-0.016545,15.573812,18.714312,3.1405,0.011024,0.368296,0.357272,0.581787,10.403243,9.821456,1.887812,4.626828,2.739016,44.700987,47.667222,2.966235,0.455475,6.617475,6.162,0.823308,0.361148,-0.46216,4.686412,23.635289,18.948877,32.14582,3.257189,-28.888631,1.77938,29.157929,27.378549,8.710091,3.378966,-5.331125,0,1.201719,1.201719,0.134595,0.021439,-0.113156,0.238407,0.503678,0.265271,0,0.15784,0.15784,641.744881,520.232146,-121.512735,7.73322,14.797743,7.064523,22.820446,2.117924,-20.702522,4.091367,7.464971,3.373604,9.093762,2.72351,-6.370252,1.18022,2.870052,1.689832,6.658088,7.754799,1.096711,26.844955,2.137917,-24.707038,0,0,0,,,
2012-09-01,14172.377432,6980.737743,-7191.639689,29522.720352,21338.132203,-8184.588149,188747.894052944,132192.632294396,-56555.2617585479,13371.032153,0,-13371.032153,14049.477711,8019.979716,-6029.497995,32931.647249,25815.18925,-7116.457999,10446.567192,10833.85439,387.287198,14021.479147,16132.896277,2111.41713,48203.067401,41605.23654,-6597.830861,35693.628079,26654.785352,-9038.84272699999,5652.087134,3185.506961,-2466.580173,64747.543822,30986.916067,-33760.627755,185682.751364,128259.972496,-57422.7788679999,81171.402709,37704.824613,-43466.578096,2571.546607,2411.344556,-160.202051,939.949007,2976.264149,2036.315142,4280.271884,2385.806901,-1894.464983,1.137887,0.458604,-0.679283,26051.973341,24147.866076,-1904.107265,0,0,0,22151.09406,17457.370464,-4693.723596,343.479466,474.004044,130.524578,11.681497,18.429203,6.747706,225.232681,287.459438,62.226757,415.729732,455.173339,39.443607,229.999391,95.464706,-134.534685,984.509044,553.647482,-430.861562,32.728967,759.490929,726.761962,41.960127,49.066188,7.106061,27.559051,251.585878,224.026827,0,20.188874,20.188874,41.915989,168.09914,126.183151,1.997013,12.933654,10.936641,1.300224,57.800727,56.500503,68.224878,93.338962,25.114084,372.596293,545.595547,172.999254,0.576528,2.202341,1.625813,0.692096,9.621869,8.929773,4.633238,9.544272,4.911034,1.92605,12.57025,10.6442,0.112975,0.304156,0.191181,0.126527,4.416742,4.290215,1.124734,49.431756,48.307022,0.134249,8.488474,8.354225,0.533972,4.932294,4.398322,4.403335,36.318452,31.915117,666.954917,198.626923,-468.327994,,,,1.257256,30.329794,29.072538,70.008342,32.7193,-37.289042,1.211911,56.551171,55.33926,1.488084,48.635721,47.147637,0.539106,31.799577,31.260471,2065.734944,1672.398172,-393.336772,3156.823041,1974.298568,-1182.524473,46.375503,34.485826,-11.889677,19.695647,38.277996,18.582349,0.003286,1.378429,1.375143,920.584014,567.174473,-353.409541,559.659815,752.672146,193.012331,157.234534,52.569168,-104.665366,654.186019,1422.259481,768.073462,2395.806312,3920.345488,1524.539176,23.490722,156.731621,133.240899,33.259519,123.650097,90.390578,433.984474,1037.414651,603.430177,0.003644,0.468958,0.465314,20.449119,57.025675,36.576556,753.230411,472.019884,-281.210527,0,0,0,509.033816,333.131472,-175.902344,372.302974,197.976643,-174.326331,8.450098,0.535203,-7.914895,540.062793,163.247739,-376.815054,4222.842172,4556.989959,334.147787000001,2248.789657,562.00454,-1686.785117,1906.58216,3127.643057,1221.060897,1270.409154,2261.404863,990.995709,37.290969,258.139358,220.848389,0.009711,0.134748,0.125037,2.840028,1.412245,-1.427783,3169.494685,2504.640003,-664.854682,8951.315769,4156.534752,-4794.781017,758.526843,226.41355,-532.113293,,,,341.307192,154.221941,-187.085251,163.829258,20.292312,-143.536946,256.95599,131.829173,-125.126817,21.48989,1.704219,-19.785671,2034.48322,2073.166158,38.6829379999999,38.447198,23.569009,-14.878189,20.973051,39.644626,18.671575,86.669507,62.325897,-24.34361,347.082257,229.237474,-117.844783,,,,2611.567804,759.871733,-1851.696071,12.473055,7.487305,-4.98575,200.532577,98.579869,-101.952708,6.421157,12.166691,5.745534,5.368981,80.718781,75.3498,30.737571,44.425349,13.687778,159.95943,75.398562,-84.560868,1.731448,7.840584,6.109136,2.136649,3.537476,1.400827,0.000792,2.332365,2.331573,29.673854,12.832562,-16.841292,19.324897,2.802706,-16.522191,879.366086,697.155098,-182.210988,237.253875,65.180135,-172.07374,0.204611,672.310897,672.106286,23.135208,5.443819,-17.691389,0.142426,0.026327,-0.116099,0.005649,0.741334,0.735685,2569.162965,1247.836206,-1321.326759,,,,53.643645,12.471456,-41.172189,39.965701,18.941455,-21.024246,4.112405,0.628487,-3.483918,2.683,2.680229,-0.00277099999999963,,,,7.0555,12.029277,4.973777,0.066026,1.416996,1.35097,0.080414,0.67749,0.597076,1.636579,3.554244,1.917665,55.283266,78.352735,23.069469,155.12704,45.011326,-110.115714,74.683656,20.077273,-54.606383,424.593375,1035.012709,610.419334,2.630515,11.999376,9.368861,1.556264,0.401554,-1.15471,5.626906,63.409451,57.782545,1612.536036,89.498231,-1523.037805,0.075662,12.972999,12.897337,817.9,576.6,-241.3,0,0.02362,0.02362,0.344919,0.030986,-0.313933,109.089364,110.2725,1.18313599999999,972.409438,238.825554,-733.583884,,,,4043.130836,1330.917214,-2712.213622,89.40868,154.459658,65.050978,186.406853,1983.112617,1796.705764,0.216673,43.266032,43.049359,157.837366,226.317313,68.479947,62.92331,97.714256,34.790946,1.285126,127.202617,125.917491,3332.655717,2243.092836,-1089.562881,296.152129,109.070647,-187.081482,7.281199,2.98469,-4.296509,385.613137,35.04547,-350.567667,171.795989,18.152935,-153.643054,0,4.663847,4.663847,2189.775222,932.869821,-1256.905401,1716.728081,342.867469,-1373.860612,2.361841,1.862321,-0.49952,251.360389,21.256032,-230.104357,2245.027722,946.195979,-1298.831743,1594.764081,2413.965674,819.201593,1404.474951,643.629583,-760.845368,0.003608,0.07864,0.075032,3.285525,11.076185,7.79066,862.7523,736.162738,-126.589562,7.23151,31.119646,23.888136,0.003825,0.024464,0.020639,2.0017,2.003321,0.00162100000000009,37891.823059,8804.20969,-29087.613369,4.875426,24.011573,19.136147,0,0,0,4725.055168,3420.957411,-1304.097757,949.539443,3130.618841,2181.079398,3177.2085,1868.312464,-1308.896036,10977.946723,6073.86105,-4904.085673,705.400597,2619.537676,1914.137079,0,0.286438,0.286438,0.016092,0.112616,0.096524,0.001873,0.077132,0.075259,0,0.003592,0.003592,4.9061,17.739679,12.833579,198.128143,269.529451,71.401308,0.092813,0.265412,0.172599,0.364831,0.624912,0.260081,0.013215,0.018541,0.005326,0.158533,1.549122,1.390589,0.007977,0.227314,0.219337,1.110808,15.994307,14.883499,0.000147,0,-0.000147,0.034387,0.474436,0.440049,0.014754,0.034434,0.01968,6.20391,7.618235,1.414325,0,0.061761,0.061761,8.664845,12.414163,3.749318,1.828962,17.977023,16.148061,0.020194,3.930308,3.910114,0.030037,1.22155,1.191513,0.006346,0.053708,0.047362,12.878845,4.537378,-8.341467,0.080057,1.538392,1.458335,107.867027,137.403947,29.53692,618.420858,53.116555,-565.304303,93.197073,33.307392,-59.889681,13.507677,17.074514,3.566837,243.065803,529.534453,286.46865,0.174844,21.33181,21.156966,0.00039,1.199858,1.199468,0,0,0,297.266256,18.655932,-278.610324,0.041899,10.126452,10.084553,8.471768,20.059513,11.587745,1.191086,9.846714,8.655628,0.238885,1.745796,1.506911,5.146819,20.633163,15.486344,1.511098,7.357936,5.846838,54.839745,11.600073,-43.239672,18.763319,99.839159,81.07584,0.055646,3.66592,3.610274,1.382968,3.872838,2.48987,0.227094,25.587334,25.36024,1614.025986,439.038821,-1174.987165,0.938927,0.03983,-0.899097,267.636709,32.126332,-235.510377,231.456524,2.567937,-228.888587,0.125676,0,-0.125676,0.14559,1.517695,1.372105,0.099739,40.235739,40.136,651.061737,92.858953,-558.202784,130.58266,17.649411,-112.933249,0.000479,0.083565,0.083086,0.011349,0.66105,0.649701,0.026299,0.257723,0.231424,24.304158,10.179441,-14.124717,0.942953,16.026644,15.083691,0.070435,0.340174,0.269739,2.416255,1.62625,-0.790005,0.003112,0.939321,0.936209,9.412382,5.283154,-4.129228,0.005702,0.169432,0.16373,0.493862,15.105342,14.61148,2.069158,6.261646,4.192488,32.073173,46.879084,14.805911,0.29252,1.09848,0.80596,0.645842,0.149194,-0.496648,7.365865,22.302436,14.936571,17.555611,3.793751,-13.76186,1.168201,18.689919,17.521718,9.293201,6.324522,-2.968679,0,1.209181,1.209181,0.010327,0.108211,0.097884,0.998677,0.944669,-0.0540080000000001,0.000003,0.072076,0.072073,789.410436,1109.138334,319.727898,27.553929,8.050511,-19.503418,16.573096,4.357818,-12.215278,0.905376,15.115799,14.210423,7.81813,2.485674,-5.332456,4.732792,2.180545,-2.552247,4.528048,4.034504,-0.493544,31.569921,0.081772,-31.488149,0,0,0,,,
2012-10-01,15226.439223,6725.124265,-8501.314958,32520.757677,21685.660767,-10835.09691,185822.273399372,126280.540738899,-59541.7326604735,15143.918777,0,-15143.918777,15135.301321,8639.025561,-6496.27576,36059.111641,26109.419897,-9949.691744,11020.793436,10411.513369,-609.280067,13445.43107,16044.553977,2599.122907,52478.936499,46132.744974,-6346.191525,39003.382172,26847.672032,-12155.71014,6185.549559,2835.781613,-3349.767946,69705.297374,32335.582688,-37369.714686,198767.110658,133718.21598,-65048.8946779999,86610.150026,38809.729027,-47800.420999,2534.910984,2517.92392,-16.9870639999999,1042.69828,2959.091368,1916.393088,4875.578392,2079.610665,-2795.967727,0.963052,0.489226,-0.473826,27661.292052,25678.93677,-1982.355282,0,0.03083,0.03083,24817.644447,20453.808204,-4363.836243,362.251469,396.155679,33.90421,12.256532,18.164969,5.908437,210.249946,254.638296,44.38835,377.443934,553.29487,175.850936,254.934119,97.541811,-157.392308,954.798307,659.70137,-295.096937,111.122875,892.124669,781.001794,1.510695,50.916842,49.406147,26.772971,311.688154,284.915183,0,48.151065,48.151065,54.778657,187.283508,132.504851,0.18503,14.439805,14.254775,0.832181,60.306978,59.474797,71.451809,104.519767,33.067958,375.233209,556.591894,181.358685,0.200873,2.773528,2.572655,0.960491,10.997205,10.036714,4.680155,11.858299,7.178144,0.534165,17.450914,16.916749,0.064361,1.556144,1.491783,0.149148,6.628851,6.479703,1.25793,16.777935,15.520005,0.316373,6.956139,6.639766,0.300699,7.614721,7.314022,4.333424,48.105038,43.771614,560.819353,229.478689,-331.340664,,,,3.553238,66.170799,62.617561,69.195504,30.710612,-38.484892,3.24484,82.37919,79.13435,1.401536,50.645887,49.244351,0.52756,31.71843,31.19087,1988.88467,1399.607222,-589.277448,3216.842762,1462.538656,-1754.304106,45.486068,31.937952,-13.548116,20.985943,42.983309,21.997366,0.005621,4.04314,4.037519,617.866858,577.787094,-40.079764,551.80425,829.947158,278.142908,190.45056,71.872807,-118.577753,648.921487,1712.139684,1063.218197,2299.771085,4142.622136,1842.851051,24.621808,124.779896,100.158088,30.136743,96.430459,66.293716,343.681809,720.505888,376.824079,0.610022,0.016518,-0.593504,23.542957,25.998987,2.45603,804.348097,445.954432,-358.393665,0.000157,0.044732,0.044575,452.089739,332.65098,-119.438759,384.266176,182.502361,-201.763815,7.277141,0.119695,-7.157446,520.34308,183.303423,-337.039657,4863.851389,4358.555369,-505.296020000001,2495.195762,663.723724,-1831.472038,1598.458719,3418.126576,1819.667857,1534.88577,2377.04091,842.15514,92.212089,56.678291,-35.533798,0.030863,0.1134,0.082537,3.06214,1.454277,-1.607863,3669.742019,2491.92001,-1177.822009,9664.652051,4116.757551,-5547.8945,782.957968,185.825659,-597.132309,,,,307.42414,148.89948,-158.52466,183.795612,40.259376,-143.536236,285.503623,153.206708,-132.296915,24.100126,2.184409,-21.915717,2217.434661,2152.789786,-64.644875,38.490369,21.085561,-17.404808,22.867546,39.457429,16.589883,119.277012,82.185392,-37.09162,405.643134,329.861625,-75.781509,,,,2879.304772,894.123057,-1985.181715,39.314561,11.061346,-28.253215,93.003851,95.667289,2.663438,8.894719,3.642657,-5.252062,20.591029,19.863572,-0.727456999999998,26.444667,32.662307,6.21764,93.173655,70.979076,-22.194579,1.294894,11.328349,10.033455,1.709697,2.415798,0.706101,0.001462,4.266352,4.26489,1.746629,10.417988,8.671359,0.322925,2.957109,2.634184,1053.409275,894.035397,-159.373878,244.522701,166.619277,-77.903424,0.011118,636.353957,636.342839,19.229157,29.512301,10.283144,0.267905,0.152759,-0.115146,0.124937,0.272503,0.147566,3114.722362,1140.568624,-1974.153738,,,,32.258942,24.659862,-7.59908,48.160081,22.904256,-25.255825,3.219537,2.268532,-0.951005,3.161515,1.478301,-1.683214,,,,13.123589,8.304177,-4.819412,0.007118,3.125467,3.118349,0.086128,1.163571,1.077443,1.443035,5.777256,4.334221,70.741688,55.433343,-15.308345,149.566703,51.223062,-98.343641,43.328401,16.030942,-27.297459,535.580026,803.713714,268.133688,3.162753,13.989688,10.826935,1.078916,0.445067,-0.633849,7.999261,126.37541,118.376149,2166.787455,138.359542,-2028.427913,0.638345,12.745653,12.107308,898.9,548.2,-350.7,0.005768,0.01184,0.006072,0.45459,0.07313,-0.38146,97.086432,146.44183,49.355398,1203.382526,208.800098,-994.582428,,,,3806.273134,1380.582147,-2425.690987,92.785369,430.265019,337.47965,167.182343,1772.653748,1605.471405,0.350027,26.332946,25.982919,92.982869,138.812681,45.829812,81.196859,110.239572,29.042713,16.504796,110.240367,93.735571,3266.079245,2084.704602,-1181.374643,278.595842,123.457433,-155.138409,9.303315,2.471694,-6.831621,348.326185,32.273017,-316.053168,175.182452,21.526104,-153.656348,0,4.199162,4.199162,2252.09596,1030.713129,-1221.382831,1921.235765,372.592787,-1548.642978,1.565271,1.244117,-0.321154,278.647421,17.889419,-260.758002,2356.111932,1082.247066,-1273.864866,1981.504239,2432.432146,450.927907,1547.721049,772.085104,-775.635945,0,0.034979,0.034979,0.618591,11.577356,10.958765,818.552965,627.83688,-190.716085,7.475407,30.211722,22.736315,0.000895,0.124747,0.123852,1.77474,2.307467,0.532727,40257.083524,10824.431396,-29432.652128,0.327161,32.588117,32.260956,0,0.01,0.01,5050.75189,3461.894053,-1588.857837,489.103799,2425.94299,1936.839191,3499.433508,2091.24418,-1408.189328,12684.05069,5675.169129,-7008.881561,811.214361,2624.818635,1813.604274,0.000867,0.004036,0.003169,0.084711,0,-0.084711,0.010073,0.859938,0.849865,0,0,0,8.848098,15.808593,6.960495,192.827321,259.883438,67.056117,0.12048,1.413697,1.293217,0.555043,0.341637,-0.213406,0.019681,0.050332,0.030651,0.120907,2.498537,2.37763,1.010693,0.499746,-0.510947,0.219076,1.358487,1.139411,0.000748,0,-0.000748,0.063092,0.064024,0.000932000000000002,0.00025,0.121958,0.121708,4.824369,6.093541,1.269172,0,0.042034,0.042034,4.927698,15.517235,10.589537,2.616558,10.102735,7.486177,0.014452,9.635268,9.620816,0.002001,1.783225,1.781224,0.00052,0.037195,0.036675,15.026539,6.206406,-8.820133,0.188412,1.984587,1.796175,60.788548,110.473256,49.684708,701.485845,74.603066,-626.882779,38.53341,62.40135,23.86794,26.739958,8.609282,-18.130676,227.426844,422.60975,195.182906,0.293919,15.953792,15.659873,0.002759,1.444833,1.442074,0,0,0,243.69545,26.855931,-216.839519,0.034126,23.887516,23.85339,48.590868,21.544551,-27.046317,0.410476,11.511127,11.100651,0.544697,4.171294,3.626597,14.357203,9.610496,-4.746707,0.957382,9.631481,8.674099,66.046325,18.101196,-47.945129,17.320951,122.699297,105.378346,0.0496,1.031543,0.981943,0.217228,1.696494,1.479266,8.058153,59.191153,51.133,2219.31689,470.473435,-1748.843455,0.292544,0.425781,0.133237,288.861422,19.133867,-269.727555,235.173602,4.176461,-230.997141,0.069887,0,-0.069887,0.413597,3.578836,3.165239,0.219423,50.198502,49.979079,754.436402,118.747168,-635.689234,46.52045,16.911082,-29.609368,0.003131,0.130878,0.127747,0.061257,0.457655,0.396398,0.078334,0.036704,-0.04163,0.674507,24.080942,23.406435,2.428609,8.093706,5.665097,0.784874,0.68611,-0.098764,1.959264,3.107068,1.147804,0.080183,0.41843,0.338247,9.731538,39.135295,29.403757,0.019315,1.075347,1.056032,1.241246,4.133534,2.892288,1.509963,7.026091,5.516128,42.715277,24.695419,-18.019858,0.292235,0.745454,0.453219,1.859203,0.290459,-1.568744,5.053758,28.984503,23.930745,34.13039,3.889332,-30.241058,5.019929,30.711822,25.691893,13.091978,5.722897,-7.369081,0.0055,0.606002,0.600502,0.019927,0.014878,-0.005049,0.362448,0.939166,0.576718,0.003688,0.23443,0.230742,724.910265,612.070756,-112.839509,19.718411,14.962803,-4.755608,17.154998,5.257426,-11.897572,17.390002,12.649677,-4.740325,6.674607,5.772495,-0.902112,2.025973,7.598571,5.572598,2.252068,1.528736,-0.723332,19.406762,0.057944,-19.348818,0,88.122933,88.122933,,,
2012-11-01,13954.340897,7339.051043,-6615.289854,33649.153387,21365.156608,-12283.996779,192148.259164916,128357.076580599,-63791.1825843175,15032.052318,0,-15032.052318,15120.534202,8199.270927,-6921.263275,37819.318777,26098.300055,-11721.018722,10134.767159,11163.190106,1028.422947,14037.282934,15576.966743,1539.683809,51483.134996,43443.534386,-8039.60061,39855.792236,26158.344089,-13697.448147,4689.23783,2657.69704,-2031.54079,66927.359772,32797.371585,-34129.988187,194553.224573,130204.374852,-64348.8497210001,83350.159654,39394.350821,-43955.808833,2485.885477,2356.816197,-129.06928,1136.95845,2939.596906,1802.638456,3634.707623,1893.36851,-1741.339113,0.658473,0.279834,-0.378639,27751.808795,24679.568411,-3072.240384,0,0,0,23731.326201,18763.965975,-4967.360226,316.550918,470.729628,154.17871,11.937327,21.861811,9.924484,186.219682,278.569805,92.350123,370.970453,402.542449,31.571996,214.366803,102.875754,-111.491049,1048.224846,545.105006,-503.11984,37.407455,810.417765,773.01031,6.255281,38.766879,32.511598,62.298576,347.999065,285.700489,0,43.930383,43.930383,57.756068,174.174092,116.418024,0.688671,21.457359,20.768688,1.023065,65.233251,64.210186,68.448327,70.760302,2.31197499999999,349.552775,556.993555,207.44078,0.198007,3.354124,3.156117,6.931534,22.94262,16.011086,4.585537,11.185424,6.599887,0.614686,14.701407,14.086721,0.023775,1.305228,1.281453,0.232861,5.756553,5.523692,1.091462,37.623549,36.532087,0.234399,6.965035,6.730636,0.393331,12.543595,12.150264,4.233911,47.190353,42.956442,528.607602,221.243484,-307.364118,,,,7.053278,92.834893,85.781615,61.259842,54.01262,-7.247222,9.396075,43.645479,34.249404,1.437804,51.198127,49.760323,4.779189,27.590004,22.810815,1935.721487,1475.069326,-460.652161,3564.250741,1539.023323,-2025.227418,42.202599,30.806101,-11.396498,19.094833,40.093498,20.998665,0,96.716778,96.716778,573.238208,562.581443,-10.656765,688.501471,770.183465,81.6819939999999,207.261673,70.463607,-136.798066,850.737303,1466.500087,615.762784,2301.817991,3828.274673,1526.456682,32.547591,156.802908,124.255317,28.974442,105.604949,76.630507,428.54416,829.24052,400.69636,1.616895,0.096466,-1.520429,36.701742,14.117882,-22.58386,879.47392,434.66061,-444.81331,0,0.034765,0.034765,598.549406,225.894533,-372.654873,443.456517,215.91232,-227.544197,7.327054,0.037284,-7.28977,513.186811,177.34542,-335.841391,4724.969727,4286.450415,-438.519311999999,2784.969314,472.759339,-2312.209975,1792.058072,3297.313457,1505.255385,1593.101159,2458.906324,865.805165,45.57743,308.534254,262.956824,0.030328,0.213145,0.182817,2.10392,1.783449,-0.320471,3728.130979,2608.123706,-1120.007273,10180.083468,3934.161768,-6245.9217,816.702925,182.267673,-634.435252,,,,314.264756,140.919576,-173.34518,134.96778,27.398353,-107.569427,235.411498,128.473369,-106.938129,23.277892,2.000583,-21.277309,2423.094874,1822.584264,-600.51061,48.773592,18.367146,-30.406446,17.48609,51.97253,34.48644,119.863398,71.590241,-48.273157,385.961795,347.533154,-38.428641,,,,2284.173088,1123.991035,-1160.182053,5.177349,12.030822,6.853473,81.612397,144.108803,62.496406,7.611262,3.961125,-3.650137,0.462354,19.261949,18.799595,13.020399,44.232972,31.212573,85.574815,61.834954,-23.739861,1.871823,8.571812,6.699989,3.24858,2.594171,-0.654409,0.006199,14.594936,14.588737,11.911989,7.492896,-4.419093,1.174752,10.623525,9.448773,1070.12369,780.154329,-289.969361,191.311758,61.805119,-129.506639,0,230.988639,230.988639,30.130039,4.381863,-25.748176,0.374947,0.073167,-0.30178,0.006642,0.043127,0.036485,3288.488671,1182.674664,-2105.814007,,,,48.263127,23.810403,-24.452724,45.617398,12.946795,-32.670603,4.696835,2.1717,-2.525135,7.253049,1.363375,-5.889674,,,,11.487488,8.327796,-3.159692,0.049683,1.917708,1.868025,0.180578,0.587734,0.407156,3.219675,5.702829,2.483154,73.953449,53.868024,-20.085425,146.33452,83.417625,-62.916895,36.571184,18.166712,-18.404472,544.176602,998.236098,454.059496,8.183447,5.051822,-3.131625,1.202879,0.096892,-1.105987,6.699532,65.123245,58.423713,1688.167229,100.882751,-1587.284478,0.193186,14.554209,14.361023,954.6,581,-373.6,0,0,0,0.315942,0.068583,-0.247359,103.095308,111.20501,8.109702,845.156059,239.608873,-605.547186,,,,4300.162369,1676.361852,-2623.800517,89.449087,577.043222,487.594135,174.001664,1966.740629,1792.738965,9.774939,43.907137,34.132198,136.818787,126.185271,-10.633516,36.116169,83.079112,46.962943,1.443862,148.531656,147.087794,3206.144693,1748.757179,-1457.387514,331.821319,114.928281,-216.893038,4.892897,2.105788,-2.787109,364.63156,28.482769,-336.148791,191.924217,23.573825,-168.350392,0,5.81572,5.81572,2164.871398,829.288227,-1335.583171,1588.224805,481.436462,-1106.788343,1.580141,3.988542,2.408401,195.366078,14.707919,-180.658159,2132.701939,1028.819919,-1103.88202,1725.185592,2790.648806,1065.463214,1417.472568,540.499163,-876.973405,0.07,0.002644,-0.067356,75.756833,19.356048,-56.400785,706.948201,859.420669,152.472468,5.967189,21.87818,15.910991,0,0.108915,0.108915,2.128885,2.254295,0.12541,39543.693182,10587.785547,-28955.907635,31.641362,30.749989,-0.891373000000002,0,0,0,4846.911575,3028.377771,-1818.533804,355.944178,3379.045082,3023.100904,3206.725814,1965.118447,-1241.607367,11811.360036,5685.768365,-6125.591671,825.916759,2606.409542,1780.492783,0,0.052656,0.052656,0.06059,0,-0.06059,0.003682,0.024413,0.020731,0.000112,0.012257,0.012145,6.679441,9.10382,2.424379,266.096465,275.140226,9.04376099999996,0.181099,0.554017,0.372918,0.328831,0.051156,-0.277675,0.020172,0.01186,-0.008312,0.123317,2.480765,2.357448,0.091492,0.585495,0.494003,0.164768,0.968098,0.80333,0.000233,0,-0.000233,0.049777,0.441979,0.392202,0.00395,0.034021,0.030071,5.269742,4.428856,-0.840886,0,0.069195,0.069195,3.861533,9.036724,5.175191,2.842383,15.360826,12.518443,0.017076,4.040188,4.023112,0.016603,2.10947,2.092867,0.070944,0.007504,-0.06344,24.962405,7.130989,-17.831416,0.180525,1.600234,1.419709,69.097535,168.165629,99.068094,648.463014,113.29565,-535.167364,54.692119,41.971782,-12.720337,2.864902,13.077689,10.212787,183.133807,394.768224,211.634417,0,5.599154,5.599154,0.000243,1.621268,1.621025,0,0,0,15.781363,22.132028,6.350665,0.050491,9.088494,9.038003,24.197733,40.050722,15.852989,0.660725,15.09828,14.437555,0.14463,1.330916,1.186286,7.280688,5.116313,-2.164375,0.492068,5.583792,5.091724,45.021936,21.641235,-23.380701,11.558487,76.590806,65.032319,0.008551,1.299917,1.291366,0.054785,4.683593,4.628808,0.17857,9.150594,8.972024,1409.029972,386.424508,-1022.605464,0.586695,0.333289,-0.253406,238.245504,17.021405,-221.224099,325.134826,3.562285,-321.572541,0.940842,0.062346,-0.878496,0.114583,5.833437,5.718854,0.268846,43.16367,42.894824,570.015035,117.80054,-452.214495,43.940689,28.371652,-15.569037,0.00066,0.294918,0.294258,0.480458,0.553247,0.072789,0.00396,0.038947,0.034987,17.110722,11.571447,-5.539275,0.844017,8.7061,7.862083,0.604842,0.319725,-0.285117,7.729066,0.55436,-7.174706,0.023736,0.118972,0.095236,3.119383,5.721075,2.601692,0,1.065692,1.065692,0.267114,3.00922,2.742106,1.284168,22.744241,21.460073,31.601912,44.636924,13.035012,0.534601,0.956382,0.421781,5.943767,0.279448,-5.664319,4.623819,13.79733,9.173511,17.58318,4.932225,-12.650955,2.800978,28.548925,25.747947,11.09432,3.962991,-7.131329,0.00278,0.614653,0.611873,0.104541,0.10389,-0.000650999999999999,0.044768,0.477081,0.432313,0.000022,0.070791,0.070769,734.673887,505.873914,-228.799973,18.078985,8.091648,-9.987337,20.609815,2.427341,-18.182474,4.194867,9.497024,5.302157,4.442621,7.189493,2.746872,6.869485,6.829898,-0.039587,8.936852,5.137462,-3.79939,36.526868,0.065901,-36.460967,0,33.605033,33.605033,,,
2012-12-01,12222.417967,8843.366506,-3379.051461,30443.749308,21623.191078,-8820.55823,187616.679934614,131816.410369327,-55800.2695652869,12762.433335,0,-12762.433335,13930.771468,7435.658738,-6495.11273,32801.463235,27539.319607,-5262.143628,9576.489473,12734.905971,3158.416498,13187.089595,16802.438759,3615.349164,46128.855251,38636.489238,-7492.36601300001,36090.151602,26843.558315,-9246.593287,3920.348448,2655.192212,-1265.156236,61603.325536,34242.352543,-27360.972993,177106.939117,130753.707654,-46353.2314629999,76587.858695,42915.445939,-33672.412756,2403.062484,2583.131369,180.068885,1191.714039,2868.741516,1677.027477,2969.435543,1819.631167,-1149.804376,0.921487,0.482772,-0.438715,25847.708699,22261.079519,-3586.62918,0,0,0,20281.146552,16375.409719,-3905.736833,363.364458,498.904199,135.539741,17.43559,19.533194,2.097604,234.511537,269.651306,35.139769,374.604021,424.539801,49.93578,199.388731,124.642552,-74.746179,896.53416,608.28639,-288.24777,27.649088,954.360048,926.71096,1.170993,80.262302,79.091309,48.829238,331.318949,282.489711,0,35.748571,35.748571,64.00155,168.529331,104.527781,0.948264,19.365602,18.417338,0.887082,55.384904,54.497822,62.945816,106.890794,43.944978,334.659577,657.107121,322.447544,0.203744,3.110231,2.906487,0.746509,18.027291,17.280782,4.515118,9.97888,5.463762,0.651086,34.819868,34.168782,0.095738,0.981808,0.88607,0.123826,7.81857,7.694744,0.950777,39.09534,38.144563,0.19788,9.294472,9.096592,0.205662,6.12587,5.920208,4.340487,37.393195,33.052708,642.940639,174.522855,-468.417784,,,,2.493073,81.448957,78.955884,14.074739,30.400253,16.325514,8.010889,116.941501,108.930612,2.21747,80.926811,78.709341,6.200694,22.782037,16.581343,1866.228636,1567.707933,-298.520703,3023.421372,1759.534929,-1263.886443,57.018123,27.37025,-29.647873,34.396515,42.445413,8.048898,0.00005,80.246891,80.246841,756.378829,645.976623,-110.402206,557.036641,868.836053,311.799412,197.953631,93.781687,-104.171944,884.816786,1966.326788,1081.510002,2164.083551,3591.744274,1427.660723,26.605299,153.837658,127.232359,31.394201,126.580303,95.186102,272.856845,849.155339,576.298494,0.00068,0.701615,0.700935,26.595709,31.981846,5.386137,764.581529,417.755023,-346.826506,0,0.011545,0.011545,362.150587,294.383097,-67.76749,383.542657,192.240843,-191.301814,8.223184,0.042561,-8.180623,408.691775,218.861389,-189.830386,4347.147407,4050.667233,-296.480174,2101.202228,736.275834,-1364.926394,1597.697264,3860.671867,2262.974603,1486.750556,2355.803206,869.05265,38.858911,121.762781,82.90387,0.121336,0.025353,-0.095983,1.825222,0.703808,-1.121414,3353.605644,2428.201872,-925.403772,9402.504091,3801.391062,-5601.113029,850.655131,274.547772,-576.107359,,,,285.097633,153.416197,-131.681436,118.204833,18.838943,-99.36589,292.322141,143.148542,-149.173599,24.008856,1.756442,-22.252414,2122.558923,1852.037578,-270.521345,31.621298,18.929353,-12.691945,18.929327,32.401024,13.471697,141.662687,64.469507,-77.19318,381.369887,401.97168,20.601793,,,,2279.427913,1170.922631,-1108.505282,11.103805,10.296534,-0.807271,128.813671,212.692614,83.878943,8.061706,4.45269,-3.609016,95.358656,31.931585,-63.427071,9.829667,68.624711,58.795044,78.694792,66.489504,-12.205288,0.304509,22.060831,21.756322,2.737581,4.003793,1.266212,0.00667,1.557734,1.551064,5.976113,6.390641,0.414528,1.162122,3.333893,2.171771,929.270399,703.435742,-225.834657,203.677772,94.709185,-108.968587,0.005,278.966196,278.961196,23.714988,21.107489,-2.607499,0.303671,0.099348,-0.204323,0.030695,0.104343,0.073648,2976.729124,1325.91855,-1650.810574,,,,34.055262,30.661973,-3.393289,47.881728,13.011557,-34.870171,4.294651,2.018746,-2.275905,3.956229,2.889076,-1.067153,,,,15.81249,12.227639,-3.584851,0.021243,2.351493,2.33025,0.027396,0.846667,0.819271,1.627406,4.374126,2.74672,78.398949,61.395894,-17.003055,138.961644,78.464484,-60.49716,39.42572,22.553007,-16.872713,419.307229,1102.128239,682.82101,1.243985,11.241042,9.997057,0.48302,0.065368,-0.417652,5.928361,114.522062,108.593701,1592.518359,454.173396,-1138.344963,0.116487,10.354205,10.237718,968,736.6,-231.4,0,0.014687,0.014687,1.045061,0.042571,-1.00249,85.014151,186.496459,101.482308,865.724873,261.318865,-604.406008,,,,3659.898646,1914.666639,-1745.232007,71.537937,660.242082,588.704145,136.777859,2315.1169,2178.339041,36.59465,28.664802,-7.929848,55.340649,134.807173,79.466524,59.108209,105.906735,46.798526,2.357098,131.303538,128.94644,2772.337336,2232.702109,-539.635227,247.681967,148.030078,-99.651889,4.59262,3.009761,-1.582859,305.779777,48.506543,-257.273234,181.840338,15.022822,-166.817516,0,31.001517,31.001517,2156.660276,944.688313,-1211.971963,1775.140936,441.880973,-1333.259963,2.218098,2.850991,0.632893,200.53851,13.516226,-187.022284,2071.403203,1112.276743,-959.12646,1468.212043,2718.26275,1250.050707,1419.957999,595.056422,-824.901577,0,0.066484,0.066484,0.464237,14.651302,14.187065,690.521498,600.137696,-90.3838019999999,6.909969,30.143197,23.233228,0.014543,0.032294,0.017751,1.204245,1.726092,0.521847,34857.579544,10308.631935,-24548.947609,0.110835,53.223534,53.112699,0,0.101472,0.101472,4599.163639,3453.340414,-1145.823225,411.614328,4414.80765,4003.193322,3097.499463,2148.495157,-949.004306,11815.573809,6016.946299,-5798.62751,838.815598,2504.479768,1665.66417,0.019541,0,-0.019541,0.060052,0.013482,-0.04657,0.021154,0.123304,0.10215,0,0.000306,0.000306,7.827662,15.690585,7.862923,317.782544,309.432625,-8.349919,0.010198,0.145744,0.135546,0.412574,0,-0.412574,0.015855,0.509434,0.493579,0.648113,1.66389,1.015777,0.042746,0.427943,0.385197,0.07324,0.525809,0.452569,0,0,0,0.035299,0.051038,0.015739,0.005537,0.043796,0.038259,4.97819,5.270538,0.292348,0,0.050784,0.050784,3.697377,9.975092,6.277715,2.167932,9.687501,7.519569,0.084385,3.698457,3.614072,0.044721,1.241365,1.196644,0.02234,0.069637,0.047297,14.862781,3.495416,-11.367365,0.089952,2.083307,1.993355,94.074134,139.036209,44.962075,565.228737,119.752483,-445.476254,54.987675,93.480417,38.492742,24.867911,19.681176,-5.186735,148.524471,428.455225,279.930754,2.738063,15.927237,13.189174,0.000003,5.506437,5.506434,0.097228,0.044756,-0.052472,76.12357,18.799158,-57.324412,0.040158,14.703804,14.663646,6.98327,21.147132,14.163862,0.460454,11.191285,10.730831,0.142968,2.765728,2.62276,4.870997,11.549817,6.67882,3.032612,5.805154,2.772542,111.008642,15.41669,-95.591952,13.013222,86.344244,73.331022,0.000634,1.684357,1.683723,0.146985,1.710914,1.563929,1.074418,94.538885,93.464467,1068.422556,535.081208,-533.341348,0.063222,0.504606,0.441384,14.420296,20.108548,5.688252,152.250584,3.946412,-148.304172,0.00329,0,-0.00329,0.06482,2.399306,2.334486,0.157206,44.031754,43.874548,395.747603,114.180725,-281.566878,102.532651,28.124744,-74.407907,0.000413,0.846059,0.845646,0.01667,0.852145,0.835475,0.00044,0.030435,0.029995,22.893149,9.253761,-13.639388,1.768918,11.817337,10.048419,1.444234,0.3274,-1.116834,6.87831,0.843026,-6.035284,0.055901,2.23674,2.180839,3.250216,20.18467,16.934454,0.014854,0.315253,0.300399,0.09045,23.73665,23.6462,2.08779,4.846269,2.758479,28.001897,40.515959,12.514062,0.217932,1.523038,1.305106,1.325381,0.244678,-1.080703,4.5961,24.275406,19.679306,18.678711,2.929655,-15.749056,5.748582,12.609304,6.860722,7.362848,5.910422,-1.452426,0,0.938079,0.938079,0.126488,0.15049,0.024002,0.006385,0.53738,0.530995,0.020895,0.032635,0.01174,758.80224,557.020538,-201.781702,44.398811,18.704122,-25.694689,26.790489,2.0004,-24.790089,0.993932,14.893697,13.899765,3.649903,8.155224,4.505321,0.520346,4.804492,4.284146,3.490082,8.170389,4.680307,22.800064,0.067026,-22.733038,0,31.358903,31.358903,,,
2013-01-01,14340.549483,7650.292366,-6690.257117,28540.261379,20251.001585,-8289.259794,189809.286743494,129892.342521637,-59916.9442218571,12315.200061,0,-12315.200061,14759.851138,7397.072794,-7362.778344,31281.395637,23980.544043,-7300.851594,,,,14076.243026,14932.284725,856.041699000001,49610.697133,41073.299616,-8537.39751699999,34365.288153,24851.705414,-9513.58273900001,5141.566711,2483.219904,-2658.346807,64476.777299,29292.758959,-35184.01834,185168.566967,123031.879061,-62136.6879059999,80812.015738,37432.968447,-43379.047291,2090.931185,2283.973992,193.042807,1162.754407,2258.167509,1095.413102,3921.905863,1603.278456,-2318.627407,0.001799,0.233446,0.231647,28055.00607,23170.845914,-4884.160156,0,0,0,21555.691063,17902.453702,-3653.237361,315.121337,425.978783,110.857446,11.023198,17.795867,6.772669,180.245013,207.606613,27.3616,281.763897,429.806151,148.042254,199.777951,75.752432,-124.025519,836.816904,598.484187,-238.332717,30.457157,1046.236431,1015.779274,1.105168,47.156737,46.051569,93.891474,256.292297,162.400823,0,65.918611,65.918611,46.3814,199.811433,153.430033,0.686292,17.119285,16.432993,13.807089,45.294205,31.487116,46.183998,88.937348,42.75335,277.206083,546.345826,269.139743,0.312238,1.975878,1.66364,0.364946,14.594517,14.229571,3.226441,10.755162,7.528721,1.81509,13.494919,11.679829,0.048076,0.496636,0.44856,0.497825,4.107833,3.610008,0.868842,77.405745,76.536903,0.168334,7.798547,7.630213,0.270226,5.569002,5.298776,4.291267,40.452889,36.161622,651.050623,161.721634,-489.328989,,,,5.199552,81.894446,76.694894,65.40273,29.587633,-35.815097,4.603817,69.144038,64.540221,1.606386,71.759079,70.152693,0.913332,53.000152,52.08682,1972.750268,1587.273419,-385.476849,3414.326317,1266.366726,-2147.959591,48.392817,26.140376,-22.252441,20.675839,24.477763,3.801924,0.004454,283.7542,283.749746,1017.187016,608.014732,-409.172284,634.419805,848.480144,214.060339,265.998277,59.724344,-206.273933,1107.906644,1238.110252,130.203608,2145.1351,3071.314784,926.179684,21.828185,172.495235,150.66705,35.718559,252.27384,216.555281,316.79225,781.411349,464.619099,0.000809,0.153245,0.152436,40.168627,24.382975,-15.785652,637.664006,435.093602,-202.570404,0,0.002206,0.002206,435.895809,282.161894,-153.733915,319.554327,205.505238,-114.049089,9.522837,0.181908,-9.340929,547.620165,254.586541,-293.033624,3984.912782,3913.506707,-71.4060749999999,2473.748773,633.409789,-1840.338984,1791.644767,2902.571406,1110.926639,1542.715174,2167.521145,624.805971,118.890254,91.291071,-27.599183,0.113516,0.155372,0.041856,3.973031,1.322674,-2.650357,3206.548471,2449.648019,-756.900452,7722.913241,3788.548441,-3934.3648,706.656448,223.307476,-483.348972,,,,285.522129,154.844986,-130.677143,107.652665,32.828335,-74.82433,273.65315,121.000428,-152.652722,21.223832,1.878238,-19.345594,2265.589832,1987.011304,-278.578528,38.609769,24.538216,-14.071553,15.416016,26.432473,11.016457,136.737181,56.269559,-80.467622,316.655569,345.653655,28.998086,,,,2076.126083,692.91996,-1383.206123,5.646197,5.727279,0.0810820000000003,122.777281,203.053182,80.275901,9.691725,7.299384,-2.392341,95.22016,23.133211,-72.086949,26.039182,48.867264,22.828082,86.01462,101.513143,15.498523,0.017592,4.866077,4.848485,3.766608,1.533848,-2.23276,0.010311,0.476974,0.466663,0.71082,3.693794,2.982974,0.777566,4.617475,3.839909,901.667745,917.920752,16.253007,196.508437,56.297442,-140.210995,0.000165,51.52341,51.523245,20.09469,44.11366,24.01897,0.242549,0.014696,-0.227853,0.028437,0.015717,-0.01272,2846.745504,1240.751799,-1605.993705,,,,39.023845,21.065821,-17.958024,41.286456,10.171777,-31.114679,4.816358,2.31318,-2.503178,9.762669,3.459268,-6.303401,,,,9.818736,17.52996,7.711224,0.056842,0.859175,0.802333,0.361497,0.746632,0.385135,1.128829,3.726978,2.598149,67.596057,43.857111,-23.738946,151.14167,60.280753,-90.860917,45.922774,17.020061,-28.902713,595.525063,1125.716651,530.191588,3.159314,12.965322,9.806008,1.109051,1.920877,0.811826,6.862306,55.488226,48.62592,1530.941498,87.688472,-1443.253026,0.474869,11.235871,10.761002,921.7,620.7,-301,0,0,0,0.541013,0.1545,-0.386513,93.735519,129.30249,35.566971,1223.212096,172.28404,-1050.928056,,,,3583.287858,1710.350554,-1872.937304,110.003112,702.22068,592.217568,183.865841,2302.423732,2118.557891,0.069993,42.582076,42.512083,113.932448,134.006937,20.074489,41.418102,93.828332,52.41023,2.029714,113.915036,111.885322,3179.766543,1726.891919,-1452.874624,330.14608,173.768527,-156.377553,7.00611,3.470338,-3.535772,493.7617,30.850978,-462.910722,212.440298,14.831083,-197.609215,0.054,76.405125,76.351125,2110.310755,1057.669666,-1052.641089,1997.122948,431.840836,-1565.282112,1.836992,1.201675,-0.635317,233.044338,18.075471,-214.968867,2119.970065,904.640681,-1215.329384,1548.743674,2174.988931,626.245257,1701.583848,635.825686,-1065.758162,0,0.05984,0.05984,7.235774,10.290978,3.055204,694.808833,679.924089,-14.8847440000001,7.476739,23.237252,15.760513,0.040395,0.120636,0.080241,3.167003,1.898246,-1.268757,37193.658803,9382.923146,-27810.735657,0.102855,13.214033,13.111178,0,0.968712,0.968712,5226.947861,3117.963667,-2108.984194,370.561673,3055.092544,2684.530871,3181.994874,1926.959417,-1255.035457,11291.625875,5162.250053,-6129.375822,803.480593,1985.446797,1181.966204,0.000001,0.02993,0.029929,0.020293,0.108687,0.088394,0.001498,0.002793,0.001295,0.002652,0,-0.002652,9.353816,18.705702,9.351886,319.334871,214.510016,-104.824855,0.009603,0.230767,0.221164,0.049531,0.006014,-0.043517,0.01038,0,-0.01038,0.184225,1.451689,1.267464,0.026,0.826995,0.800995,0.166519,0.469625,0.303106,0.000203,0,-0.000203,0.044985,0.04935,0.004365,0.006834,0.007333,0.000499,9.236333,5.416914,-3.819419,0,0.047851,0.047851,3.628783,8.735599,5.106816,1.460495,10.688184,9.227689,0.012078,2.993527,2.981449,0.027563,2.384838,2.357275,0.006684,0,-0.006684,15.599162,4.983082,-10.61608,0.100972,1.061751,0.960779,94.116384,131.364169,37.247785,748.558114,167.219745,-581.338369,72.506261,52.007226,-20.499035,13.502841,7.478381,-6.02446,137.256632,472.580024,335.323392,0.849762,4.456897,3.607135,0.04018,2.207514,2.167334,0.003212,0,-0.003212,72.156926,38.548694,-33.608232,0.006293,9.616278,9.609985,47.474093,20.477532,-26.996561,1.437673,13.36712,11.929447,0.193251,6.393084,6.199833,4.279213,4.908241,0.629028,1.745875,4.167742,2.421867,101.035774,15.843857,-85.191917,22.253752,74.255615,52.001863,0.030105,1.020925,0.99082,0.319019,1.735716,1.416697,0.522952,120.542683,120.019731,1578.118612,438.377585,-1139.741027,0.025791,1.50427,1.478479,6.044244,12.132613,6.088369,246.060443,3.902951,-242.157492,1.104944,2.598473,1.493529,0.283336,5.910897,5.627561,0.405834,33.998634,33.5928,787.714783,131.118259,-656.596524,24.931519,17.025016,-7.906503,0.000825,0.192777,0.191952,0.008411,0.373903,0.365492,0.040136,0,-0.040136,0.439102,27.661236,27.222134,2.499305,14.26248,11.763175,1.005633,0.210403,-0.79523,4.494315,0.519861,-3.974454,0.009085,0.33928,0.330195,3.597779,17.065835,13.468056,0.031109,0.248367,0.217258,0.144504,12.505628,12.361124,2.333735,3.661384,1.327649,31.96651,35.763616,3.797106,1.259298,1.130863,-0.128435,2.156002,0.161372,-1.99463,7.23217,22.300421,15.068251,31.134294,2.321616,-28.812678,1.89683,21.757012,19.860182,13.961617,4.508247,-9.45337,0.000409,0.319925,0.319516,0.447158,0.000479,-0.446679,1.081349,0.267744,-0.813605,0.018583,0.085311,0.066728,865.51444,451.377702,-414.136738,3.188006,4.923308,1.735302,7.927971,1.712063,-6.215908,0.911027,6.956464,6.045437,4.824368,1.22904,-3.595328,0.402006,2.833344,2.431338,3.993111,2.287596,-1.705515,32.892385,0.012107,-32.880278,0,0,0,,,
2013-02-01,10357.380263,6783.526654,-3573.853609,29134.515265,20151.095837,-8983.419428,192655.256873103,131929.379665234,-60725.8772078687,13277.794654,0,-13277.794654,14309.642062,7725.065163,-6584.576899,27902.570125,22651.140332,-5251.429793,,,,11886.251664,14677.53888,2791.287216,47918.583799,40902.52041,-7016.063389,34475.821924,25344.447809,-9131.37411499999,3213.691491,3229.912111,16.220620000001,57491.993136,30344.124895,-27147.868241,170322.898015,123443.633859,-46879.2641559999,71902.739908,37060.66347,-34842.076438,2381.259283,2378.916634,-2.34264900000016,924.092689,2228.348862,1304.256173,2933.02652,2205.961448,-727.065072,1.71654,0.202317,-1.514223,25848.367646,23199.318297,-2649.049349,0,0,0,22070.216153,17703.202113,-4367.01404,329.445508,558.575695,229.130187,4.99693,18.476168,13.479238,198.800085,255.805945,57.00586,364.44247,386.659041,22.216571,220.346024,76.077525,-144.268499,935.394816,519.149479,-416.245337,29.29585,932.375191,903.079341,0.816489,29.160235,28.343746,24.729718,285.389263,260.659545,0,53.000131,53.000131,48.818054,188.836886,140.018832,0.497234,16.000244,15.50301,0.962169,57.40327,56.441101,62.842314,87.385759,24.543445,332.83038,582.648949,249.818569,0.390336,3.045923,2.655587,0.181023,14.652908,14.471885,3.512104,9.456628,5.944524,1.205489,11.291477,10.085988,0.03044,0.74731,0.71687,0.135725,3.783985,3.64826,1.135464,53.963279,52.827815,0.123984,6.62421,6.500226,0.245985,4.074539,3.828554,4.168394,34.100192,29.931798,446.053127,139.572625,-306.480502,,,,5.121926,77.72256,72.600634,40.944924,56.24362,15.298696,5.994984,30.633133,24.638149,1.183823,39.553493,38.36967,0.945025,19.982646,19.037621,1651.852323,1368.999484,-282.852839,2178.060285,1133.635397,-1044.424888,43.030331,23.907039,-19.123292,37.947471,42.981356,5.033885,0,2.335771,2.335771,809.275609,786.216831,-23.0587780000001,658.491465,747.987233,89.495768,39.592972,107.669755,68.076783,1021.077153,1374.630041,353.552888,1976.995691,3574.686968,1597.691277,19.543218,142.754988,123.21177,25.667778,132.588469,106.920691,359.125671,686.527939,327.402268,0.000903,0.2253,0.224397,23.245403,31.496856,8.251453,769.152279,338.430544,-430.721735,0.000678,0,-0.000678,393.824231,382.287913,-11.536318,424.048185,153.615928,-270.432257,6.810933,0.00714,-6.803793,441.521141,204.817377,-236.703764,3904.546152,4232.849646,328.303494,2652.349519,512.108677,-2140.240842,1857.637041,3099.8657,1242.228659,1294.866073,2351.900118,1057.034045,55.498976,110.006454,54.507478,0.103257,0.096144,-0.00711300000000001,1.815223,5.452614,3.637391,3123.24951,2168.928895,-954.320615,8520.325428,3841.929541,-4678.395887,802.305335,200.542961,-601.762374,,,,261.465263,153.725458,-107.739805,103.275873,17.944615,-85.331258,260.769617,135.866482,-124.903135,22.186188,1.363006,-20.823182,1911.43109,2100.697013,189.265923,50.525285,18.201617,-32.323668,35.572353,29.392457,-6.179896,57.883323,64.203653,6.32033000000001,347.006384,272.416134,-74.59025,,,,2040.448581,1008.62449,-1031.824091,13.006693,7.656454,-5.350239,49.822285,133.958187,84.135902,6.44305,13.485813,7.042763,120.683885,21.738738,-98.945147,36.61254,57.064016,20.451476,140.590409,71.917804,-68.672605,0.371784,13.049149,12.677365,1.573624,3.635683,2.062059,0.543196,2.716656,2.17346,6.239932,12.23517,5.995238,2.083488,6.36973,4.286242,870.638362,646.130491,-224.507871,221.107789,69.172074,-151.935715,0.002769,242.334448,242.331679,19.441083,48.391923,28.95084,0.465012,0.034586,-0.430426,0.04899,0.013467,-0.035523,2773.322849,1297.138857,-1476.183992,,,,34.582918,23.404406,-11.178512,36.441053,14.541112,-21.899941,3.34548,2.290055,-1.055425,14.232914,6.220479,-8.012435,,,,12.325744,8.78232,-3.543424,0.152222,0.373004,0.220782,0.070642,0.457363,0.386721,1.336203,6.870659,5.534456,57.144326,58.17652,1.032194,109.515926,58.74903,-50.766896,47.601232,18.941784,-28.659448,531.490213,1052.123015,520.632802,2.72199,9.703383,6.981393,0.440622,0.383379,-0.057243,5.317177,99.11921,93.802033,1473.768538,112.247785,-1361.520753,1.133591,26.080108,24.946517,943.4,643.4,-300,0,0,0,0.300097,0.102912,-0.197185,90.268916,192.619015,102.350099,747.401653,204.738929,-542.662724,,,,3041.790126,1275.645351,-1766.144775,99.284883,443.529131,344.244248,237.200793,2113.855217,1876.654424,0.220331,32.928238,32.707907,102.228423,118.554815,16.326392,44.163203,89.988618,45.825415,3.327072,103.18358,99.856508,2829.030556,1561.061107,-1267.969449,262.711083,133.27396,-129.437123,5.544578,2.040027,-3.504551,473.103766,75.021729,-398.082037,176.584342,15.273831,-161.310511,0.168093,6.994169,6.826076,1884.154658,757.357059,-1126.797599,1769.424114,438.875349,-1330.548765,1.664449,1.128125,-0.536324,224.637488,22.703633,-201.933855,1812.04711,873.997346,-938.049764,1346.335579,2348.273627,1001.938048,1422.689235,693.666332,-729.022903,0,0.099315,0.099315,0.806487,12.712651,11.906164,672.455712,633.520873,-38.9348389999999,7.03868,19.480774,12.442094,0.021377,0.210953,0.189576,1.357587,4.48755,3.129963,32742.677585,9133.3176,-23609.359985,5.808342,18.322887,12.514545,0,0.062368,0.062368,4633.214395,3411.990152,-1221.224243,294.114912,3478.555143,3184.440231,2707.522009,2565.651182,-141.870827,10948.259091,4975.332203,-5972.926888,650.350855,1982.621292,1332.270437,0,0.025603,0.025603,0.022844,0.000171,-0.022673,0.006354,0.000404,-0.00595,0.00295,0.003961,0.001011,5.626878,10.717713,5.090835,248.854608,204.288007,-44.566601,0.006263,0.35717,0.350907,0.059521,0.00025,-0.059271,0.00339,0.024503,0.021113,0.023506,1.555908,1.532402,0.03936,0.51488,0.47552,0.126565,0.281437,0.154872,0.000058,0,-0.000058,0.049041,0.104476,0.055435,0.003989,0.020075,0.016086,6.889593,3.205699,-3.683894,0.021,0.010518,-0.010482,2.850098,9.042,6.191902,0.927305,3.346951,2.419646,0.024182,4.57683,4.552648,0.040638,1.614531,1.573893,0,0.146174,0.146174,8.091091,4.913866,-3.177225,0.100201,0.973869,0.873668,102.37551,218.170412,115.794902,10.808357,122.380695,111.572338,27.196122,49.791553,22.595431,5.281936,7.86955,2.587614,94.107441,570.634269,476.526828,0,2.708994,2.708994,0.002122,0.133481,0.131359,0,0,0,89.528888,514.818658,425.28977,0.099441,11.958054,11.858613,8.233448,36.720912,28.487464,0.601188,11.873332,11.272144,0.038297,7.280695,7.242398,12.849424,6.019727,-6.829697,1.431425,4.803621,3.372196,129.651478,14.628159,-115.023319,34.300718,79.023208,44.72249,0.025775,2.664807,2.639032,0.049886,2.912306,2.86242,0.445595,18.789078,18.343483,911.17902,431.895295,-479.283725,0.106538,0.218495,0.111957,9.7866,18.681546,8.894946,62.790008,3.378078,-59.41193,0.004364,0.029332,0.024968,0.061004,3.963235,3.902231,0.091357,61.798653,61.707296,803.095655,71.932282,-731.163373,149.24865,17.945977,-131.302673,0.045939,1.727729,1.68179,0,0.44214,0.44214,0.001185,0.183993,0.182808,0.895352,5.610441,4.715089,5.214259,11.204839,5.99058,0.480638,4.454246,3.973608,1.461931,0.99526,-0.466671,0.081326,0.820973,0.739647,4.727275,29.542058,24.814783,0,0.330691,0.330691,0.222642,25.356002,25.13336,2.265,4.485978,2.220978,28.671228,40.134379,11.463151,0.686963,0.882747,0.195784,1.27729,0.32622,-0.95107,6.208211,32.352255,26.144044,23.03383,3.272239,-19.761591,4.572719,24.424732,19.852013,11.558112,5.581435,-5.976677,0,1.357629,1.357629,0.100289,0.09903,-0.001259,0.503858,0.541446,0.037588,0.006027,0.275892,0.269865,576.376476,667.743442,91.3669659999999,11.719356,13.420002,1.700646,11.956631,11.84191,-0.114720999999999,0.56655,9.647278,9.080728,3.00168,2.008021,-0.993659,0.23596,5.800831,5.564871,4.504917,2.989993,-1.514924,17.193151,0.021817,-17.171334,0,0,0,,,
2013-03-01,12671.647253,8185.641655,-4486.005598,33383.523054,23003.517177,-10380.005877,183966.667725685,129195.532662402,-54771.135063283,13976.90969,0,-13976.90969,15166.486708,8910.439259,-6256.047449,31587.05908,27977.760793,-3609.298287,,,,13285.8524,15606.324213,2320.471813,51494.65727,44132.556755,-7362.100515,39620.594008,28655.977944,-10964.616064,4412.689198,3845.912866,-566.776331999999,55282.27589,33160.070727,-22122.205163,181850.699994,136642.157119,-45208.542875,71905.001342,41848.006903,-30056.994439,2576.29282,2759.499223,183.206403,1130.915068,2542.985761,1412.070693,3291.229304,2612.037085,-679.192218999999,0.990708,10.392677,9.401969,28342.376865,26039.808564,-2302.568301,0,0,0,23152.280405,18092.748191,-5059.532214,369.702197,562.811078,193.108881,12.21176,23.614038,11.402278,214.503515,254.210232,39.706717,409.378316,525.392514,116.014198,232.191855,87.486849,-144.705006,989.34592,643.75277,-345.59315,31.072948,870.2619,839.188952,0.831572,49.386782,48.55521,72.781606,337.038152,264.256546,0,26.361147,26.361147,69.034468,173.794308,104.75984,0.516023,22.146075,21.630052,1.328772,64.020549,62.691777,73.001911,77.702254,4.70034299999999,361.171017,685.84578,324.674763,0.285363,2.767553,2.48219,1.068267,13.120514,12.052247,4.727275,9.053673,4.326398,0.911728,13.376817,12.465089,0.012177,0.638067,0.62589,0.205781,3.804657,3.598876,1.460786,17.164027,15.703241,0.183968,5.316712,5.132744,0.759254,7.697127,6.937873,3.868221,41.664521,37.7963,571.136562,195.004931,-376.131631,,,,4.434781,69.285583,64.850802,20.720023,34.894701,14.174678,10.881535,72.408195,61.52666,0.685234,68.254588,67.569354,0.98926,35.418579,34.429319,1908.127165,1526.562663,-381.564502,2257.681361,991.617195,-1266.064166,44.053102,34.616859,-9.436243,27.067939,35.194546,8.126607,0.12939,11.836112,11.706722,957.772908,698.482451,-259.290457,738.562258,1018.989093,280.426835,131.362214,78.724429,-52.637785,1258.397826,1467.835108,209.437282,1970.526072,3744.411196,1773.885124,20.970586,198.095322,177.124736,31.011559,126.893471,95.881912,480.781968,679.243358,198.46139,0.005957,0.127737,0.12178,25.523862,14.638494,-10.885368,781.17304,446.857968,-334.315072,0,0.297597,0.297597,502.560609,351.657405,-150.903204,465.981395,199.807081,-266.174314,9.963665,0.059558,-9.904107,498.67923,182.137999,-316.541231,4570.970147,4225.820378,-345.149769,2891.469399,530.458622,-2361.010777,1814.819901,3436.952556,1622.132655,1481.586667,2702.724722,1221.138055,56.046532,262.569829,206.523297,0.066701,0.412079,0.345378,1.411067,1.529302,0.118235,3889.207054,2668.853369,-1220.353685,9713.993958,4412.659055,-5301.334903,839.122481,489.172999,-349.949482,,,,331.711743,198.768723,-132.94302,149.068555,26.607852,-122.460703,286.720692,155.80656,-130.914132,24.379015,1.702561,-22.676454,2433.146971,2529.228348,96.081377,37.30395,32.076772,-5.227178,18.210824,35.748395,17.537571,202.927031,80.961831,-121.9652,431.411924,319.537631,-111.874293,,,,2449.437529,917.892441,-1531.545088,7.881428,12.346068,4.46464,99.470433,114.952381,15.481948,8.944848,9.784198,0.83935,0.22907,51.941908,51.712838,4.869476,55.187702,50.318226,68.771515,109.397553,40.626038,1.094841,7.038256,5.943415,2.307707,4.173029,1.865322,0.026277,16.638458,16.612181,1.102794,6.710614,5.60782,0.52558,3.590266,3.064686,1075.174119,827.238264,-247.935855,231.806037,65.421548,-166.384489,0.028485,183.051087,183.022602,25.044508,9.178965,-15.865543,0.656889,0.124075,-0.532814,0.002741,0.769446,0.766705,3203.982812,1495.290587,-1708.692225,,,,41.377838,37.53622,-3.841618,41.766832,18.037981,-23.728851,3.017255,2.690572,-0.326683,2.696783,5.245991,2.549208,,,,13.406139,9.758091,-3.648048,0.071782,1.249555,1.177773,0.170742,2.26199,2.091248,2.017887,5.077631,3.059744,87.108634,47.477431,-39.631203,156.029677,55.257452,-100.772225,56.269279,26.252892,-30.016387,573.288863,1233.054111,659.765248,4.558795,14.303495,9.7447,0.739314,0.137531,-0.601783,7.299624,95.319797,88.020173,1169.26755,155.875035,-1013.392515,0.0263,35.423152,35.396852,1093.2,633.9,-459.3,0,0.047956,0.047956,0.428935,0.097725,-0.33121,91.054375,279.985071,188.930696,1049.017242,263.431453,-785.585789,,,,3937.670296,1808.015353,-2129.654943,219.037419,318.409532,99.372113,428.663384,2986.675865,2558.012481,0.518579,28.584712,28.066133,98.645204,153.795321,55.150117,71.363083,89.792928,18.429845,5.82213,93.015065,87.192935,3676.811681,1865.246015,-1811.565666,304.327595,137.002683,-167.324912,6.315114,3.273,-3.042114,455.766425,61.594649,-394.171776,207.005091,23.192021,-183.81307,1.158613,5.565507,4.406894,2234.087407,1177.846881,-1056.240526,1578.031442,539.140618,-1038.890824,5.308674,1.614436,-3.694238,237.531525,22.708604,-214.822921,2243.105983,1287.821936,-955.284047,1420.722496,2848.945307,1428.222811,1615.900223,650.555606,-965.344617,0.002577,0.196867,0.19429,0.394476,17.542558,17.148082,762.744352,754.275654,-8.46869800000002,5.715165,33.051705,27.33654,0.04,0.300679,0.260679,2.650812,1.592219,-1.058593,27294.067203,9539.031339,-17755.035864,0.444292,16.334258,15.889966,0,0.054099,0.054099,5150.221199,3897.143475,-1253.077724,756.650856,3935.809155,3179.158299,2781.857809,2129.666034,-652.191775,12156.701675,5576.672648,-6580.029027,718.451421,2208.455653,1490.004232,0.001366,0.052134,0.050768,0.000762,0,-0.000762,0.011834,0.001295,-0.010539,0.025076,1.00165,0.976574,9.730911,18.605688,8.874777,366.012121,262.493969,-103.518152,0.006666,0.274086,0.26742,0.034825,0.021593,-0.013232,0.01864,0.050077,0.031437,0.198132,2.301167,2.103035,0.029254,1.781174,1.75192,0.208264,1.002131,0.793867,0.001089,0,-0.001089,0.094809,0.444789,0.34998,0.012162,0.00398,-0.008182,5.081584,7.684638,2.603054,0,0.018475,0.018475,3.900792,16.345598,12.444806,1.891891,10.242199,8.350308,0.013898,3.173572,3.159674,0.039332,1.599151,1.559819,0.065887,0.038877,-0.02701,24.97446,6.728872,-18.245588,0.14535,1.521752,1.376402,70.002754,264.13705,194.134296,459.851792,191.302264,-268.549528,163.015374,29.92076,-133.094614,0.07583,4.866983,4.791153,177.708573,666.343084,488.634511,2.356754,7.54643,5.189676,0.000002,0.204231,0.204229,0.005287,0.00753,0.002243,0.854656,17.379365,16.524709,0.045859,14.339914,14.294055,42.372995,27.089288,-15.283707,0.895517,13.112211,12.216694,0.201153,3.269138,3.067985,14.691655,14.698257,0.00660199999999911,1.358064,5.956455,4.598391,136.819652,16.176261,-120.643391,20.213218,94.71314,74.499922,0.003372,3.08099,3.077618,0.249006,2.275534,2.026528,0.408339,37.80353,37.395191,1406.252688,549.072677,-857.180011,2.076228,0.583652,-1.492576,17.704048,32.781272,15.077224,186.774515,3.407684,-183.366831,0.012238,0.058736,0.046498,0.038562,3.7514,3.712838,0.410544,65.895918,65.485374,536.172241,106.531955,-429.640286,62.11237,20.132589,-41.979781,0.000655,2.172014,2.171359,0.023342,3.129486,3.106144,0.000227,0.763613,0.763386,21.68773,9.074848,-12.612882,2.265262,10.968287,8.703025,0.110535,5.286077,5.175542,2.537606,2.275888,-0.261718,0.28192,0.12527,-0.15665,8.669509,15.606184,6.936675,0.014919,2.483952,2.469033,0.510044,12.995016,12.484972,3.362824,38.105883,34.743059,36.501867,37.902582,1.40071500000001,0.664553,1.269752,0.605199,0.624531,0.16501,-0.459521,10.248953,26.976108,16.727155,28.783639,2.780449,-26.00319,3.212439,18.48189,15.269451,19.8221,5.206669,-14.615431,0.003856,0.557578,0.553722,0.114459,0.28208,0.167621,0.002507,0.149744,0.147237,0.000213,0.182213,0.182,636.448328,1335.282928,698.8346,9.169222,15.362654,6.193432,28.25664,7.17198,-21.08466,9.786216,10.331232,0.545016,4.615139,1.501649,-3.11349,0.693334,9.354435,8.661101,3.747734,1.674365,-2.073369,25.31696,0.050025,-25.266935,0,0,0,,,
2013-04-01,13481.182673,6836.77509,-6644.407583,33297.754388,21027.446788,-12270.3076,188166.353303971,130640.648760483,-57525.7045434878,14075.568569,0,-14075.568569,15670.645941,9229.587289,-6441.058652,32522.136931,24698.149699,-7823.987232,,,,13309.02228,14296.941312,987.919032,52891.184134,46004.342994,-6886.84114,39520.156662,27741.224487,-11778.932175,4451.879783,2512.985656,-1938.894127,61945.1334,29342.615813,-32602.517587,190555.285853,129460.620838,-61094.6650149999,79088.799399,36603.092606,-42485.706793,2439.804281,2235.486757,-204.317524,1294.038184,2301.402287,1007.364103,3451.593213,1638.424387,-1813.168826,0.201523,0.380429,0.178906,28527.046617,26209.760419,-2317.286198,0.003888,0.251067,0.247179,24364.137517,19794.582575,-4569.554942,339.624192,387.405371,47.781179,13.280225,23.112109,9.831884,171.174755,261.369664,90.194909,346.999969,412.29662,65.296651,233.011082,81.425635,-151.585447,1000.371196,589.126241,-411.244955,27.473491,723.805905,696.332414,39.687917,43.421935,3.734018,48.550162,205.316747,156.766585,0,32.684589,32.684589,24.76133,197.695884,172.934554,0.394448,17.6172,17.222752,1.104575,54.324141,53.219566,73.781003,132.196704,58.415701,348.623087,503.863226,155.240139,0.446566,2.960655,2.514089,0.422457,13.563875,13.141418,7.287616,9.23681,1.949194,0.684336,9.035289,8.350953,0.100141,1.00211,0.901969,0.109531,5.279279,5.169748,1.351286,36.097488,34.746202,0.129512,10.258338,10.128826,1.7656,4.486742,2.721142,5.119362,33.164347,28.044985,645.129755,185.647776,-459.481979,,,,7.785961,59.628653,51.842692,43.572336,64.24432,20.671984,0.984505,64.834489,63.849984,0.1718,68.67485,68.50305,2.871946,59.724187,56.852241,1860.997238,1437.735883,-423.261355,2816.149806,1256.275144,-1559.874662,36.292232,25.300064,-10.992168,12.963512,44.917665,31.954153,0.053453,4.371461,4.318008,1007.886965,450.758598,-557.128367,564.300273,753.595114,189.294841,116.719136,75.291299,-41.427837,1021.88632,1396.168008,374.281688,2154.615311,3370.325742,1215.710431,8.238706,156.897577,148.658871,39.605194,103.955203,64.350009,282.010997,927.790737,645.77974,0.532995,0.057638,-0.475357,28.481392,29.681469,1.200077,753.000355,338.771022,-414.229333,0.000264,0.002809,0.002545,437.220249,336.354589,-100.86566,379.8029,212.817625,-166.985275,10.110847,0.421381,-9.689466,700.211042,147.885236,-552.325806,4304.493547,3494.781915,-809.711632,2802.30082,581.649623,-2220.651197,1802.54281,3428.19845,1625.65564,1609.140143,2809.460586,1200.320443,40.80027,103.771645,62.971375,0.425591,0.391031,-0.03456,2.705924,2.218963,-0.486961,4009.043138,2647.104366,-1361.938772,9767.201757,3795.421044,-5971.780713,813.984334,325.938733,-488.045601,,,,330.819134,141.322624,-189.49651,147.32324,26.511635,-120.811605,267.642336,138.93047,-128.711866,23.570566,2.172185,-21.398381,2382.262529,3873.600081,1491.337552,36.560299,21.612602,-14.947697,26.615182,31.9174,5.302218,144.246296,70.120435,-74.125861,410.673136,268.685239,-141.987897,,,,2445.833165,1087.226442,-1358.606723,14.734549,7.989913,-6.744636,113.0163,140.382809,27.366509,9.039786,9.787534,0.747748000000001,10.418996,31.933931,21.514935,19.016521,47.341452,28.324931,93.950406,66.578372,-27.372034,0.335187,5.732409,5.397222,3.377363,5.541741,2.164378,0.00696,2.036704,2.029744,2.535634,7.173871,4.638237,0.329476,2.736,2.406524,1008.499809,875.273942,-133.225867,273.82643,70.725206,-203.101224,0.021429,224.453704,224.432275,14.592355,34.119787,19.527432,0.418684,0.508282,0.089598,0.046514,0.049771,0.003257,3285.124111,1236.456474,-2048.667637,,,,40.896382,20.179178,-20.717204,50.088451,12.734343,-37.354108,3.20976,2.78651,-0.42325,2.357199,7.643174,5.285975,,,,12.491037,20.604261,8.113224,0.0281,1.643739,1.615639,0.158777,1.133491,0.974714,1.204768,5.829262,4.624494,86.26075,105.3643,19.10355,151.958655,62.325973,-89.632682,35.975613,19.76053,-16.215083,605.094301,789.821819,184.727518,4.131093,5.606405,1.475312,5.878021,0.091521,-5.7865,9.573627,87.031349,77.457722,1766.287274,131.674247,-1634.613027,0.0108,45.837725,45.826925,894.5,586.8,-307.7,0,0,0,0.22433,0.076902,-0.147428,91.374325,200.047292,108.672967,1015.755057,195.014298,-820.740759,,,,4045.198032,1481.683406,-2563.514626,91.824697,375.591152,283.766455,196.434335,2185.004551,1988.570216,0.156686,79.235898,79.079212,76.212745,120.540443,44.327698,71.144435,111.946624,40.802189,1.140672,94.066704,92.926032,4069.527798,1656.897256,-2412.630542,307.538205,165.34984,-142.188365,4.979645,1.705853,-3.273792,443.897878,74.23447,-369.663408,215.629367,48.562627,-167.06674,2.275031,3.648628,1.373597,2103.948319,1065.844668,-1038.103651,1774.809204,355.355801,-1419.453403,2.211344,3.203613,0.992269,235.489808,22.505123,-212.984685,2285.601569,1010.510137,-1275.091432,1614.628222,2361.822464,747.194242,1627.914846,766.367324,-861.547522,0,0.133344,0.133344,0.819419,12.86301,12.043591,772.235884,773.449525,1.21364099999994,5.156672,32.179984,27.023312,0.086411,0.125493,0.039082,1.585251,1.669734,0.0844830000000001,33131.926306,8953.954532,-24177.971774,0.088461,15.80567,15.717209,0,0,0,5588.634439,3197.422652,-2391.211787,378.329324,2817.248145,2438.918821,3285.293045,2105.345225,-1179.94782,11984.744131,5062.208797,-6922.535334,916.84728,1986.796993,1069.949713,0,0.030932,0.030932,0.010958,0.008899,-0.002059,0.020391,0.034342,0.013951,0.000586,0.010628,0.010042,4.454184,12.642993,8.188809,348.548079,249.804032,-98.744047,0.016146,0.174863,0.158717,0.201129,0.001001,-0.200128,0.025163,0.030067,0.004904,0.566272,4.339455,3.773183,0.616289,0.598929,-0.0173599999999999,0.458381,1.092358,0.633977,0.002717,0,-0.002717,0.073665,0.068113,-0.00555199999999999,0.000808,0.056572,0.055764,6.393895,8.368119,1.974224,0.000215,0.017208,0.016993,1.937703,12.609717,10.672014,1.467049,12.831918,11.364869,0.310889,3.643301,3.332412,0.023901,1.204775,1.180874,0.011457,0.157855,0.146398,11.950833,4.436006,-7.514827,0.09755,2.24286,2.14531,114.222783,191.599529,77.376746,352.816096,140.092204,-212.723892,85.085888,35.641366,-49.444522,14.438653,19.592262,5.153609,141.469952,407.947923,266.477971,0.352957,3.259256,2.906299,0.001013,0.580812,0.579799,0,0,0,94.466718,26.147731,-68.318987,20.617383,24.156733,3.53935,19.582301,20.746527,1.164226,1.535309,15.494893,13.959584,0.152368,4.647059,4.494691,10.36624,3.578833,-6.787407,1.029977,7.038858,6.008881,88.986018,14.479377,-74.506641,82.198374,90.508413,8.310039,0.480176,2.510183,2.030007,0.034015,2.592237,2.558222,1.761089,61.965505,60.204416,1317.131011,382.540511,-934.5905,0.030026,0.017263,-0.012763,10.200044,52.669401,42.469357,196.30815,2.310219,-193.997931,2.742462,0.134933,-2.607529,0.19241,4.173703,3.981293,0.236732,50.787945,50.551213,572.187399,94.647119,-477.54028,29.40619,24.858592,-4.547598,0.001118,0.109631,0.108513,0.158311,0.489539,0.331228,0.015616,0.143173,0.127557,4.364238,21.22444,16.860202,3.205325,19.627339,16.422014,0.212805,2.644809,2.432004,0.856194,3.077219,2.221025,0.101267,1.39867,1.297403,16.920504,49.80693,32.886426,0.01115,3.747568,3.736418,0.24315,10.250557,10.007407,4.560796,4.46297,-0.0978259999999995,33.412977,40.316703,6.903726,0.029868,1.562738,1.53287,1.084713,0,-1.084713,8.680097,20.618183,11.938086,31.166267,2.87899,-28.287277,12.427856,16.853396,4.42554,11.824823,8.143605,-3.681218,0.00001,3.96569,3.96568,0.099627,0.156901,0.057274,3.35592,0.605692,-2.750228,0.007555,0.270741,0.263186,767.542414,531.656244,-235.88617,14.258588,8.612928,-5.64566,24.036315,11.950521,-12.085794,2.326463,14.838175,12.511712,4.996297,1.896428,-3.099869,0.514601,2.23434,1.719739,7.001213,1.817505,-5.183708,30.210052,0.05929,-30.150762,0,0,0,,,
2013-05-01,13456.437497,7230.704543,-6225.732954,33145.660849,22465.212141,-10680.448708,190945.640220082,129517.167133742,-61428.4730863403,15010.629009,0,-15010.629009,14738.442886,9362.972567,-5375.470319,34128.210217,27135.398406,-6992.811811,,,,14313.808658,14855.029223,541.220565000007,52990.20049,45699.542703,-7290.657787,40517.266259,28142.0531,-12375.213159,5199.387745,2832.853458,-2366.534287,64814.646854,31105.143643,-33709.503211,196685.387287,132968.704067,-63716.6832200001,82495.43066,38906.312991,-43589.117669,2858.902069,2535.841641,-323.060428,1168.769464,2531.380418,1362.610954,4039.425906,1812.911054,-2226.514852,0.523924,1.532174,1.00825,28505.949667,26473.354644,-2032.595023,0.000087,0,-0.000087,24484.250823,19226.188059,-5258.062764,417.859748,504.8634,87.003652,12.780639,21.675989,8.89535,234.684231,284.211982,49.527751,417.405756,470.876869,53.471113,255.467492,81.620888,-173.846604,1133.288246,555.243179,-578.045067,35.307454,834.654702,799.347248,2.255713,53.098272,50.842559,47.001321,229.753229,182.751908,0,37.407985,37.407985,27.899928,155.245541,127.345613,0.72619,19.477867,18.751677,2.060233,45.573877,43.513644,82.491623,99.961518,17.469895,400.196596,639.025323,238.828727,0.504979,2.545266,2.040287,0.992967,23.549934,22.556967,4.549074,8.833843,4.284769,0.582975,9.905928,9.322953,0.070228,0.713243,0.643015,0.081474,4.622876,4.541402,1.784493,23.303581,21.519088,0.213093,6.906159,6.693066,1.630702,6.276726,4.646024,5.28132,39.917796,34.636476,498.063239,181.673631,-316.389608,,,,5.520327,44.081814,38.561487,100.973829,131.442404,30.468575,1.915101,39.022374,37.107273,0.345712,70.574292,70.22858,0.762461,20.214127,19.451666,2055.023242,1529.013063,-526.010179,2751.707169,1211.55028,-1540.156889,41.662497,27.518232,-14.144265,26.69062,43.493886,16.803266,0,2.032008,2.032008,954.237592,479.446845,-474.790747,640.929138,819.867807,178.938669,101.73313,64.222948,-37.510182,1042.853731,1514.591414,471.737683,2570.35146,3377.474757,807.123297,10.360205,130.451909,120.091704,46.051148,118.781756,72.730608,379.511245,890.309471,510.798226,0.000337,0.000232,-0.000105,23.288584,12.087598,-11.200986,907.468448,422.18352,-485.284928,0,0.888982,0.888982,334.755908,455.792612,121.036704,366.020047,193.922495,-172.097552,10.090431,0.325617,-9.764814,536.954204,169.511374,-367.44283,4661.129389,4066.46959,-594.659799,2676.000796,503.29746,-2172.703336,1534.935462,3325.799582,1790.86412,1820.071595,2856.384059,1036.312464,49.988951,277.374989,227.386038,0.070898,1.38783,1.316932,2.193102,4.490162,2.29706,3713.75441,2629.036842,-1084.717568,9628.967045,4024.376633,-5604.590412,837.814598,320.187358,-517.62724,,,,332.398097,163.883293,-168.514804,165.710555,38.40387,-127.306685,301.720707,128.581195,-173.139512,25.300801,2.744333,-22.556468,3278.395892,2148.339831,-1130.056061,32.012563,24.016841,-7.995722,18.86476,30.226562,11.361802,109.865188,66.129712,-43.735476,409.288395,370.80624,-38.482155,,,,2807.688048,781.571515,-2026.116533,6.989054,7.358237,0.369183,90.337167,119.628107,29.29094,9.241218,5.466685,-3.774533,6.060307,35.732888,29.672581,1.605113,53.897541,52.292428,91.50204,77.31978,-14.18226,0.326423,17.684479,17.358056,2.591018,5.035633,2.444615,0.039467,4.525723,4.486256,2.890959,62.643765,59.752806,19.742577,122.727602,102.985025,1109.716529,872.360632,-237.355897,314.699995,79.659341,-235.040654,0.008733,571.533031,571.524298,16.424908,7.447351,-8.977557,0.767125,0.028776,-0.738349,0.023462,0.102865,0.079403,3275.72787,1638.028327,-1637.699543,,,,31.58972,25.7991,-5.79062,54.88565,78.877991,23.992341,4.259705,5.282297,1.022592,2.506127,7.410347,4.90422,,,,16.09086,12.95027,-3.14059,0,1.195844,1.195844,0.076288,6.467773,6.391485,1.652692,7.505281,5.852589,65.666457,56.342479,-9.323978,132.361369,61.80372,-70.557649,38.931759,19.494927,-19.436832,633.111411,1144.715555,511.604144,2.691382,14.806658,12.115276,0.932876,0.404407,-0.528469,12.81553,124.656771,111.841241,944.048604,366.987385,-577.061219,0.0225,32.948193,32.925693,1168.1,585.7,-582.4,0,0.028007,0.028007,0.32349,0.057049,-0.266441,84.172715,194.995246,110.822531,978.216465,220.557861,-757.658604,,,,4491.160952,1790.124799,-2701.036153,145.648913,371.740504,226.091591,201.583739,1953.60697,1752.023231,0.377325,49.576958,49.199633,67.355598,151.192674,83.837076,62.544962,69.367397,6.822435,4.573082,138.922604,134.349522,4201.786658,1924.435508,-2277.35115,299.862282,154.132718,-145.729564,5.842389,2.940689,-2.9017,434.965002,51.349456,-383.615546,186.023363,27.551776,-158.471587,2.109514,4.860901,2.751387,2184.812087,1023.403266,-1161.408821,1877.609821,388.925042,-1488.684779,1.915889,1.317292,-0.598597,189.315038,19.667877,-169.647161,2548.25675,1123.894058,-1424.362692,1573.910641,2689.430065,1115.519424,1524.445173,787.196555,-737.248618,0,0.055426,0.055426,0.345573,16.127427,15.781854,749.233358,621.614315,-127.619043,4.514798,23.793737,19.278939,0.036278,0.232232,0.195954,1.033257,2.237011,1.203754,36617.62364,8752.827685,-27864.795955,5.954006,131.374071,125.420065,0,0,0,5668.753812,3248.428965,-2420.324847,410.499101,3363.822741,2953.32364,3443.069046,2223.351589,-1219.717457,11134.086231,5783.444589,-5350.641642,815.734065,2203.060633,1387.326568,0.002578,0.012424,0.009846,0.029857,9.120163,9.090306,0.033673,0.021956,-0.011717,0.000064,0,-0.000064,4.201438,16.682858,12.48142,319.973228,251.468426,-68.504802,0.013536,0.312278,0.298742,0.524771,0.013025,-0.511746,0.016845,0.006762,-0.010083,0.608347,1.93682,1.328473,0.149608,0.266544,0.116936,1.785012,13.182828,11.397816,0.002005,0.035203,0.033198,0.053971,0.419978,0.366007,0.023522,0.15002,0.126498,4.678094,7.028177,2.350083,0,0.010478,0.010478,4.913988,9.414739,4.500751,1.929107,5.25685,3.327743,0.01465,2.732102,2.717452,0.001787,1.398072,1.396285,0.017937,0.167801,0.149864,13.629824,6.459658,-7.170166,0.162925,2.180808,2.017883,66.933974,291.97118,225.037206,617.487095,251.863115,-365.62398,30.023174,41.882536,11.859362,35.490002,21.600601,-13.889401,120.658252,375.338854,254.680602,0.6937,5.177889,4.484189,0.029258,0.354465,0.325207,0,0.012357,0.012357,0.900281,26.488882,25.588601,20.846339,43.985205,23.138866,8.722875,47.16697,38.444095,1.523863,10.358088,8.834225,0.260891,1.74912,1.488229,9.347722,9.741336,0.393614000000001,5.004315,11.037405,6.03309,128.312715,12.746369,-115.566346,93.206978,108.553051,15.346073,0.055183,3.95045,3.895267,0.151484,7.303046,7.151562,0.69291,49.679135,48.986225,1021.912206,390.045435,-631.866771,0.109549,0.078553,-0.030996,224.155758,17.364813,-206.790945,293.659684,3.408966,-290.250718,1.396131,0,-1.396131,0.454811,6.205028,5.750217,0.066067,44.416687,44.35062,1027.903518,104.456209,-923.447309,131.91132,21.034808,-110.876512,0.003454,0.172467,0.169013,0.007044,0.559193,0.552149,0.009865,0.018417,0.008552,1.513052,11.870801,10.357749,1.39511,17.290299,15.895189,0.166321,0.918499,0.752178,1.078015,6.337174,5.259159,0.004376,3.654618,3.650242,16.536689,31.477253,14.940564,0.003654,5.232169,5.228515,0.491717,11.257683,10.765966,6.048588,4.988987,-1.059601,34.59335,48.736714,14.143364,0.626722,0.634311,0.00758899999999996,0.930609,0.00531,-0.925299,10.422511,38.08413,27.661619,29.188526,4.889349,-24.299177,4.734375,22.282935,17.54856,15.836299,5.452538,-10.383761,0.018346,0.336291,0.317945,0.76823,0.153062,-0.615168,0.022046,0.820658,0.798612,0.001814,0.037105,0.035291,849.957084,616.766476,-233.190608,22.619498,16.134214,-6.485284,39.293152,2.003123,-37.290029,2.244259,7.361599,5.11734,4.024042,2.652108,-1.371934,2.398105,3.174314,0.776209,4.430797,4.006547,-0.42425,18.310282,0.075255,-18.235027,0,0,0,,,
2013-06-01,13019.473149,7380.71489,-5638.758259,30297.619524,22795.596184,-7502.02334,186853.700833808,132138.68524885,-54715.0155849583,14154.422608,0,-14154.422608,14478.02811,8972.518459,-5505.509651,32927.152715,29194.503944,-3732.648771,,,,12858.197174,15538.337682,2680.14050799999,50026.751946,43380.054449,-6646.697497,36371.724063,28895.861434,-7475.862629,5071.909368,3235.940151,-1835.969217,63175.308128,32779.617428,-30395.6907,184930.459517,134550.410192,-50380.0493249999,79508.274875,40653.581774,-38854.693101,2483.447344,2401.42059,-82.026754,1092.253309,2845.898699,1753.64539,4002.062213,1933.387204,-2068.675009,1.348782,0.736003,-0.612779,27099.136961,25393.740866,-1705.396095,0,0,0,22927.614985,17986.313583,-4941.301402,321.928599,424.053422,102.124823,12.827444,24.476328,11.648884,202.073933,266.976677,64.902744,393.537202,427.45372,33.916518,211.0031,93.047682,-117.955418,998.27022,584.307088,-413.963132,43.646049,837.899159,794.25311,4.155602,41.183532,37.02793,27.031723,231.596161,204.564438,0,21.192186,21.192186,33.045206,140.177274,107.132068,0.445904,17.198884,16.75298,0.707852,58.002012,57.29416,71.485135,156.430467,84.945332,356.63429,605.582001,248.947711,0.361786,2.23514,1.873354,0.354972,24.952614,24.597642,4.188313,11.942857,7.754544,0.396902,9.779748,9.382846,0.01176,0.627808,0.616048,0.18069,10.248755,10.068065,1.166134,20.509768,19.343634,0.193437,6.13986,5.946423,1.234358,5.426476,4.192118,3.503378,30.976925,27.473547,626.134458,288.872267,-337.262191,,,,1.896283,113.532684,111.636401,55.269643,63.598177,8.328534,1.046807,84.940998,83.894191,0.190402,49.327422,49.13702,2.708404,36.846841,34.138437,1924.558862,1320.187711,-604.371151,2345.903766,1151.379793,-1194.523973,41.57696,22.534799,-19.042161,26.440128,33.075999,6.635871,0.029804,1.189866,1.160062,746.345674,628.512016,-117.833658,627.974351,795.270599,167.296248,89.144486,67.072482,-22.072004,819.67617,1694.305726,874.629556,2322.485795,3884.560748,1562.074953,40.60924,151.377585,110.768345,44.766643,163.662891,118.896248,453.055215,935.476418,482.421203,0.000094,0.196116,0.196022,21.563236,26.840293,5.277057,834.066643,343.787109,-490.279534,0.006195,0.144105,0.13791,561.281429,427.119626,-134.161803,350.997633,252.699502,-98.298131,12.623871,0.132601,-12.49127,475.238927,175.610093,-299.628834,4373.398048,4514.521052,141.123004,2092.349054,578.858532,-1513.490522,1494.145317,3495.475942,2001.330625,1516.018955,2946.21018,1430.191225,42.370993,165.044237,122.673244,0.026921,0.125644,0.098723,2.631965,419.299223,416.667258,3520.675672,2632.831142,-887.84453,8794.753216,3899.853438,-4894.899778,789.906441,228.522646,-561.383795,,,,307.633337,136.064213,-171.569124,161.228562,19.378902,-141.84966,273.025605,161.310532,-111.715073,25.039559,1.60931,-23.430249,2366.102831,2794.654166,428.551335,41.047372,23.416101,-17.631271,24.586694,30.751785,6.165091,120.075512,51.3916,-68.683912,382.072758,387.57936,5.50660199999999,,,,2006.434593,781.329553,-1225.10504,10.707272,11.04803,0.340758000000001,126.424389,195.458528,69.034139,7.133938,4.810377,-2.323561,190.267568,18.742204,-171.525364,20.021715,38.388925,18.36721,104.490071,86.477703,-18.012368,0.188105,9.386656,9.198551,2.959237,3.713079,0.753842,0.002538,11.969129,11.966591,1.129089,68.967266,67.838177,0.42362,6.478712,6.055092,905.642596,810.717686,-94.9249100000001,215.766631,84.926266,-130.840365,0.134916,292.053294,291.918378,18.305717,36.835299,18.529582,0.358675,0.076514,-0.282161,0.003405,0,-0.003405,3227.860115,1623.387716,-1604.472399,,,,32.857224,12.383145,-20.474079,42.021172,12.054868,-29.966304,8.45175,1.60098,-6.85077,1.344578,3.970666,2.626088,,,,40.366413,11.371021,-28.995392,0.012388,0.676344,0.663956,0.157502,1.914019,1.756517,1.512774,5.982718,4.469944,93.555136,69.79981,-23.755326,127.274567,72.915427,-54.35914,37.591233,22.160957,-15.430276,562.303996,875.924564,313.620568,3.154394,7.108644,3.95425,0.753129,0.003765,-0.749364,8.286587,89.142139,80.855552,831.330674,199.637212,-631.693462,0,26.64971,26.64971,1054.1,696.3,-357.8,0.139439,0.01969,-0.119749,0.32982,0.090288,-0.239532,92.05472,177.23662,85.1819,903.759112,266.532296,-637.226816,,,,4704.330111,1651.011867,-3053.318244,109.112898,371.430659,262.317761,151.291316,1982.066327,1830.775011,0.007586,38.046179,38.038593,72.080156,137.385573,65.305417,34.099172,88.717859,54.618687,6.145676,156.863024,150.717348,3408.629233,2365.463859,-1043.165374,326.074292,112.305856,-213.768436,5.46074,2.859786,-2.600954,399.765972,52.027556,-347.738416,167.7578,23.269364,-144.488436,2.208323,7.316445,5.108122,2062.600774,1067.353199,-995.247575,2150.178873,398.487413,-1751.69146,2.249095,3.237624,0.988529,204.002421,18.920989,-185.081432,2181.905695,1241.172778,-940.732917,1448.359924,2756.472268,1308.112344,1470.704195,839.121695,-631.5825,0.021332,0.339477,0.318145,0.794194,66.675597,65.881403,744.412356,611.272205,-133.140151,21.622,36.245696,14.623696,0.000733,0.106868,0.106135,0.769462,2.3674,1.597938,35885.978832,9217.62633,-26668.352502,0.267238,14.1896,13.922362,0,4.013096,4.013096,5160.124624,3516.773751,-1643.350873,725.340918,3951.862008,3226.52109,3214.586426,2063.849012,-1150.737414,11257.646038,5674.775133,-5582.870905,754.539382,2496.091619,1741.552237,0.000397,0.010844,0.010447,0.00077,3.018869,3.018099,0.093807,0.006961,-0.086846,0.000545,0.000334,-0.000211,4.924881,13.516259,8.591378,304.368663,294.163077,-10.205586,0.080997,0.528269,0.447272,0.13147,0.007267,-0.124203,0.00899,0.005029,-0.003961,0.536498,1.965689,1.429191,1.375754,0.304538,-1.071216,0.316424,2.623214,2.30679,0.000346,0.008397,0.008051,0.050776,0.681063,0.630287,0.089437,0.109676,0.020239,6.377944,6.937727,0.559782999999999,0,0.045221,0.045221,3.630599,11.845857,8.215258,1.233836,1.966996,0.73316,0.315129,3.481608,3.166479,0.013591,1.794646,1.781055,0.053553,0,-0.053553,14.019823,5.320683,-8.69914,0.179169,1.537591,1.358422,47.995944,187.420927,139.424983,269.358152,268.502217,-0.855935000000045,37.198346,228.818005,191.619659,64.128488,11.2695,-52.858988,235.327742,464.452885,229.125143,0.578915,1.756261,1.177346,0.000045,0.633139,0.633094,0,0,0,60.398817,19.687228,-40.711589,23.83939,21.716868,-2.122522,45.251406,16.002116,-29.24929,2.500447,16.581895,14.081448,0.346351,4.215998,3.869647,8.662546,5.55274,-3.109806,1.175463,4.91258,3.737117,47.639816,18.331207,-29.308609,28.681459,71.644074,42.962615,0.001068,4.07474,4.073672,0.034956,8.181091,8.146135,0.494179,125.190228,124.696049,1717.27402,543.110383,-1174.163637,0.014579,0,-0.014579,77.771475,56.693917,-21.077558,208.962854,5.470306,-203.492548,0.101234,0,-0.101234,0.191699,12.680922,12.489223,0.502713,44.347941,43.845228,763.375414,139.60661,-623.768804,115.590391,19.102501,-96.48789,0,0.041425,0.041425,1.297657,0.780108,-0.517549,0.018546,0.009104,-0.009442,19.310104,17.660761,-1.649343,0.99386,19.771868,18.778008,0.163386,1.280477,1.117091,2.677547,1.264425,-1.413122,0.002053,1.934699,1.932646,19.937274,22.062443,2.125169,0.004001,0.419268,0.415267,0.230447,11.467735,11.237288,3.253331,9.223545,5.970214,36.076511,46.391293,10.314782,0.825944,1.478785,0.652841,2.449943,0.017447,-2.432496,2.621305,25.018569,22.397264,16.86718,1.934775,-14.932405,6.953917,36.380696,29.426779,13.423042,6.776542,-6.6465,0,0.739415,0.739415,0,0.204324,0.204324,0.023221,0.877782,0.854561,0.000561,0.023541,0.02298,683.303696,534.965606,-148.33809,41.407578,12.523121,-28.884457,17.636031,3.936384,-13.699647,2.326604,13.506526,11.179922,2.195074,1.304784,-0.89029,3.622951,6.846996,3.224045,4.677641,13.907311,9.22967,21.943223,0.022905,-21.920318,0,0,0,,,
2013-07-01,13499.289078,5993.703117,-7505.585961,34816.925182,20893.607121,-13923.318061,187817.081221545,130855.326258187,-56961.754963358,14007.697175,0,-14007.697175,13560.464444,7877.514092,-5682.950352,34431.792359,26737.462051,-7694.330308,,,,14722.484479,16046.549446,1324.064967,49738.221136,43186.346899,-6551.874237,41462.264378,26369.584746,-15092.679632,4453.015919,3021.658269,-1431.35765,67992.625987,29984.731925,-38007.894062,197311.660506,127280.872192,-70030.7883139999,85779.081278,36065.791842,-49713.289436,2618.840726,2362.095903,-256.744823,1155.742185,2580.604771,1424.862586,3427.079244,2142.239741,-1284.839503,0.851009,2.860093,2.009084,26192.314683,23604.522379,-2587.792304,0.000122,0,-0.000122,23545.906453,19581.82452,-3964.081933,381.033467,432.038617,51.00515,12.80706,20.247292,7.440232,233.732708,220.428274,-13.304434,418.941199,443.098897,24.157698,247.292205,80.678309,-166.613896,975.412236,598.698055,-376.714181,40.899716,909.670139,868.770423,2.592356,58.56959,55.977234,55.080575,278.220631,223.140056,0,20.821446,20.821446,28.346189,151.995495,123.649306,0.584537,19.146176,18.561639,1.175275,40.993128,39.817853,79.6951,118.01318,38.31808,362.428911,587.153751,224.72484,0.200202,2.175612,1.97541,0.752489,16.399017,15.646528,4.164332,10.014962,5.85063,0.767381,14.350334,13.582953,0.046813,0.450023,0.40321,0.286045,9.627354,9.341309,1.093627,29.161594,28.067967,0.600077,10.092041,9.491964,1.10456,12.154188,11.049628,5.08729,35.088948,30.001658,664.797253,197.088465,-467.708788,,,,1.292064,38.422484,37.13042,15.081019,28.673293,13.592274,0.974982,134.170395,133.195413,0.182132,62.491558,62.309426,0.609734,26.038999,25.429265,2145.492083,1573.385393,-572.10669,3283.573388,963.094557,-2320.478831,34.05293,26.623393,-7.429537,25.814544,25.915838,0.101293999999999,0.019918,156.500822,156.480904,987.912212,630.169408,-357.742804,709.169288,818.783529,109.614241,87.37678,104.418476,17.041696,816.277886,1506.553686,690.2758,2686.28368,4389.152129,1702.868449,42.501892,140.951315,98.449423,47.001975,204.455681,157.453706,319.942664,900.291908,580.349244,0.003705,0.081064,0.077359,18.504315,128.381684,109.877369,739.096135,308.18522,-430.910915,0.003206,0.025041,0.021835,465.150283,325.25387,-139.896413,435.14446,195.661265,-239.483195,13.933455,0.195323,-13.738132,598.738519,168.563607,-430.174912,4997.574418,3522.046028,-1475.52839,2720.531146,479.341817,-2241.189329,1483.773077,3678.281844,2194.508767,1742.049707,2330.553968,588.504261,47.754876,126.308731,78.553855,0.013565,0.778555,0.76499,5.708256,20.386108,14.677852,4417.600044,2583.582243,-1834.017801,9970.327007,3616.355483,-6353.971524,839.606101,599.343492,-240.262609,,,,355.217937,129.850593,-225.367344,187.977578,12.41126,-175.566318,295.790599,167.543139,-128.24746,26.046559,1.529365,-24.517194,2486.396893,2425.796646,-60.6002470000003,37.689009,20.215883,-17.473126,23.342205,41.532126,18.189921,125.367236,57.233626,-68.13361,474.940459,404.885159,-70.0553,,,,2405.334656,874.49955,-1530.835106,3.376743,6.760446,3.383703,92.479851,205.956398,113.476547,7.77472,10.222613,2.447893,278.364363,27.287067,-251.077296,3.001677,62.556829,59.555152,154.338241,73.211379,-81.126862,0.133,6.040553,5.907553,2.844266,2.297196,-0.54707,0.00201,2.717769,2.715759,2.961779,7.892664,4.930885,0.478465,113.885662,113.407197,1055.261758,802.389698,-252.87206,190.150793,59.349138,-130.801655,0.019929,291.698005,291.678076,15.236944,5.591457,-9.645487,0.571012,0.047335,-0.523677,0.044583,0.081578,0.036995,3705.23142,1336.674095,-2368.557325,,,,34.382506,40.724466,6.34196,51.184071,12.274839,-38.909232,5.532515,5.148466,-0.384049,2.199757,4.19685,1.997093,,,,52.07703,8.946643,-43.130387,0.007195,0.992295,0.9851,0.11609,1.847383,1.731293,1.4583,13.396084,11.937784,91.925972,101.445843,9.51987099999999,134.249201,59.254134,-74.995067,41.151809,24.854448,-16.297361,616.466482,853.948268,237.481786,5.630195,9.153519,3.523324,4.753202,0.398959,-4.354243,10.266389,73.729582,63.463193,1032.77383,160.049062,-872.724768,0.438976,23.07219,22.633214,1251.2,556.3,-694.9,0.059645,0,-0.059645,0.31046,0.103071,-0.207389,124.324802,190.719074,66.394272,957.816497,179.950359,-777.866138,,,,4676.509234,1379.459995,-3297.049239,36.577072,386.109767,349.532695,149.274769,1373.399578,1224.124809,0.108743,37.597576,37.488833,147.709602,128.802396,-18.907206,39.117261,72.772362,33.655101,1.186457,113.432158,112.245701,3966.235746,1885.280945,-2080.954801,347.638279,108.063331,-239.574948,6.574369,2.02929,-4.545079,540.28919,95.580594,-444.708596,222.836871,22.824194,-200.012677,3.77493,4.565994,0.791064,2208.109325,875.158591,-1332.950734,2412.882817,348.862805,-2064.020012,2.018141,2.14505,0.126909,255.680703,19.379819,-236.300884,2467.20168,1012.106347,-1455.095333,1769.252693,2462.191462,692.938769,1684.024581,767.370332,-916.654249,0,0.055426,0.055426,0.673332,15.204319,14.530987,856.512262,659.837779,-196.674483,6.21581,26.786287,20.570477,0.068395,0.182404,0.114009,0.913228,1.706633,0.793405,38800.430628,8723.70815,-30076.722478,0.38084,12.00866,11.62782,0,0,0,5604.947937,3472.1883,-2132.759637,386.390969,3340.646601,2954.255632,3309.481178,1786.909628,-1522.57155,11980.652148,5174.193412,-6806.458736,814.337785,2278.689248,1464.351463,0,0.043591,0.043591,0.501025,1.453411,0.952386,0.018243,0.005565,-0.012678,0,0.005621,0.005621,8.587603,10.005732,1.418129,303.917381,254.894328,-49.023053,0.116733,0.683734,0.567001,0.213034,0,-0.213034,0.023392,0.079559,0.056167,0.246912,1.920194,1.673282,1.262469,1.428803,0.166334,0.155642,0.911857,0.756215,0.003549,0,-0.003549,0.032584,0.420345,0.387761,0.021318,0.048756,0.027438,6.783913,4.866179,-1.917734,0.007968,0.054483,0.046515,2.532711,7.841212,5.308501,0.593645,3.680863,3.087218,0.013781,4.335173,4.321392,0.000353,1.288432,1.288079,0.046379,0,-0.046379,16.277718,6.262931,-10.014787,0.077834,1.56044,1.482606,68.259925,276.148031,207.888106,305.278019,118.35993,-186.918089,43.611161,26.426944,-17.184217,9.213501,26.55644,17.342939,123.854465,380.297634,256.443169,0.611494,0.96578,0.354286,0.000539,0.817851,0.817312,0.604394,0,-0.604394,83.329169,21.378508,-61.950661,0.146489,19.324398,19.177909,7.176971,19.212107,12.035136,1.492447,63.423635,61.931188,0.187556,2.731806,2.54425,6.719992,8.462688,1.742696,0.986193,5.21433,4.228137,67.898764,9.674844,-58.22392,21.727497,74.621877,52.89438,0.014413,3.21553,3.201117,0.208074,2.127033,1.918959,1.002647,61.589038,60.586391,823.047151,581.304926,-241.742225,0.033404,0,-0.033404,205.776531,20.152955,-185.623576,298.631247,3.15814,-295.473107,0,0,0,0.497122,4.090396,3.593274,0.043519,42.498482,42.454963,764.505293,121.811358,-642.693935,39.947182,14.234743,-25.712439,3.051605,0.346982,-2.704623,0.078414,0.623846,0.545432,0.02276,0.049544,0.026784,0.957177,21.76772,20.810543,1.361758,13.455974,12.094216,0.097265,0.348066,0.250801,0.39933,0.800241,0.400911,0.073248,3.460063,3.386815,19.434402,10.551168,-8.883234,0.003278,0.066587,0.063309,0.092709,12.511314,12.418605,5.841931,8.741416,2.899485,39.42761,43.292614,3.865004,0.32694,0.875204,0.548264,1.611344,0.03543,-1.575914,4.412098,21.711275,17.299177,28.211471,2.291062,-25.920409,6.152167,30.164741,24.012574,16.903477,9.313865,-7.589612,0,1.183308,1.183308,0,0.09396,0.09396,1.133011,0.500443,-0.632568,0.000172,0.090376,0.090204,831.711238,550.771805,-280.939433,42.985011,40.055572,-2.929439,27.066873,5.577886,-21.488987,4.435842,9.120109,4.684267,4.683425,1.185702,-3.497723,0.921499,5.041759,4.12026,3.828346,3.824137,-0.00420899999999991,54.40219,0.009435,-54.392755,0,7.476126,7.476126,,,
2013-08-01,13903.258523,6739.242636,-7164.015887,31286.385307,21967.203407,-9319.18190000001,188180.379091783,131165.113932276,-57015.2651595076,14981.652781,0,-14981.652781,14883.028591,9034.024932,-5849.003659,32491.384884,26732.15198,-5759.232904,,,,13573.99906,16430.882153,2856.883093,51763.454417,44564.323483,-7199.130934,37152.943316,26764.64248,-10388.300836,4785.852492,2899.282154,-1886.570338,67133.012333,32292.390229,-34840.622104,193050.664288,132584.007865,-60466.6564230001,84700.270486,39378.167452,-45322.103034,2673.718218,2623.761136,-49.9570819999999,1073.284968,2546.531772,1473.246804,3681.320645,2052.771237,-1628.549408,0.859549,0.178371,-0.681178,27775.113006,25373.202666,-2401.91034,0,0,0,23988.341411,19191.120817,-4797.220594,389.569516,453.182843,63.613327,3.166817,18.29343,15.126613,219.831022,318.231514,98.400492,402.732698,419.04305,16.310352,264.344543,137.937418,-126.407125,1014.938123,677.554598,-337.383525,48.42756,1008.030333,959.602773,0.775176,43.9483,43.173124,46.048117,262.576908,216.528791,0,19.472962,19.472962,21.182374,159.541234,138.35886,0.610407,19.719992,19.109585,1.03095,61.271253,60.240303,70.483563,97.556354,27.072791,382.302316,617.811713,235.509397,0.337309,2.370242,2.032933,0.737665,45.450585,44.71292,4.031879,9.786815,5.754936,0.265989,8.431772,8.165783,0.10696,1.371373,1.264413,0.375612,11.595473,11.219861,1.398171,60.339239,58.941068,0.138212,8.130015,7.991803,0.45961,6.963546,6.503936,5.912589,32.695128,26.782539,507.829883,225.007626,-282.822257,,,,4.058047,40.762677,36.70463,25.286275,60.93298,35.646705,1.279991,85.858886,84.578895,0.599618,49.43955,48.839932,2.984182,34.635397,31.651215,1729.523239,1467.214638,-262.308601,2527.456856,1068.286475,-1459.170381,44.645873,24.491508,-20.154365,33.020021,55.089695,22.069674,0.296375,1.344847,1.048472,1272.108904,751.981205,-520.127699,818.011102,880.270923,62.259821,86.921568,104.275214,17.353646,705.945883,1644.879085,938.933202,2514.665394,4233.797742,1719.132348,10.535314,154.497606,143.962292,26.633325,121.674913,95.041588,378.543209,925.108204,546.564995,4.446823,0.026892,-4.419931,15.868998,93.162582,77.293584,608.796732,362.914127,-245.882605,0,0.133183,0.133183,365.63162,514.61806,148.98644,367.369457,178.248659,-189.120798,10.709895,0.169156,-10.540739,528.070012,158.332221,-369.737791,4242.036593,3824.794165,-417.242428,2400.227883,547.382659,-1852.845224,1357.37653,3362.427415,2005.050885,1526.491185,2901.385693,1374.894508,48.173683,93.041631,44.867948,0.245746,0.53216,0.286414,29.056125,1.963924,-27.092201,3638.667533,2870.730127,-767.937406,9490.931232,4163.427885,-5327.503347,831.755165,199.015344,-632.739821,,,,336.365897,154.418243,-181.947654,125.502216,16.954126,-108.54809,297.074985,135.139696,-161.935289,21.861954,2.424959,-19.436995,2061.648465,1499.293076,-562.355389,39.249271,19.484188,-19.765083,21.27399,80.931727,59.657737,132.694454,78.009933,-54.684521,424.448856,273.180798,-151.268058,,,,2315.150115,941.803952,-1373.346163,10.471216,7.853639,-2.617577,81.656068,176.228749,94.572681,8.360673,5.048019,-3.312654,112.327685,29.794034,-82.533651,14.591597,55.169291,40.577694,137.931689,81.273223,-56.658466,0.317045,10.214663,9.897618,3.126294,4.305909,1.179615,0.000769,0.532666,0.531897,4.366101,12.717773,8.351672,0.287975,4.136468,3.848493,1058.747396,853.849043,-204.898353,201.006388,54.842484,-146.163904,0.000821,466.83274,466.831919,16.685985,7.748823,-8.937162,0.644278,0.300089,-0.344189,0.00253,0.909463,0.906933,3212.452282,1431.073684,-1781.378598,,,,32.454569,23.460785,-8.993784,53.127623,32.688061,-20.439562,5.183295,1.75204,-3.431255,6.481288,5.282438,-1.19885,,,,84.523292,12.274727,-72.248565,0.021825,1.834171,1.812346,0.019178,1.572491,1.553313,2.029285,3.188623,1.159338,95.517967,42.930039,-52.587928,144.421315,65.606793,-78.814522,52.051081,25.659808,-26.391273,574.042187,862.116805,288.074618,3.415027,9.52525,6.110223,0.972001,1.11978,0.147779,7.437098,96.560121,89.123023,1261.513055,154.082102,-1107.430953,0.01,11.473662,11.463662,968.2,658.3,-309.9,0.066727,0,-0.066727,0.241417,0.018891,-0.222526,113.043104,212.817592,99.774488,1183.072938,199.576013,-983.496925,,,,4790.639663,1231.476064,-3559.163599,80.466411,643.063019,562.596608,157.975928,1617.709729,1459.733801,0.251325,50.352148,50.100823,80.160934,154.93981,74.778876,61.125671,89.703879,28.578208,2.041706,126.192953,124.151247,3604.368833,2068.038878,-1536.329955,351.239635,134.984052,-216.255583,7.676212,2.539712,-5.1365,525.774827,54.318559,-471.456268,217.104744,38.573467,-178.531277,2.352663,6.402577,4.049914,2213.628593,919.478587,-1294.150006,2102.792218,378.828675,-1723.963543,2.287096,2.37222,0.085124,245.129934,17.2209,-227.909034,2303.413968,1106.376191,-1197.037777,1450.72983,2561.063828,1110.333998,1588.102191,742.292772,-845.809419,0.030749,0.085132,0.054383,1.479531,11.675232,10.195701,842.050268,712.076763,-129.973505,5.753982,39.549365,33.795383,0.013328,0.19048,0.177152,1.518218,1.989906,0.471688,39161.299515,9352.119496,-29809.180019,0.774483,10.117665,9.343182,0,0.555852,0.555852,5113.585022,3467.380176,-1646.204846,346.030677,4186.051506,3840.020829,3260.390784,1943.089628,-1317.301156,12013.381555,5667.479052,-6345.902503,768.350259,2184.532314,1416.182055,0,0,0,0.083721,0.017909,-0.065812,0.035305,0.013556,-0.021749,0.00191,0,-0.00191,6.245315,19.31439,13.069075,272.199436,299.389516,27.19008,0.128352,0.33297,0.204618,0.184776,0.179268,-0.00550799999999999,0.041675,0,-0.041675,1.121606,2.406325,1.284719,0.517111,0.748602,0.231491,0.075016,0.321592,0.246576,0.000036,0,-0.000036,0.097301,3.925706,3.828405,0.002547,0.060915,0.058368,6.175898,7.690168,1.51427,0,0.005696,0.005696,2.593231,8.804876,6.211645,0.841702,8.250163,7.408461,0.003934,3.131248,3.127314,0.008263,1.140584,1.132321,0.009941,0,-0.009941,14.314706,4.202921,-10.111785,0.253944,2.075524,1.82158,51.77474,268.456895,216.682155,420.937261,170.47381,-250.463451,165.799858,38.160888,-127.63897,33.247899,10.307993,-22.939906,151.192241,328.628419,177.436178,0.11,11.16298,11.05298,0.103005,0.832045,0.72904,0,0,0,110.453829,18.972545,-91.481284,64.382153,35.668733,-28.71342,8.071152,49.652409,41.581257,1.186874,18.553816,17.366942,0.974298,3.973389,2.999091,2.471034,4.161827,1.690793,12.769959,5.83408,-6.935879,63.842067,12.314738,-51.527329,17.721978,83.126531,65.404553,0.507764,2.326782,1.819018,0.145865,2.137446,1.991581,0.397035,61.916407,61.519372,750.788497,744.874229,-5.91426799999999,0.164868,0,-0.164868,175.291967,27.185499,-148.106468,147.8134,1.908054,-145.905346,0.581379,0,-0.581379,0.955179,6.202058,5.246879,0.114204,54.138345,54.024141,1145.846998,108.05822,-1037.788778,228.48366,20.584996,-207.898664,0.105415,0.109812,0.00439700000000001,0.118757,0.391333,0.272576,0.029146,0.132807,0.103661,17.16959,15.725992,-1.443598,5.3402,6.477138,1.136938,0.003472,0.145927,0.142455,0.391821,3.057203,2.665382,0.083622,1.000113,0.916491,20.329295,13.966834,-6.36246099999999,0.000284,0.213692,0.213408,0.088177,8.18982,8.101643,3.0437,6.956595,3.912895,38.760156,43.338105,4.577949,0.169096,0.579486,0.41039,0.268835,0.008869,-0.259966,3.596065,23.404421,19.808356,30.14946,5.751998,-24.397462,7.9573,16.133415,8.176115,12.99544,4.463646,-8.531794,0.001536,0.889525,0.887989,0.006634,0.018299,0.011665,1.53539,1.269461,-0.265929,0.000131,0.122748,0.122617,744.044906,581.245661,-162.799245,11.755294,10.979059,-0.776235,9.617461,19.554129,9.936668,1.92366,16.920505,14.996845,8.036853,0.966584,-7.070269,1.129741,1.963746,0.834005,6.551204,7.840746,1.289542,29.388945,0.100786,-29.288159,0,0,0,,,
2013-09-01,12440.439426,6775.674368,-5664.765058,31394.705749,22716.695791,-8678.00995800001,191294.858643186,130593.727737873,-60701.1309053129,14429.987418,0,-14429.987418,15610.497811,8702.003619,-6908.494192,35076.193744,26752.330513,-8323.863231,,,,13168.919309,15487.0526,2318.133291,51472.07766,42904.182828,-8567.89483199999,37821.359404,27467.058763,-10354.300641,4285.702858,2405.758267,-1879.944591,67417.651502,31481.569307,-35936.082195,191940.918026,128377.55544,-63563.3625859998,84256.757643,37599.411031,-46657.346612,2673.984945,2530.362579,-143.622366,934.455584,2512.641613,1578.186029,3351.680544,1804.64052,-1547.040024,1.645568,1.450338,-0.19523,28168.814937,24881.16262,-3287.652317,0,0,0,23303.262723,18023.020208,-5280.242515,309.693505,484.436822,174.743317,10.728293,15.494194,4.765901,208.245464,272.015953,63.770489,392.364938,487.861514,95.496576,247.755346,95.714005,-152.041341,1149.620969,576.747,-572.873969,53.742877,744.257628,690.514751,2.283534,36.702193,34.418659,53.542273,388.479341,334.937068,0,19.852753,19.852753,29.275457,165.091624,135.816167,1.044006,15.009919,13.965913,0.840473,58.358382,57.517909,79.697252,90.11077,10.413518,366.304723,613.587285,247.282562,0.350268,2.258782,1.908514,0.301736,17.799077,17.497341,4.041104,9.522072,5.480968,0.542803,9.983416,9.440613,0.015708,0.554692,0.538984,0.231833,8.090996,7.859163,1.474851,38.80687,37.332019,0.174427,9.247927,9.0735,0.646269,10.524131,9.877862,5.33231,39.941829,34.609519,432.859009,218.654876,-214.204133,,,,1.968453,30.445006,28.476553,5.390921,55.188173,49.797252,6.334841,133.601777,127.266936,0.137919,46.778668,46.640749,2.87009,26.922716,24.052626,1723.075727,1551.182029,-171.893698,2272.860481,1044.094966,-1228.765515,22.655354,26.291421,3.636067,14.655526,34.090458,19.434932,0.002502,0.996962,0.99446,1081.748305,777.880535,-303.86777,703.163954,815.467424,112.30347,76.016836,105.501521,29.484685,659.385091,1413.90235,754.517259,2707.688307,3719.299559,1011.611252,33.178521,169.176082,135.997561,26.672412,150.252569,123.580157,476.160356,956.570769,480.410413,3.844285,0.305564,-3.538721,20.887197,37.708339,16.821142,690.997747,340.365542,-350.632205,0,0,0,472.140445,342.093981,-130.046464,407.233667,216.092609,-191.141058,11.236062,0.205414,-11.030648,505.647084,158.141968,-347.505116,4104.102662,4008.212917,-95.8897450000004,2678.559379,498.638578,-2179.920801,1393.82177,4340.176146,2946.354376,1520.684429,2827.502832,1306.818403,45.642882,259.719288,214.076406,0.016589,0.705076,0.688487,8.009075,2.239142,-5.769933,3527.853981,2626.591178,-901.262803,10038.464673,3751.590557,-6286.874116,788.677615,338.037909,-450.639706,,,,329.050137,165.139933,-163.910204,134.83295,19.170228,-115.662722,340.312746,158.868818,-181.443928,25.349467,1.720547,-23.62892,2148.351758,1423.778942,-724.572816,24.884416,29.145688,4.261272,23.712412,42.728033,19.015621,115.759379,77.080299,-38.67908,413.330984,246.103904,-167.22708,,,,2572.353372,1068.463868,-1503.889504,8.738703,5.226794,-3.511909,95.820072,168.260233,72.440161,6.280338,4.766734,-1.513604,218.61431,46.976787,-171.637523,20.213215,38.41144,18.198225,188.671204,180.025953,-8.645251,0.15392,8.365389,8.211469,3.915161,4.045393,0.130232,0.009203,6.404605,6.395402,2.83455,9.716928,6.882378,0.316011,6.945512,6.629501,775.785507,743.219975,-32.5655320000001,243.765375,71.382819,-172.382556,0.002852,300.253144,300.250292,22.814384,130.965893,108.151509,0.502579,0.200983,-0.301596,0.031628,0.353415,0.321787,2899.143634,1478.5218,-1420.621834,,,,35.987923,22.226042,-13.761881,50.140545,20.841587,-29.298958,3.348267,3.564014,0.215747,3.154389,4.005364,0.850975,,,,72.313295,9.738285,-62.57501,0.046811,1.101911,1.0551,0.256812,1.419652,1.16284,1.72791,4.002131,2.274221,87.052426,40.193774,-46.858652,155.225944,64.861446,-90.364498,36.282396,30.957311,-5.325085,541.35846,1069.662996,528.304536,4.938702,10.218717,5.280015,1.240495,0.521009,-0.719486,4.593089,62.427893,57.834804,875.117155,126.175503,-748.941652,0.091482,18.919923,18.828441,1216.4,697.8,-518.6,0.077841,0,-0.077841,0.460482,0.009926,-0.450556,111.540326,101.68493,-9.855396,1118.696804,239.362214,-879.33459,,,,4687.310613,1525.620556,-3161.690057,91.591873,199.711738,108.119865,120.825656,2069.760864,1948.935208,20.675947,55.158785,34.482838,76.495879,131.268486,54.772607,55.807349,72.380188,16.572839,3.658015,112.988085,109.33007,3310.725307,1604.276376,-1706.448931,288.822,101.343644,-187.478356,8.01112,2.509304,-5.501816,408.764261,42.812736,-365.951525,204.608824,33.476343,-171.132481,2.901359,3.504702,0.603343,2316.671564,934.952161,-1381.719403,2161.831649,364.070358,-1797.761291,2.495313,2.207209,-0.288104,267.962465,12.483062,-255.479403,2324.866791,1225.477702,-1099.389089,1530.975456,2668.473905,1137.498449,1386.783868,709.006252,-677.777616,0.05525,0.022863,-0.032387,1.308841,20.671515,19.362674,802.979789,666.005302,-136.974487,6.835557,19.124793,12.289236,0.086581,0.352426,0.265845,1.881929,1.185499,-0.69643,40144.392508,9527.176643,-30617.215865,5.079439,20.492257,15.412818,0,0,0,5117.277144,3027.92967,-2089.347474,847.30486,3810.714429,2963.409569,3222.4509,1807.094179,-1415.356721,11123.24822,5527.603151,-5595.645069,696.16032,2168.18753,1472.02721,0.000803,0.04309,0.042287,0.069223,1.408175,1.338952,0.018125,0.012264,-0.005861,0,0.077132,0.077132,7.801934,10.16094,2.359006,205.265314,293.943296,88.677982,0.003082,0.476137,0.473055,0.075711,0.567268,0.491557,0.01138,0.021482,0.010102,0.194353,2.107594,1.913241,0.84506,1.387667,0.542607,0.217914,3.249434,3.03152,0.11958,0,-0.11958,0.07401,0.376399,0.302389,0.000457,0.036149,0.035692,5.749464,5.656908,-0.0925560000000001,0,0.017059,0.017059,2.331014,9.759744,7.42873,2.704639,1.97271,-0.731929,0.077832,3.090002,3.01217,0.01059,1.407403,1.396813,0.011857,0.027658,0.015801,12.724305,6.472169,-6.252136,0.100423,2.131793,2.03137,118.403566,81.603838,-36.799728,531.170252,75.339606,-455.830646,28.461317,77.438064,48.976747,8.45439,14.767693,6.313303,105.072475,286.841516,181.769041,0.074168,0.184798,0.11063,0.000001,1.647912,1.647911,0.065405,0.068553,0.003148,131.523759,13.620961,-117.902798,0.135511,25.527225,25.391714,5.95109,21.869202,15.918112,1.234027,13.046737,11.81271,0.831408,5.343238,4.51183,3.650472,3.129785,-0.520687,1.896346,6.213629,4.317283,40.015017,6.854884,-33.160133,12.295556,80.244585,67.949029,0.046032,3.702281,3.656249,0.078569,1.383159,1.30459,0.579753,108.23199,107.652237,740.754595,518.80737,-221.947225,0.138848,0.535265,0.396417,225.690071,11.931872,-213.758199,339.99753,3.362261,-336.635269,0.730249,0.037459,-0.69279,0.666297,10.062025,9.395728,0.560093,46.952248,46.392155,771.945822,102.107338,-669.838484,129.838077,13.336733,-116.501344,0.000516,0.374362,0.373846,0.039842,0.713267,0.673425,0.053202,0.268384,0.215182,2.067576,11.865357,9.797781,18.337004,13.93798,-4.399024,0.07589,0.233797,0.157907,2.099612,1.981727,-0.117885,0.230806,0.350024,0.119218,17.937852,9.290666,-8.647186,0.002789,0.124279,0.12149,1.610924,6.766335,5.155411,2.568479,12.34627,9.777791,40.205379,47.324087,7.118708,0.569453,0.818011,0.248558,0.788472,0.026021,-0.762451,4.7894,27.958131,23.168731,29.456512,3.327003,-26.129509,8.930451,33.444042,24.513591,24.551194,4.690953,-19.860241,0.000002,0.624588,0.624586,0.161075,2.29216,2.131085,1.003603,0.359457,-0.644146,0.000587,0.300297,0.29971,708.920057,492.352258,-216.567799,19.557216,52.644209,33.086993,24.517646,2.377677,-22.139969,3.494858,9.885427,6.390569,9.535812,2.371078,-7.164734,1.145428,5.64386,4.498432,2.749323,3.663018,0.913695,22.448361,0.058515,-22.389846,0,0,0,,,
2013-10-01,12804.924591,7241.93206,-5562.992531,37074.105734,23287.575902,-13786.529832,191086.941606565,134237.583858163,-56849.3577484019,16338.111668,0,-16338.111668,15851.180896,9128.272522,-6722.908374,37329.682099,27696.438973,-9633.243126,,,,13045.965905,15666.19481,2620.228905,54949.365119,48094.07721,-6855.287909,43762.491423,28527.895861,-15234.595562,3647.364268,3124.697014,-522.667254,70559.35052,36544.252216,-34015.098304,205089.657917,142061.250573,-63028.407344,88613.821716,43924.780226,-44689.04149,2619.212009,2607.263366,-11.9486429999997,1069.940685,2649.923529,1579.982844,2956.45992,2183.153537,-773.306382999999,0.708801,0.948309,0.239508,29634.436835,27028.748556,-2605.688279,0,0.005129,0.005129,25314.928284,21065.328654,-4249.59963,378.268513,403.519879,25.251366,11.789296,19.827767,8.038471,208.795149,340.633385,131.838236,381.59244,509.314375,127.721935,235.294945,91.971633,-143.323312,1034.202382,637.560769,-396.641613,35.837656,922.9206,887.082944,3.061812,44.457596,41.395784,68.645973,193.057853,124.41188,0,34.933804,34.933804,25.66314,119.47079,93.80765,3.481684,19.329515,15.847831,0.620927,59.132287,58.51136,75.035377,107.29236,32.256983,381.05858,624.263325,243.204745,0.207839,2.608264,2.400425,0.547504,22.257598,21.710094,5.005768,26.859949,21.854181,0.380341,13.032357,12.652016,1.847034,0.521308,-1.325726,0.195147,5.968533,5.773386,1.445406,83.48123,82.035824,0.624341,6.904884,6.280543,0.743389,11.968839,11.22545,5.21792,46.740298,41.522378,409.220076,233.917329,-175.302747,,,,4.639953,79.353656,74.713703,13.908149,29.982876,16.074727,2.384466,38.925982,36.541516,0.328089,43.822274,43.494185,3.902603,19.557763,15.65516,1762.907047,1607.684169,-155.222878,2964.134828,1049.022188,-1915.11264,40.874278,31.784579,-9.089699,22.638388,38.394488,15.7561,0.00001,0.783671,0.783661,888.502972,539.257756,-349.245216,688.715704,863.181538,174.465834,94.770319,73.603466,-21.166853,586.542189,1569.47844,982.936251,2273.295312,3931.718216,1658.422904,27.152818,170.032488,142.87967,24.96049,144.211341,119.250851,377.525651,853.430202,475.904551,0,0.02319,0.02319,25.952902,14.399537,-11.553365,852.516677,366.942326,-485.574351,0,0.125302,0.125302,686.495317,346.969695,-339.525622,397.32603,196.866612,-200.459418,11.718826,0.359461,-11.359365,567.13092,182.423495,-384.707425,4985.002228,4266.820119,-718.182109,3408.086076,607.403493,-2800.682583,1756.458738,4236.29504,2479.836302,1842.864179,2703.17981,860.315631,43.788587,124.821113,81.032526,0.22688,0.447621,0.220741,2.239399,1.530223,-0.709176,4577.929736,2935.036375,-1642.893361,10884.483383,4045.503445,-6838.979938,876.302099,199.470673,-676.831426,,,,375.453799,175.565107,-199.888692,153.001158,35.826026,-117.175132,397.281793,152.924167,-244.357626,25.292116,1.87988,-23.412236,2450.29565,2189.501883,-260.793767,28.425681,26.343254,-2.082427,21.334349,46.189677,24.855328,159.446395,78.6281,-80.818295,472.876431,283.209524,-189.666907,,,,2634.860829,1047.338991,-1587.521838,10.172252,8.465955,-1.706297,48.087122,116.071923,67.984801,8.270817,9.387601,1.116784,3.274952,25.306414,22.031462,1.417647,44.464105,43.046458,160.78603,71.580332,-89.205698,0.174523,9.029427,8.854904,3.325461,4.193305,0.867844,0.006198,1.335356,1.329158,3.012363,4.22509,1.212727,0.278836,3.787826,3.50899,1031.561033,949.422614,-82.138419,259.286198,76.000627,-183.285571,0,382.339779,382.339779,14.772201,59.629777,44.857576,0.515515,0.291646,-0.223869,0.003751,0.052354,0.048603,3591.753404,1278.562009,-2313.191395,,,,35.759932,21.05962,-14.700312,46.873096,25.385009,-21.488087,4.93714,2.675326,-2.261814,3.898638,0.91078,-2.987858,,,,65.837547,10.580338,-55.257209,0.038238,1.251664,1.213426,0.188801,1.798889,1.610088,3.050659,3.900676,0.850017,83.442958,60.25833,-23.184628,164.796195,76.815233,-87.980962,41.892613,45.758571,3.86595800000001,534.02728,936.11858,402.0913,4.259845,31.235756,26.975911,1.163117,1.534568,0.371451,7.000597,74.775065,67.774468,1043.676184,185.378887,-858.297297,0,14.163004,14.163004,1143,648.1,-494.9,0.106841,0,-0.106841,0.339734,0.147364,-0.19237,111.543178,165.151405,53.608227,1030.009278,227.152347,-802.856931,,,,4720.48409,1624.944652,-3095.539438,117.933868,403.306254,285.372386,140.594183,2239.887907,2099.293724,21.005254,51.635159,30.629905,74.949469,118.49862,43.549151,47.495288,84.041434,36.546146,12.554342,143.249659,130.695317,3684.885133,1733.636935,-1951.248198,346.968133,121.472174,-225.495959,7.019222,3.693991,-3.325231,477.692133,45.867884,-431.824249,228.22532,21.972903,-206.252417,4.587026,5.524212,0.937186000000001,2399.565371,1063.648942,-1335.916429,2479.010087,449.740903,-2029.269184,2.312845,1.367824,-0.945021,272.529505,17.353042,-255.176463,2461.247797,1173.541151,-1287.706646,1562.990632,2858.027181,1295.036549,1916.732955,1067.84745,-848.885505,0,0.296763,0.296763,1.659087,136.226425,134.567338,863.038153,665.822584,-197.215569,7.069132,38.679999,31.610867,0.086923,0.187015,0.100092,1.89436,5.906483,4.012123,41845.472131,13147.763822,-28697.708309,0.346153,13.632105,13.285952,0,0,0,5152.26667,3523.094263,-1629.172407,402.712102,3493.703728,3090.991626,3393.797684,2341.618917,-1052.178767,11909.918836,5502.51769,-6407.401146,766.798643,2246.25581,1479.457167,0,0.806263,0.806263,0.047936,6.221011,6.173075,0.769013,0,-0.769013,0.000566,0.000145,-0.000421,9.243985,11.352861,2.108876,266.402713,337.800335,71.397622,0.024835,0.540886,0.516051,0.051516,0.02539,-0.026126,0.027169,0.011158,-0.016011,0.113754,3.807246,3.693492,1.698979,0.191949,-1.50703,0.094823,10.405866,10.311043,0.000066,0.001136,0.00107,0.110644,0.265257,0.154613,0.051359,0.033022,-0.018337,4.436092,5.322941,0.886849,0.004382,0.026399,0.022017,3.385141,9.727106,6.341965,1.605481,2.792094,1.186613,0.086571,3.512075,3.425504,0.149819,1.776908,1.627089,0.042272,0.028528,-0.013744,14.652195,7.692384,-6.959811,0.194581,1.327568,1.132987,110.562514,209.643368,99.080854,352.733415,143.14612,-209.587295,41.514326,113.079867,71.565541,4.131723,4.394332,0.262609,127.290013,416.617348,289.327335,0.56,1.180186,0.620186,0.000023,2.607425,2.607402,0.002379,0.035182,0.032803,105.732805,15.974134,-89.758671,0.18686,13.39687,13.21001,15.882543,30.198228,14.315685,1.65213,18.268249,16.616119,0.050127,5.748913,5.698786,9.085809,8.270597,-0.815211999999999,12.428469,10.941823,-1.486646,27.115157,23.039806,-4.075351,11.353568,91.016691,79.663123,0.503383,1.272892,0.769509,0.359022,2.296022,1.937,0.572668,62.512674,61.940006,754.301602,602.426909,-151.874693,0.077824,0.394632,0.316808,72.11397,14.493387,-57.620583,95.641774,4.244756,-91.397018,0.031404,0.000084,-0.03132,1.024847,8.79086,7.766013,0.548782,52.112249,51.563467,735.365307,156.351425,-579.013882,214.116851,25.010132,-189.106719,0.002286,1.255905,1.253619,0.180292,0.527273,0.346981,0.008942,0.181377,0.172435,1.290173,10.280556,8.990383,15.239749,14.297548,-0.942200999999999,0.16182,0.225297,0.063477,0.963377,0.733674,-0.229703,0.101826,0.440186,0.33836,10.850483,51.506925,40.656442,0.015507,0.214942,0.199435,0.036551,12.999373,12.962822,4.417472,11.448662,7.03119,36.77168,179.79679,143.02511,0.274271,0.830195,0.555924,1.132452,0.003071,-1.129381,2.92058,44.230272,41.309692,33.013847,6.276776,-26.737071,9.288597,54.5722,45.283603,12.070415,3.976068,-8.094347,0.000478,1.38026,1.379782,0.002819,0.007408,0.004589,0.443326,1.406202,0.962876,0.000155,0.111622,0.111467,645.85988,596.048779,-49.811101,46.632666,14.727717,-31.904949,20.443488,4.670034,-15.773454,4.137169,17.396598,13.259429,6.509183,1.753043,-4.75614,0.905465,5.569018,4.663553,9.353118,6.290269,-3.062849,33.425245,0.035824,-33.389421,0,72.728485,72.728485,,,
2013-11-01,11303.253182,6490.365244,-4812.887938,33064.023725,22732.417351,-10331.606374,189221.421851066,134981.157811815,-54240.2640392507,15289.416223,0,-15289.416223,14943.375783,8605.421774,-6337.954009,37267.0745,27940.150633,-9326.923867,,,,11957.714535,14807.426007,2849.711472,51090.947322,44971.91001,-6119.037312,38474.050885,28151.442846,-10322.608039,2738.471774,2799.053755,60.5819809999998,67149.665141,35963.024883,-31186.640258,188617.830337,136200.329241,-52417.5010960001,83216.778802,43064.941306,-40151.837496,2282.439459,2557.306758,274.867299,1139.377708,2344.585303,1205.207595,2124.800266,2066.674791,-58.1254749999994,0.436437,0.032089,-0.404348,27367.598442,25681.48845,-1686.109992,0.052874,0.005433,-0.047441,23723.34888,19290.42156,-4432.92732,264.411421,446.005923,181.594502,10.477574,18.492294,8.01472,169.357758,334.625581,165.267823,361.444691,453.460872,92.016181,215.733235,76.801506,-138.931729,923.235665,625.527674,-297.707991,29.267073,948.108285,918.841212,1.325442,45.458279,44.132837,26.627341,340.61557,313.988229,0,11.095274,11.095274,34.55883,154.419606,119.860776,0.607033,23.152819,22.545786,0.58417,63.578128,62.993958,67.129272,90.730319,23.601047,348.256689,620.885202,272.628513,0.432896,3.098949,2.666053,0.131339,45.693516,45.562177,4.375818,17.158513,12.782695,1.654439,18.137003,16.482564,0.086348,1.103998,1.01765,0.120264,5.780295,5.660031,2.289316,16.106078,13.816762,0.128832,10.65153,10.522698,0.420798,11.711114,11.290316,4.880977,45.938115,41.057138,504.414281,210.424046,-293.990235,,,,8.293883,99.368962,91.075079,8.471856,66.842838,58.370982,3.084974,136.527108,133.442134,0.194758,43.092406,42.897648,13.527373,21.059821,7.532448,1454.393022,1621.076631,166.683609,2619.382623,1071.125428,-1548.257195,28.021702,29.5799,1.558198,30.015249,41.322857,11.307608,0.000196,2.136676,2.13648,879.666869,530.75182,-348.915049,730.529334,803.269502,72.740168,80.405765,73.300565,-7.1052,554.262184,1386.508211,832.246027,2050.671048,3127.92159,1077.250542,23.08872,174.493377,151.404657,38.158621,127.273082,89.114461,458.843995,812.98128,354.137285,4.750861,0.033464,-4.717397,24.359826,33.834264,9.474438,844.348937,290.662686,-553.686251,0.010292,0.014022,0.00373,488.233985,417.960014,-70.273971,413.096317,183.047221,-230.049096,9.091819,0.162051,-8.929768,586.088712,239.325123,-346.763589,4283.993504,3903.682245,-380.311259,2390.591392,555.142057,-1835.449335,1588.775807,3816.844664,2228.068857,1593.484935,2679.441614,1085.956679,40.475387,128.357096,87.881709,0.0822,0.224156,0.141956,1.972823,4.492671,2.519848,3783.868434,2770.375715,-1013.492719,10383.972787,4394.799541,-5989.173246,874.253394,208.223792,-666.029602,,,,337.185358,218.432834,-118.752524,185.368858,21.05082,-164.318038,379.503536,126.804522,-252.699014,24.605243,1.45544,-23.149803,2217.514866,2088.622031,-128.892835,27.880837,26.295051,-1.585786,22.689741,65.602053,42.912312,145.387332,107.472358,-37.914974,389.346658,348.965346,-40.381312,,,,1854.034149,950.842724,-903.191425,4.707489,7.756052,3.048563,49.834056,211.41453,161.580474,11.776358,5.570305,-6.206053,0.081107,34.937185,34.856078,15.290854,51.901802,36.610948,169.574453,144.369274,-25.205179,0.23098,7.986834,7.755854,2.732125,3.574128,0.842003,0.019421,1.231186,1.211765,1.635376,8.372273,6.736897,0.905309,68.177074,67.271765,883.89485,934.847589,50.952739,224.311149,67.845782,-156.465367,0.000032,369.04507,369.045038,13.850825,118.530889,104.680064,0.51133,0.07795,-0.43338,0.000323,0.10947,0.109147,3320.866663,1336.581087,-1984.285576,,,,29.23853,27.390956,-1.847574,52.714795,16.007877,-36.706918,4.448135,2.131525,-2.31661,9.937244,3.158373,-6.778871,,,,85.090048,11.108789,-73.981259,0.007384,2.824372,2.816988,0.054979,1.139818,1.084839,2.897262,4.595004,1.697742,69.73004,61.332156,-8.397884,156.088789,49.381094,-106.707695,39.863133,27.238,-12.625133,430.387692,981.937108,551.549416,3.153025,8.737183,5.584158,0.431018,0.175083,-0.255935,5.909486,104.925036,99.01555,598.910096,134.90651,-464.003586,0,42.565459,42.565459,1234.6,690.1,-544.5,0,0.068168,0.068168,0.869074,0.019983,-0.849091,96.771451,124.299459,27.528008,1296.16772,220.197457,-1075.970263,,,,4355.586222,1499.994171,-2855.592051,64.530645,329.673276,265.142631,138.318133,1698.677903,1560.35977,0.082279,33.6941,33.611821,52.939623,119.945822,67.006199,49.209236,88.534772,39.325536,1.711534,131.072706,129.361172,2863.409351,1861.126829,-1002.282522,264.672593,114.103338,-150.569255,5.080579,2.482228,-2.598351,380.760248,79.114872,-301.645376,204.30066,20.873976,-183.426684,3.508342,14.702812,11.19447,2279.015944,959.731638,-1319.284306,2221.030393,481.719415,-1739.310978,2.920557,2.520718,-0.399839,213.359992,23.171087,-190.188905,2186.422018,1044.246973,-1142.175045,1341.571097,2524.244218,1182.673121,1472.103844,698.641127,-773.462717,0,0.010119,0.010119,0.658113,218.623423,217.96531,764.419197,912.757418,148.338221,10.344151,31.234314,20.890163,0.013932,0.188752,0.17482,1.917639,1.636374,-0.281265,40112.279565,13027.082593,-27085.196972,0.18477,5.873268,5.688498,0,0.741012,0.741012,5059.06008,3841.84165,-1217.21843,378.705556,3228.17391,2849.468354,3108.393651,2282.978723,-825.414928,11603.000684,5846.982848,-5756.017836,825.296038,2006.925891,1181.629853,0,0.100481,0.100481,0.054882,0.070882,0.016,0.001793,0,-0.001793,0,0.069063,0.069063,49.516308,14.576253,-34.940055,237.894839,284.715542,46.820703,0.000099,0.645892,0.645793,0.064219,0.004346,-0.059873,0.016666,0.020427,0.003761,0.364742,3.153287,2.788545,1.505548,0.605417,-0.900131,0.042175,0.507167,0.464992,0.000005,0,-0.000005,0.142556,0.145711,0.00315500000000002,0.012335,0.079315,0.06698,5.554519,5.898578,0.344059,0,0.05763,0.05763,2.528158,12.693997,10.165839,0.655159,2.039884,1.384725,0.050592,3.918613,3.868021,0.008738,1.615993,1.607255,0.185803,0.191692,0.00588900000000001,15.273573,5.04789,-10.225683,0.212233,1.562886,1.350653,67.268247,105.279457,38.01121,414.435072,88.662818,-325.772254,28.406733,98.702821,70.296088,4.482172,7.589658,3.107486,96.274143,381.951423,285.67728,0.224,13.681503,13.457503,0.005812,0.612188,0.606376,0.01769,0.003176,-0.014514,16.651068,21.161189,4.510121,0.281261,15.908607,15.627346,54.904072,26.292681,-28.611391,1.3484,26.130358,24.781958,0.27955,2.254141,1.974591,8.039702,3.527909,-4.511793,1.252217,8.169409,6.917192,44.355305,12.634781,-31.720524,8.136575,69.201583,61.065008,0.000046,2.905557,2.905511,0.578058,1.58596,1.007902,0.529152,140.710936,140.181784,467.733467,661.448103,193.714636,0.002342,0.586805,0.584463,15.147111,19.039248,3.892137,238.682076,3.879438,-234.802638,0.501616,0.005205,-0.496411,0.623367,3.561249,2.937882,0.116137,52.123703,52.007566,467.823571,156.702261,-311.12131,35.97169,17.173497,-18.798193,0.008716,0.053815,0.045099,0.133354,0.458148,0.324794,0.035001,0.161959,0.126958,25.159334,8.409987,-16.749347,14.176358,19.22527,5.048912,0.662894,0.24132,-0.421574,3.536102,2.818884,-0.717218,0.063818,0.375417,0.311599,8.683985,25.281668,16.597683,0,0.171375,0.171375,0.119641,26.193244,26.073603,4.87519,8.870953,3.995763,56.484465,31.491679,-24.992786,0.149715,1.075422,0.925707,4.587929,0,-4.587929,4.385477,14.447545,10.062068,22.085543,3.20659,-18.878953,8.148031,14.108156,5.960125,13.217595,3.137307,-10.080288,0.0014,0.233784,0.232384,0.422549,0.117724,-0.304825,1.328357,1.255,-0.0733570000000001,0.150177,0.244373,0.094196,484.408296,452.372668,-32.035628,23.392933,14.30695,-9.085983,35.594629,8.247798,-27.346831,2.427499,11.969347,9.541848,3.742778,3.430205,-0.312573,1.220284,7.947587,6.727303,15.20261,3.836409,-11.366201,32.688595,0.090745,-32.59785,0,60.932492,60.932492,,,
2013-12-01,11410.42665,7421.862705,-3988.563945,32074.88973,20803.96381,-11270.92592,187989.145507712,133370.214359338,-54618.9311483737,13777.296404,0,-13777.296404,14011.443598,7541.292684,-6470.150914,34199.278838,28238.019923,-5961.258915,,,,12230.282824,16070.646268,3840.363444,49113.54514,41796.0794,-7317.46574,37037.276541,25585.150003,-11452.126538,2658.210118,2888.62293,230.412812,63802.377166,35813.260118,-27989.117048,182462.704915,131915.459503,-50547.2454119998,80355.63738,42840.633177,-37515.004203,2434.490155,2390.032276,-44.4578790000005,1067.597382,2695.391931,1627.794549,2113.33762,1922.282458,-191.055162,0.15553,0.201788,0.046258,26987.483595,23698.915599,-3288.567996,0,0,0,22126.061545,18097.163801,-4028.897744,354.835468,471.717118,116.88165,11.044252,19.124472,8.08022,195.907278,234.122463,38.215185,372.535301,454.991976,82.456675,243.940638,80.792485,-163.148153,923.262988,617.233059,-306.029929,43.317222,786.327807,743.010585,1.950401,44.878659,42.928258,35.044072,439.641341,404.597269,0,16.868753,16.868753,25.526782,173.543621,148.016839,0.964014,19.871582,18.907568,8.250503,72.414918,64.164415,65.226981,80.796766,15.569785,344.008482,531.175175,187.166693,0.203982,2.995248,2.791266,0.509058,60.692642,60.183584,5.191329,10.33746,5.146131,0.399282,14.284018,13.884736,0.298013,0.390084,0.092071,0.203021,4.769108,4.566087,1.067135,137.963015,136.89588,0.210256,5.110347,4.900091,0.196298,8.398737,8.202439,2.731238,32.658844,29.927606,537.23925,170.81092,-366.42833,,,,9.792721,94.399543,84.606822,6.532592,65.883133,59.350541,2.375655,209.720292,207.344637,0.394681,28.669621,28.27494,9.613222,28.385287,18.772065,1437.526431,1780.717334,343.190903,2566.292686,994.081765,-1572.210921,41.114053,20.074873,-21.03918,25.193228,30.891728,5.6985,0,163.918053,163.918053,888.512659,797.499482,-91.013177,612.465725,954.961728,342.496003,81.560719,137.610964,56.050245,790.476773,1308.932555,518.455782,2168.485831,3680.843533,1512.357702,18.959862,171.559403,152.599541,36.835134,108.584031,71.748897,360.050434,1001.991275,641.940841,0.037174,0.01105,-0.026124,23.457295,66.782803,43.325508,755.556773,324.446356,-431.110417,0,0,0,367.38456,433.753982,66.369422,326.6163,160.767983,-165.848317,10.459383,0.233953,-10.22543,508.460536,189.732356,-318.72818,4329.072022,3387.731468,-941.340554,2310.244402,604.544414,-1705.699988,1358.518436,3454.156678,2095.638242,1520.346423,2563.92101,1043.574587,51.718761,106.495192,54.776431,0.036809,0.541239,0.50443,4.146927,0.982387,-3.16454,4297.918297,2761.00018,-1536.918117,9425.566237,3629.000523,-5796.565714,780.043606,188.17895,-591.864656,,,,340.098971,151.342117,-188.756854,142.551941,28.730707,-113.821234,394.375051,144.180125,-250.194926,32.05172,1.576122,-30.475598,2274.196868,1498.419317,-775.777551,28.387407,27.836901,-0.550505999999999,21.050354,33.112279,12.061925,103.963239,66.734437,-37.228802,413.32763,257.288078,-156.039552,,,,1477.989583,992.233997,-485.755586,8.463215,6.953019,-1.510196,66.571041,139.446717,72.875676,8.3526,5.592208,-2.760392,100.614696,33.474377,-67.140319,12.276936,47.99394,35.717004,24.781943,86.513326,61.731383,0.181177,6.85726,6.676083,2.746095,3.553695,0.8076,0.005467,1.288886,1.283419,1.695555,57.429344,55.733789,0.437358,12.982698,12.54534,991.164545,1010.665785,19.5012400000001,258.872209,88.728209,-170.144,0.010132,201.279888,201.269756,14.829819,61.04003,46.210211,0.469405,0.168363,-0.301042,0.000227,0.009753,0.009526,3366.588376,1364.629305,-2001.959071,,,,36.946754,33.622812,-3.323942,54.44865,15.875896,-38.572754,7.184044,6.246114,-0.93793,3.458424,3.274529,-0.183895,,,,60.081066,8.328735,-51.752331,0.039464,0.542055,0.502591,0.065579,0.924454,0.858875,2.760017,10.289778,7.529761,69.237724,51.861036,-17.376688,133.086054,59.257942,-73.828112,40.196244,29.223785,-10.972459,472.469225,1153.513254,681.044029,1.702969,9.859256,8.156287,0.800524,14.953945,14.153421,6.469648,71.087987,64.618339,778.104018,188.672754,-589.431264,0,19.773297,19.773297,1076,728.4,-347.6,0,0.014317,0.014317,0.485167,0.015916,-0.469251,97.372542,116.168265,18.795723,1133.786327,208.741368,-925.044959,,,,4772.731524,1984.58816,-2788.143364,134.901684,413.187695,278.286011,185.188786,1952.995874,1767.807088,22.119802,18.86012,-3.259682,59.911801,102.033296,42.121495,58.099664,75.227027,17.127363,1.323658,83.214646,81.890988,3014.811913,1558.091924,-1456.719989,258.503184,189.995354,-68.50783,8.248357,2.969512,-5.278845,317.394521,46.004097,-271.390424,208.842207,21.510164,-187.332043,4.811463,6.339531,1.528068,2172.697832,894.566049,-1278.131783,2126.312318,460.916494,-1665.395824,3.293588,2.084562,-1.209026,192.435176,27.030738,-165.404438,2354.695594,1012.102289,-1342.593305,1234.639584,2411.097001,1176.457417,1460.624519,748.654014,-711.970505,0.006333,0.010556,0.004223,1.010111,19.684704,18.674593,743.798971,712.83406,-30.964911,6.85406,27.839428,20.985368,0.044229,0.153227,0.108998,1.624601,2.101897,0.477296,37500.212876,12988.657301,-24511.555575,0.223591,8.208888,7.985297,0,0.187678,0.187678,4895.419015,3926.570785,-968.848230000001,357.447404,3670.553033,3313.105629,3029.923277,2346.255878,-683.667399,11172.077384,5283.954518,-5888.122866,742.214686,2376.673564,1634.458878,0.004645,0.575666,0.571021,0.185602,0.740918,0.555316,0.027114,0.367758,0.340644,0.000703,0.0118,0.011097,9.406119,10.452456,1.046337,294.053566,277.931087,-16.122479,0.003902,0.312089,0.308187,0.030705,0.002633,-0.028072,0.029433,0,-0.029433,0.335096,1.449268,1.114172,0.776362,0.278056,-0.498306,0.546146,0.391986,-0.15416,0.000762,0.010855,0.010093,0.19609,0.08242,-0.11367,0.00335,0.019823,0.016473,2.20378,4.792624,2.588844,0.001203,0.039195,0.037992,2.260656,9.369192,7.108536,1.655654,2.409224,0.75357,0.863189,2.97811,2.114921,0.02521,1.012301,0.987091,0.148241,0,-0.148241,12.536589,4.365042,-8.171547,0.094562,1.061996,0.967434,64.207284,257.931916,193.724632,347.43792,111.361397,-236.076523,26.090479,115.316393,89.225914,31.064919,53.974357,22.909438,104.362032,423.582245,319.220213,0.112447,3.410316,3.297869,0.019285,2.786161,2.766876,0.011894,0.029278,0.017384,132.002067,21.962011,-110.040056,0.103384,9.086542,8.983158,103.339491,20.309115,-83.030376,1.573428,8.898112,7.324684,0.164899,2.286422,2.121523,8.802119,7.41104,-1.391079,0.472642,8.121355,7.648713,137.777484,10.70896,-127.068524,13.750482,64.479261,50.728779,0.01905,3.410222,3.391172,0.123237,11.66513,11.541893,0.313368,158.569641,158.256273,235.364947,544.449093,309.084146,0.007404,0.184415,0.177011,72.599142,24.857002,-47.74214,143.828982,3.029854,-140.799128,0.598231,0.002575,-0.595656,1.120341,9.18011,8.059769,0.032516,56.171759,56.139243,367.006416,150.072488,-216.933928,5.043546,11.958293,6.914747,0.000667,0.086814,0.086147,0.310693,0.646045,0.335352,0.018376,0.085679,0.067303,1.679341,12.055491,10.37615,5.531295,9.306689,3.775394,1.156808,0.722507,-0.434301,3.926446,1.329713,-2.596733,0.160541,2.059853,1.899312,4.617599,25.422942,20.805343,0.070904,0.223422,0.152518,0.157652,13.990557,13.832905,4.515586,9.447746,4.93216,39.385297,41.206945,1.821648,0.178565,1.052417,0.873852,0.827772,0.013308,-0.814464,4.809346,114.852184,110.042838,35.637905,3.164463,-32.473442,1.79823,14.413284,12.615054,13.599437,2.756694,-10.842743,0.003445,0.499479,0.496034,0.720209,0.065587,-0.654622,0.236909,0.720576,0.483667,0.000294,0.005373,0.005079,671.139414,482.816747,-188.322667,15.627447,31.554675,15.927228,31.367604,3.047324,-28.32028,3.120179,13.215585,10.095406,2.775823,2.383219,-0.392604,0.698569,4.103337,3.404768,7.063249,2.360849,-4.7024,33.183508,0.03444,-33.149068,0,38.734006,38.734006,,,
2014-01-01,12949.462153,5709.689051,-7239.773102,30584.31129,21552.858036,-9031.453254,192185.63745369,132514.077169145,-59671.5602845456,13204.883404,0,-13204.883404,13213.832357,6770.836008,-6442.996349,30262.227368,25320.518663,-4941.708705,,,,12628.780444,14918.55554,2289.775096,49726.768387,41743.60549,-7983.162897,36295.238239,25764.998552,-10530.239687,2720.526446,2777.098102,56.571656000001,65186.277509,32870.255297,-32316.022212,186070.068022,126619.205952,-59450.86207,83565.758378,38978.324725,-44587.433653,1930.630223,2492.576569,561.946346,1132.202526,2436.531265,1304.328739,2125.483833,1626.6251,-498.858733,0.793602,0.092278,-0.701324,27705.334454,22576.190841,-5129.143613,0,0,0,22021.433933,19167.414649,-2854.019284,308.817445,433.003524,124.186079,10.413841,14.419695,4.005854,137.225333,297.99506,160.769727,271.243476,427.651127,156.407651,205.102329,68.920478,-136.181851,737.454763,695.801509,-41.6532539999999,38.558013,749.171314,710.613301,1.078076,34.779425,33.701349,44.963398,296.83621,251.872812,0,34.932775,34.932775,20.412496,170.318799,149.906303,0.175346,21.557287,21.381941,0.744971,51.388358,50.643387,44.843398,98.991983,54.148585,270.786877,569.204871,298.417994,0.286348,2.897872,2.611524,0.41264,39.935538,39.522898,3.692718,12.741861,9.049143,0.239111,21.684551,21.44544,0.088103,0.412437,0.324334,0.150542,4.592236,4.441694,0.888614,100.255029,99.366415,0.071286,8.718234,8.646948,0.57539,6.33358,5.75819,3.194446,43.891821,40.697375,473.006882,201.163317,-271.843565,,,,8.228989,90.505951,82.276962,11.648861,56.036583,44.387722,2.267967,51.1594,48.891433,0.503553,31.572546,31.068993,6.750713,23.222407,16.471694,1814.311996,1686.434412,-127.877584,3032.849947,614.114263,-2418.735684,22.873939,22.986024,0.112085,34.096582,31.443669,-2.652913,0,2.793804,2.793804,993.231255,775.910469,-217.320786,586.148437,922.269203,336.120766,114.995373,80.490103,-34.50527,859.614351,1394.666458,535.052107,2301.787357,3487.342459,1185.555102,13.594953,156.199464,142.604511,33.27078,212.782113,179.511333,217.641317,871.008245,653.366928,0.538232,0.019076,-0.519156,26.633051,13.70769,-12.925361,619.539099,324.951754,-294.587345,0.00064,0,-0.00064,481.037632,393.425678,-87.611954,306.780942,176.025548,-130.755394,12.903845,0.08352,-12.820325,620.241824,178.985835,-441.255989,4250.081363,3905.016204,-345.065159,2532.144326,572.528945,-1959.615381,1523.388796,3341.738998,1818.350202,1400.205643,2602.510004,1202.304361,37.026061,208.546172,171.520111,0.061215,0.471359,0.410144,2.12481,5.161946,3.037136,3306.936055,2648.844196,-658.091859,9129.579481,3836.290995,-5293.288486,741.25932,452.339614,-288.919706,,,,299.269922,167.355531,-131.914391,181.344803,33.567445,-147.777358,343.2964,136.716166,-206.580234,20.297031,2.748021,-17.54901,2435.637827,1479.27949,-956.358337,29.279179,20.618177,-8.661002,10.702867,37.539751,26.836884,116.780675,60.738458,-56.042217,372.570441,271.835175,-100.735266,,,,1860.146494,862.359415,-997.787079,7.302898,5.595055,-1.707843,79.108828,139.339288,60.23046,5.162299,5.724059,0.56176,0.290223,24.237208,23.946985,2.46393,50.980546,48.516616,153.5028,74.431195,-79.071605,0.414314,3.935431,3.521117,2.715681,2.191702,-0.523979,0.038183,0.998757,0.960574,1.19552,5.427662,4.232142,0.84962,3.310156,2.460536,1029.829924,942.438158,-87.3917659999998,273.081068,115.818915,-157.262153,0.008662,327.515302,327.50664,10.818803,41.863139,31.044336,0.360078,0.045848,-0.31423,0.005466,0.109933,0.104467,3094.824565,1258.090683,-1836.733882,,,,29.634308,45.045878,15.41157,49.787885,11.66838,-38.119505,5.762466,2.518449,-3.244017,7.849047,3.828142,-4.020905,,,,21.797913,7.930607,-13.867306,0.095887,0.412536,0.316649,0.007131,0.777343,0.770212,2.340213,2.817333,0.47712,78.84705,74.111781,-4.735269,147.420329,48.069828,-99.350501,46.635988,26.826937,-19.809051,580.813245,792.776845,211.9636,3.004173,12.775369,9.771196,0.506757,0.028253,-0.478504,7.274779,75.962489,68.68771,856.603149,123.26539,-733.337759,0,14.355282,14.355282,1112.5,827.2,-285.3,0,0,0,0.932481,0.178203,-0.754278,114.555286,97.930457,-16.624829,1508.963146,152.055534,-1356.907612,,,,5088.933198,1188.938394,-3899.994804,105.866906,153.717306,47.8504,259.139178,1832.396213,1573.257035,0.05244,25.068209,25.015769,54.808757,116.475459,61.666702,113.611785,62.551072,-51.060713,2.734116,85.549891,82.815775,3680.678877,1564.85182,-2115.827057,338.866049,109.922548,-228.943501,6.445692,3.407066,-3.038626,516.935829,92.400437,-424.535392,227.581946,35.839478,-191.742468,4.750864,8.655464,3.9046,2142.423903,1141.704172,-1000.719731,2433.683561,420.136787,-2013.546774,1.796064,3.021796,1.225732,230.18757,24.40189,-205.78568,2171.604094,927.57646,-1244.027634,1177.713019,2671.87841,1494.165391,1669.779742,624.30329,-1045.476452,0,0.075277,0.075277,0.981836,11.132979,10.151143,788.735612,762.852277,-25.883335,6.07767,17.558678,11.481008,0.043661,0.074416,0.030755,2.291368,1.851988,-0.43938,38377.19956,10264.542542,-28112.657018,0.266807,14.063458,13.796651,0,0,0,5292.668573,3446.047746,-1846.620827,394.503419,4362.842946,3968.339527,3385.095147,1886.338441,-1498.756706,10819.724905,5504.778463,-5314.946442,799.178034,2142.126829,1342.948795,0.0002,0.005992,0.005792,0.054983,0.448789,0.393806,0.02047,0,-0.02047,0.000567,0.00743,0.006863,14.641382,12.916256,-1.725126,288.374516,235.35998,-53.014536,0.049164,0.255246,0.206082,0.013729,0.004141,-0.009588,0.056533,0,-0.056533,0.790735,1.441432,0.650697,1.467304,0.338843,-1.128461,0.463124,16.11708,15.653956,0.001187,0.001281,0.0000940000000000001,0.219721,0.172191,-0.04753,0.004408,0.050018,0.04561,7.448641,3.422545,-4.026096,0,0.075461,0.075461,2.060183,10.317439,8.257256,1.774071,3.219625,1.445554,0.011286,2.780148,2.768862,0.006999,1.428606,1.421607,0.060849,0,-0.060849,15.337579,5.224098,-10.113481,0.169833,0.840177,0.670344,71.487147,281.950234,210.463087,306.715203,349.584541,42.869338,81.89109,154.72601,72.83492,105.279792,12.053575,-93.226217,128.217563,338.014875,209.797312,0.256,0.574883,0.318883,0.000114,1.260547,1.260433,0.017843,0,-0.017843,21.91768,18.944681,-2.972999,20.854484,7.29845,-13.556034,6.761057,13.977276,7.216219,1.47205,10.345757,8.873707,0.1421,0.970698,0.828598,1.318874,2.579065,1.260191,1.585711,4.82472,3.239009,116.555635,15.907668,-100.647967,15.655648,45.068419,29.412771,0.00031,2.302276,2.301966,0.192212,1.898837,1.706625,1.488573,79.448007,77.959434,382.234873,369.843316,-12.391557,0.139298,0.301596,0.162298,0.865139,21.610482,20.745343,189.827002,3.46336,-186.363642,0.13103,0,-0.13103,0.036757,3.039872,3.003115,0.747388,58.191466,57.444078,414.892056,110.206323,-304.685733,71.999064,10.640818,-61.358246,0.001035,0.02936,0.028325,0.135983,0.365947,0.229964,0.01376,0.046916,0.033156,2.894961,8.678908,5.783947,6.480296,10.469216,3.98892,1.623445,0.375291,-1.248154,3.461707,0.469995,-2.991712,0.068861,0.993995,0.925134,7.879504,24.824942,16.945438,0.014404,0.119331,0.104927,0.289796,6.463455,6.173659,3.243985,7.938585,4.6946,39.076136,28.330842,-10.745294,0.048554,1.522124,1.47357,2.285055,0.016775,-2.26828,9.151386,13.188802,4.037416,33.51532,2.097228,-31.418092,11.79766,14.562939,2.765279,13.403859,2.635113,-10.768746,0,0.623374,0.623374,0.110929,0.08734,-0.023589,4.263977,0.553832,-3.710145,0.000054,0.00479,0.004736,646.303684,525.546288,-120.757396,27.177401,18.224196,-8.953205,13.307379,1.738568,-11.568811,3.234028,15.587378,12.35335,6.029693,2.823066,-3.206627,0.646783,5.224901,4.578118,4.475081,2.600862,-1.874219,39.054349,0.143649,-38.9107,0,0,0,,,
2014-02-01,11492.551773,5795.776481,-5696.775292,29793.691827,20908.392501,-8885.299326,193313.873591231,132139.022890107,-61174.8507011241,14026.150382,0,-14026.150382,12904.348341,7562.192179,-5342.156162,27440.528663,24452.559492,-2987.969171,,,,11983.058073,13471.678146,1488.620073,48528.168028,41889.749963,-6638.418065,35245.700664,26070.719536,-9174.98112799999,2671.433298,2834.669817,163.236518999999,54980.738494,30696.192006,-24284.546488,170711.231072,123630.418125,-47080.8129470001,71305.6147,37030.374913,-34275.239787,2392.278319,2468.057203,75.7788839999998,976.817651,2333.145523,1356.327872,2087.570786,1784.342606,-303.22818,0.435163,0.080227,-0.354936,26082.94273,23421.917212,-2661.025518,0.003495,0,-0.003495,22445.225298,18467.832751,-3977.392547,321.346462,555.845183,234.498721,2.681386,16.651951,13.970565,185.006373,211.346067,26.339694,372.290479,462.26838,89.977901,230.903459,65.789196,-165.114263,932.348556,568.474714,-363.873842,31.405658,774.019125,742.613467,0.99316,32.466539,31.473379,58.425352,322.918298,264.492946,0,44.471869,44.471869,24.269082,142.944669,118.675587,0.519085,21.528107,21.009022,2.050254,62.101001,60.050747,72.252658,79.821039,7.568381,350.38299,604.333663,253.950673,0.435494,2.770356,2.334862,0.22651,12.477945,12.251435,4.527406,11.235656,6.70825,0.420042,13.41421,12.994168,0.006161,0.365819,0.359658,0.109279,4.748092,4.638813,2.404351,12.11443,9.710079,0.131729,5.382417,5.250688,0.591232,4.598385,4.007153,4.497142,29.687571,25.190429,455.849083,169.060466,-286.788617,,,,4.224947,85.375068,81.150121,15.676789,59.555582,43.878793,1.93516,97.691185,95.756025,0.38272,43.214326,42.831606,12.065319,27.58703,15.521711,1538.636573,1316.624577,-222.011996,2367.03874,593.135645,-1773.903095,33.68512,24.231454,-9.453666,25.15673,29.49988,4.34315,0.000016,5.961737,5.961721,1055.463645,345.011637,-710.452008,561.857019,899.477815,337.620796,191.571772,80.009197,-111.562575,754.575605,1206.506143,451.930538,2043.362402,3289.529275,1246.166873,8.084546,154.123468,146.038922,27.080982,93.983713,66.902731,288.186589,882.561685,594.375096,0.000016,6.763581,6.763565,25.744657,32.935843,7.191186,760.495633,311.237487,-449.258146,0.000219,0.035341,0.035122,386.21721,528.630016,142.412806,293.167955,179.431251,-113.736704,12.431974,0.136461,-12.295513,595.248887,174.921964,-420.326923,3869.047629,3580.514886,-288.532743,2169.314634,532.84346,-1636.471174,1683.693779,3103.095758,1419.401979,1475.801933,2622.644896,1146.842963,32.024373,142.78099,110.756617,0.008874,0.322711,0.313837,2.389691,7.937909,5.548218,3659.826118,2276.410515,-1383.415603,8909.726383,4312.502478,-4597.223905,750.239024,558.49971,-191.739314,,,,313.674756,186.6499,-127.024856,131.39276,22.233803,-109.158957,325.661189,149.554957,-176.106232,24.267942,2.179455,-22.088487,2312.302032,1991.387045,-320.914987,36.532974,23.541632,-12.991342,18.838688,43.028836,24.190148,86.763549,49.689871,-37.073678,369.564844,274.431454,-95.13339,,,,1882.298421,951.234941,-931.06348,10.856623,6.833563,-4.02306,42.020084,141.713478,99.693394,6.457058,5.9501,-0.506958,0.251541,25.79968,25.548139,16.564737,56.133788,39.569051,127.491165,73.935083,-53.556082,0.052853,4.556748,4.503895,1.967731,3.816531,1.8488,1.260536,1.525988,0.265452,0.415996,7.856107,7.440111,0.938533,12.343322,11.404789,950.011576,773.807936,-176.20364,190.253074,65.624032,-124.629042,0.002223,350.596778,350.594555,12.520821,6.421602,-6.099219,0.561568,0.039881,-0.521687,0.151652,0.172501,0.020849,2811.709971,1315.728793,-1495.981178,,,,42.078557,26.861133,-15.217424,46.745135,15.211553,-31.533582,6.849311,1.281749,-5.567562,15.623041,0.9909,-14.632141,,,,30.668779,8.340671,-22.328108,0.01365,0.501032,0.487382,0.63425,1.734408,1.100158,2.413281,4.273099,1.859818,71.45794,43.333921,-28.124019,135.510278,60.826991,-74.683287,44.963158,39.749961,-5.213197,541.153205,939.131906,397.978701,7.426209,16.812731,9.386522,0.396405,0.226893,-0.169512,3.826416,63.516971,59.690555,967.693629,123.242387,-844.451242,0,11.018167,11.018167,963.2,817.1,-146.1,0,0,0,0.171427,0,-0.171427,90.619169,98.771611,8.15244199999999,1206.130422,440.032699,-766.097723,,,,4473.602267,1290.955663,-3182.646604,232.046549,391.288686,159.242137,150.937613,1657.915465,1506.977852,11.513709,26.302204,14.788495,76.346206,113.81424,37.468034,94.354251,80.783403,-13.570848,2.544753,75.519453,72.9747,3038.616246,1375.459772,-1663.156474,267.897599,143.926206,-123.971393,6.950494,6.587546,-0.362948,440.053577,233.460241,-206.593336,206.880431,21.671731,-185.2087,8.791232,4.956295,-3.834937,1803.185732,802.527142,-1000.65859,2036.238406,540.143864,-1496.094542,1.656326,2.259407,0.603081,247.942497,25.728447,-222.21405,2015.528969,948.536428,-1066.992541,1110.752931,2290.431882,1179.678951,1412.578859,714.115938,-698.462921,0,0.0215,0.0215,1.918117,8.229133,6.311016,695.284755,608.084314,-87.2004410000001,5.401489,28.597929,23.19644,0.045169,0.019215,-0.025954,1.693456,2.538904,0.845448,30700.352329,9750.696184,-20949.656145,0.212813,8.094139,7.881326,0,1.196866,1.196866,4567.76886,3491.783242,-1075.985618,248.255207,3224.787731,2976.532524,2653.592155,2047.093836,-606.498319,10604.163187,5305.158682,-5299.004505,680.775835,2059.205272,1378.429437,0.001551,0.706187,0.704636,0.00121,0.123453,0.122243,0.04461,0.053226,0.00861600000000001,0,0.572187,0.572187,5.118966,9.20122,4.082254,279.246835,210.270215,-68.97662,0.048809,0.461032,0.412223,0.086407,0,-0.086407,0.019792,0,-0.019792,0.287676,1.312904,1.025228,0.972461,0.564284,-0.408177,0.382587,0.590724,0.208137,0.000901,0,-0.000901,0.090956,0.98849,0.897534,0.000261,0.145119,0.144858,2.96219,24.530288,21.568098,0,0.00295,0.00295,1.939661,11.159735,9.220074,1.956316,4.402054,2.445738,0.017083,3.120617,3.103534,0.056393,2.254675,2.198282,0.020946,0.038776,0.01783,2.656203,2.523106,-0.133097,0.104231,1.577532,1.473301,70.780553,194.371376,123.590823,354.341927,207.202647,-147.13928,57.830565,30.154808,-27.675757,29.573887,10.939146,-18.634741,92.857196,568.434524,475.577328,0.148,1.149688,1.001688,0.000683,0.59056,0.589877,0,0,0,21.169344,77.418655,56.249311,10.128735,12.830124,2.701389,7.583943,19.136463,11.55252,1.87963,26.888525,25.008895,0.190237,2.938528,2.748291,13.120503,3.038958,-10.081545,0.384356,4.471115,4.086759,204.785258,15.119193,-189.666065,33.277445,68.686435,35.40899,0.018028,4.011512,3.993484,0.211576,6.406331,6.194755,1.093073,48.683503,47.59043,265.419851,518.148057,252.728206,0.017419,0.405061,0.387642,156.972468,17.702345,-139.270123,105.940198,3.662497,-102.277701,1.610523,0.075119,-1.535404,0.183867,11.334413,11.150546,0.549155,58.970057,58.420902,416.008345,170.466844,-245.541501,2.56705,14.519803,11.952753,0.037137,0.332051,0.294914,0.005649,0.512901,0.507252,0.031114,0.033372,0.002258,7.344873,13.973502,6.628629,23.444046,10.565645,-12.878401,0.605203,0.158211,-0.446992,2.300445,4.151293,1.850848,0.043452,0.207392,0.16394,4.961261,22.754814,17.793553,0.000012,0.261647,0.261635,0.018047,10.410387,10.39234,2.34128,6.495968,4.154688,38.276344,33.559693,-4.716651,0.344857,0.950716,0.605859,1.603315,0.011265,-1.59205,8.622815,17.006732,8.383917,25.236733,1.857905,-23.378828,1.564084,17.603321,16.039237,19.499569,3.478577,-16.020992,0.025799,0.349707,0.323908,0,0.136646,0.136646,0.969482,1.195289,0.225807,0.000166,0.16597,0.165804,602.205827,425.706293,-176.499534,30.887623,48.217675,17.330052,14.012202,1.740828,-12.271374,1.31009,10.894923,9.584833,2.859974,2.144096,-0.715878,3.565559,3.946985,0.381426,2.794111,18.937099,16.142988,46.369922,0.829783,-45.540139,0,0,0,,,
2014-03-01,12077.042952,6687.292916,-5389.750036,36796.912176,24580.023302,-12216.888874,198397.943359655,136236.068063248,-62161.8752964076,15721.128863,0,-15721.128863,14796.488084,8973.108555,-5823.379529,33258.228892,29340.858641,-3917.370251,,,,12854.80015,16172.480509,3317.680359,55000.626024,47128.246974,-7872.37905,43794.479183,30609.9576,-13184.521583,3077.73957,3024.035477,-53.7040930000012,60845.58382,35018.255038,-25827.328782,194612.916502,142289.932238,-52322.9842640001,78702.72195,42834.295098,-35868.426852,2660.210221,2936.619974,276.409753,1182.098247,2513.03603,1330.937783,2474.489314,1861.508775,-612.980539,0.451378,7.88055,7.429172,30056.911353,27112.963518,-2943.947835,0,0,0,24943.714671,20015.283456,-4928.431215,361.464803,483.971826,122.507023,13.085468,22.516414,9.430946,214.351776,310.17302,95.821244,393.535077,622.455229,228.920152,243.05511,88.668723,-154.386387,1060.149666,726.318744,-333.830922,24.769828,1038.785666,1014.015838,1.015327,76.289109,75.273782,57.676537,409.999947,352.32341,0,53.704617,53.704617,27.313315,179.97585,152.662535,0.640683,21.613571,20.972888,2.652059,48.189089,45.53703,67.067495,128.131695,61.0642,387.653789,705.032432,317.378643,0.534354,3.543681,3.009327,0.144932,21.314815,21.169883,5.004775,13.290402,8.285627,3.621892,10.699072,7.07718,0.065179,1.115361,1.050182,0.379802,5.090619,4.710817,3.449993,20.122791,16.672798,0.097978,7.31412,7.216142,1.190642,10.671241,9.480599,3.069039,46.338638,43.269599,500.508263,192.565718,-307.942545,,,,4.0971,67.842281,63.745181,21.365991,33.082582,11.716591,1.685004,144.889793,143.204789,0.191345,41.997968,41.806623,6.661141,17.671105,11.009964,1763.863338,1798.313611,34.4502729999999,2514.659194,710.255594,-1804.4036,39.462702,29.990314,-9.472388,18.035821,37.682987,19.647166,0.001407,0.733681,0.732274,864.23772,602.788978,-261.448742,447.265473,760.836136,313.570663,200.018629,88.922728,-111.095901,1029.124695,1457.38079,428.256095,2107.506824,3974.350394,1866.84357,11.67631,166.259573,154.583263,35.927976,153.433477,117.505501,411.824994,838.149052,426.324058,4.696704,0.007075,-4.689629,26.150998,54.63923,28.488232,854.007957,416.30235,-437.705607,0,0.587191,0.587191,713.33861,367.989522,-345.349088,477.127165,197.565781,-279.561384,15.319418,0.403831,-14.915587,702.666697,219.641616,-483.025081,4793.966349,4545.898287,-248.068062,2770.400545,742.177073,-2028.223472,1956.106294,3699.677891,1743.571597,1844.732836,3073.370209,1228.637373,56.722027,107.413246,50.691219,0.025175,0.187841,0.162666,2.06231,3.03837,0.97606,4394.377789,2639.287328,-1755.090461,10689.065254,4646.506987,-6042.558267,996.664001,209.735444,-786.928557,,,,358.288037,175.622614,-182.665423,179.572522,36.9106,-142.661922,446.20834,208.091691,-238.116649,27.777882,2.296235,-25.481647,2703.714573,2782.65295,78.9383769999999,54.858157,33.53642,-21.321737,23.817007,62.144621,38.327614,131.014741,66.034957,-64.979784,448.810297,333.425192,-115.385105,,,,2550.132217,1015.700879,-1534.431338,7.447691,6.713766,-0.733925,84.190553,129.011573,44.82102,8.663958,5.589076,-3.074882,115.188548,28.785143,-86.403405,19.162658,53.180473,34.017815,65.43595,57.913799,-7.52215100000001,0.093327,6.851358,6.758031,2.5165,2.632183,0.115683,1.444489,1.191911,-0.252578,0.910244,176.912561,176.002317,1.940758,19.19736,17.256602,1234.051375,811.964307,-422.087068,307.297566,101.206551,-206.091015,0.072233,232.281752,232.209519,16.283636,120.691165,104.407529,0.67057,0.133663,-0.536907,0.032154,0.079833,0.047679,3609.591248,1853.125467,-1756.465781,,,,43.971221,50.347823,6.376602,60.854508,13.818337,-47.036171,6.944227,2.209742,-4.734485,15.152332,2.735733,-12.416599,,,,20.269329,8.24085,-12.028479,0.004976,2.166618,2.161642,0.080391,1.313021,1.23263,2.501669,4.825284,2.323615,84.162134,73.656616,-10.505518,205.810309,93.561152,-112.249157,47.928761,34.665011,-13.26375,606.323267,1060.47255,454.149283,8.555403,13.644566,5.089163,0.89427,0.711554,-0.182716,7.025225,74.006182,66.980957,1030.732449,202.084661,-828.647788,0,18.790117,18.790117,1101.5,717.3,-384.2,0.044848,0,-0.044848,0.235347,0.036267,-0.19908,97.656879,137.077337,39.420458,859.057948,224.573731,-634.484217,,,,4883.23675,1635.403387,-3247.833363,365.409506,657.335635,291.926129,240.948969,1801.125827,1560.176858,0.206435,29.146147,28.939712,125.605156,175.868597,50.263441,70.86607,96.779873,25.913803,29.453378,93.979426,64.526048,3909.851428,1715.935762,-2193.915666,294.73378,123.213396,-171.520384,8.242653,2.979674,-5.262979,482.963157,245.068932,-237.894225,246.782778,22.025894,-224.756884,6.115825,11.352295,5.23647,2297.167632,993.965824,-1303.201808,2123.377891,528.429608,-1594.948283,1.854136,1.970449,0.116313,295.513841,23.234807,-272.279034,2380.572668,1186.552082,-1194.020586,1237.298132,2742.866659,1505.568527,1801.638171,678.064729,-1123.573442,0.003904,0.026365,0.022461,2.664258,183.974014,181.309756,878.36864,792.04061,-86.32803,4.442154,36.364382,31.922228,0.006533,0.200667,0.194134,1.832136,3.487352,1.655216,31420.875281,10934.276106,-20486.599175,0.431682,18.947979,18.516297,0,10.052124,10.052124,5629.377523,4342.245287,-1287.132236,939.398542,3302.192172,2362.79363,3289.953401,2360.520998,-929.432403,12112.971599,6009.199558,-6103.772041,804.392323,2132.47266,1328.080337,0.000336,0,-0.000336,0.122144,0.026587,-0.095557,0.015972,0.006134,-0.009838,0,0.099651,0.099651,9.108005,10.141803,1.033798,334.523123,307.343978,-27.179145,0.003783,0.285911,0.282128,0.011798,0.006445,-0.005353,0.010636,0.012679,0.002043,0.151057,2.438139,2.287082,0.442527,0.525476,0.0829490000000001,0.9591,0.473339,-0.485761,0.000375,0,-0.000375,0.377044,0.402951,0.025907,0.010415,0.007302,-0.003113,9.336376,23.86348,14.527104,0,0.037367,0.037367,7.774418,13.223481,5.449063,0.976694,2.587567,1.610873,0.083468,2.873424,2.789956,0.021631,1.910114,1.888483,0.016028,0.032444,0.016416,13.638065,12.001897,-1.636168,0.105405,1.308766,1.203361,86.551019,180.199259,93.64824,320.872669,208.261342,-112.611327,59.962646,32.221962,-27.740684,43.544602,11.577154,-31.967448,127.217234,691.038855,563.821621,0.905806,0.647671,-0.258135,0,1.693499,1.693499,0.000276,0,-0.000276,0.594035,19.786897,19.192862,0.403806,6.451272,6.047466,44.79057,18.921462,-25.869108,2.125038,13.65664,11.531602,0.102558,13.130238,13.02768,11.160725,8.957955,-2.20277,10.635064,9.147316,-1.487748,234.928972,12.620318,-222.308654,23.298983,98.842938,75.543955,0.081041,4.470917,4.389876,0.281578,4.157224,3.875646,0.944733,85.055217,84.110484,634.804997,455.955786,-178.849211,0.042118,0.698904,0.656786,82.234527,22.099263,-60.135264,146.819787,3.267905,-143.551882,0.000146,0.252483,0.252337,0.139644,2.819483,2.679839,0.739471,89.183453,88.443982,356.972687,121.305309,-235.667378,9.509807,13.73603,4.226223,0,0.063214,0.063214,0.067161,0.509933,0.442772,0.000875,0,-0.000875,6.197016,24.595218,18.398202,1.259773,10.280241,9.020468,0.204864,0.553007,0.348143,0.487445,0.571488,0.084043,0.027925,16.130476,16.102551,5.019898,11.060092,6.040194,0.000019,0.172001,0.171982,0.477421,5.37325,4.895829,2.609882,10.221105,7.611223,44.561805,36.455483,-8.106322,1.541814,1.258285,-0.283529,0.472575,0.053276,-0.419299,7.980943,26.595206,18.614263,32.250467,3.076003,-29.174464,6.310835,49.601588,43.290753,16.703481,2.860815,-13.842666,0,0.208191,0.208191,0.000414,0.00918,0.008766,2.059707,0.446549,-1.613158,0.000065,0.082849,0.082784,676.020559,580.894322,-95.1262370000001,9.544125,21.210534,11.666409,26.735409,3.182391,-23.553018,5.984066,14.303099,8.319033,5.644334,1.15019,-4.494144,4.26712,5.621123,1.354003,4.666047,3.245553,-1.420494,34.972647,0.04967,-34.922977,0,0,0,,,
2014-04-01,13215.808481,6664.402802,-6551.405679,37432.685423,23394.297702,-14038.387721,200025.271937407,134918.506495092,-65106.7654423144,15368.967325,0,-15368.967325,14545.26871,9068.467361,-5476.801349,35163.674307,27073.551024,-8090.123283,,,,13237.761571,14949.799376,1712.037805,53862.143276,46509.301574,-7352.84170200001,44574.896453,28436.856388,-16138.040065,3128.313693,3719.356706,591.043013000001,65804.006084,31276.520389,-34527.485695,201243.758555,133990.050434,-67253.708121,85095.057124,37709.923062,-47385.134062,2645.411087,2647.29787,1.88678300000038,1345.387063,2664.572954,1319.185891,2594.872184,2384.847339,-210.024844999999,0.199338,0.240374,0.041036,29284.28598,26608.995575,-2675.290405,0.000037,0,-0.000037,24577.857296,19900.305999,-4677.551297,405.979733,508.737153,102.75742,11.921299,23.222538,11.301239,188.94287,262.463541,73.520671,369.981875,483.383579,113.401704,264.676917,84.049306,-180.627611,1035.427816,627.968233,-407.459583,26.482587,816.46829,789.985703,1.562778,40.847336,39.284558,39.891469,271.189005,231.297536,0,30.798044,30.798044,22.029195,203.955753,181.926558,0.563629,22.491641,21.928012,2.028114,48.197921,46.169807,71.276176,93.306047,22.029871,380.401876,680.696058,300.294182,0.592823,2.954962,2.362139,0.25511,14.996277,14.741167,7.270376,14.006512,6.736136,0.164474,21.02214,20.857666,0.006498,0.386305,0.379807,0.133034,6.382411,6.249377,1.146496,10.702292,9.555796,0.086802,8.443452,8.35665,1.081978,8.130601,7.048623,4.395022,37.153167,32.758145,548.124443,200.006357,-348.118086,,,,5.566587,48.520469,42.953882,67.611751,42.36873,-25.243021,31.171955,62.494559,31.322604,0.261214,37.316939,37.055725,0.470523,27.100251,26.629728,1621.923425,1741.726647,119.803222,2804.617848,793.032393,-2011.585455,44.548436,36.53973,-8.008706,24.315756,52.680093,28.364337,0.01418,122.794233,122.780053,791.58107,614.809488,-176.771582,606.305659,933.06779,326.762131,171.871691,84.07942,-87.792271,1045.781717,1376.885876,331.104159,2186.62403,3357.572018,1170.947988,8.305289,162.954902,154.649613,34.029154,105.321691,71.292537,407.595834,828.485084,420.88925,0.742062,0.090142,-0.65192,23.464715,31.061277,7.596562,990.961579,356.877259,-634.08432,0,0,0,539.709597,468.819361,-70.890236,422.490144,144.75258,-277.737564,11.821616,0.054291,-11.767325,681.887249,212.584057,-469.303192,5040.20588,4445.294305,-594.911575,3061.189774,641.765703,-2419.424071,1983.469328,3630.058081,1646.588753,1831.150349,2847.498107,1016.347758,68.173075,69.622945,1.44987,0.187828,0.254972,0.067144,1.816856,3.56082,1.743964,4288.475187,2895.791167,-1392.68402,11073.907,4097.13673,-6976.77027,949.555894,585.973017,-363.582877,,,,349.371788,183.127303,-166.244485,205.819127,49.597856,-156.221271,369.407968,116.847209,-252.560759,23.964862,2.638171,-21.326691,3145.559959,1614.038581,-1531.521378,34.41438,33.792413,-0.621966999999998,24.583293,28.638376,4.055083,52.755753,51.574726,-1.181027,431.708818,421.53224,-10.176578,,,,2364.289348,1033.787555,-1330.501793,17.167829,8.020634,-9.147195,102.740558,91.725158,-11.0154,6.215252,6.525922,0.310669999999999,126.862855,31.248109,-95.614746,25.153849,54.61536,29.461511,80.990756,98.363138,17.372382,0.124167,5.934095,5.809928,2.568316,3.698701,1.130385,0.668797,2.403707,1.73491,1.002241,186.635177,185.632936,1.172735,7.420752,6.248017,1362.656218,713.135355,-649.520863,256.037885,77.96113,-178.076755,0.01106,309.397901,309.386841,15.040569,85.388499,70.34793,0.700237,0.338586,-0.361651,0.006521,0.567327,0.560806,3479.252572,1475.079572,-2004.173,,,,48.590785,17.231249,-31.359536,64.691144,19.693804,-44.99734,10.386647,2.077377,-8.30927,9.553748,1.482292,-8.071456,,,,22.379016,36.1229,13.743884,0.002546,1.699417,1.696871,0.054966,1.424974,1.370008,2.983665,6.038541,3.054876,94.565669,59.608503,-34.957166,187.059114,78.983939,-108.075175,54.420388,45.178706,-9.241682,620.650488,1032.60359,411.953102,10.844493,9.572871,-1.271622,0.908361,0.20619,-0.702171,6.765231,82.017477,75.252246,1195.403934,177.408524,-1017.99541,0,14.471568,14.471568,862.2,603.5,-258.7,0.067391,0.104122,0.036731,0.329452,0.052365,-0.277087,112.341076,133.236269,20.895193,1188.560694,208.158648,-980.402046,,,,5569.252449,1366.587231,-4202.665218,132.293421,755.671622,623.378201,170.999543,1575.287516,1404.287973,0.205769,55.394846,55.189077,110.192135,212.541554,102.349419,89.386012,83.794134,-5.59187799999999,2.824478,95.60674,92.782262,4456.424275,1393.512627,-3062.911648,315.154035,143.516496,-171.637539,6.146742,2.494513,-3.652229,440.329411,57.198047,-383.131364,230.771849,21.073553,-209.698296,5.608969,6.467251,0.858282,2166.766435,830.327481,-1336.438954,2336.471333,468.698314,-1867.773019,2.413827,2.897258,0.483431,231.149146,24.158678,-206.990468,2447.654289,1000.570864,-1447.083425,1490.613631,2384.328654,893.715023,1668.84358,811.663225,-857.180355,0,0.149641,0.149641,10.640945,130.804399,120.163454,855.646834,678.881101,-176.765733,5.557375,32.525574,26.968199,0.015868,0.29033,0.274462,2.354699,1.886407,-0.468292,36450.218795,9031.900812,-27418.317983,0.251878,9.653113,9.401235,0,6.68991,6.68991,6138.023651,3845.240118,-2292.783533,349.448249,3090.785454,2741.337205,3689.159051,2357.973729,-1331.185322,11384.013843,5294.783086,-6089.230757,929.090228,2289.603031,1360.512803,0,0,0,0.087986,4.441751,4.353765,0.055299,0,-0.055299,0,0.053725,0.053725,4.582331,38.143394,33.561063,380.513282,289.316948,-91.196334,0.092989,0.466826,0.373837,0.019336,0.573248,0.553912,0.018702,0.032113,0.013411,0.561702,2.583074,2.021372,0.616916,1.112288,0.495372,0.722358,0.578522,-0.143836,0.003175,0,-0.003175,0.177472,0.072199,-0.105273,0.001125,0.013407,0.012282,8.931868,4.599933,-4.331935,0,0.094328,0.094328,2.844977,11.42506,8.580083,1.55152,4.598953,3.047433,0.023003,3.755942,3.732939,0.00614,1.579439,1.573299,0.037617,0.09243,0.054813,15.320527,9.890025,-5.430502,0.129121,1.635456,1.506335,118.2529,206.736984,88.484084,254.006786,288.293823,34.287037,41.406674,28.369142,-13.037532,53.132859,18.895456,-34.237403,117.81271,732.249235,614.436525,1.15,3.312473,2.162473,0,1.140124,1.140124,0,0,0,19.355045,15.183406,-4.171639,0.512339,18.219255,17.706916,6.843116,21.499978,14.656862,2.869564,10.690959,7.821395,0.071956,1.523245,1.451289,9.121545,4.561137,-4.560408,1.055972,7.758483,6.702511,160.707484,10.878382,-149.829102,32.466409,97.62379,65.157381,0.027627,4.600053,4.572426,0.537627,14.382671,13.845044,0.400595,351.536031,351.135436,656.075591,644.938201,-11.13739,0.052451,0.568293,0.515842,81.153003,30.325378,-50.827625,142.614778,6.459418,-136.15536,0.497854,0,-0.497854,0.587159,4.715244,4.128085,0.180026,65.078532,64.898506,452.806828,152.879005,-299.927823,79.071012,19.353887,-59.717125,0.002999,0.207649,0.20465,0.107677,0.590657,0.48298,0.016825,0.01865,0.001825,8.82704,7.459336,-1.367704,25.849058,12.44286,-13.406198,0.540767,0.56152,0.020753,0.867024,1.3219,0.454876,0.004819,6.846437,6.841618,8.675937,13.572767,4.89683,0.0002,2.622717,2.622517,0.654941,10.783188,10.128247,3.578361,6.486466,2.908105,58.174119,170.77489,112.600771,0.039336,0.806775,0.767439,0.430634,0.017653,-0.412981,7.828054,29.571841,21.743787,36.027951,3.915244,-32.112707,10.77642,14.477505,3.701085,18.539145,4.642552,-13.896593,0,0.605708,0.605708,0.010501,0.058064,0.047563,0.473545,1.826211,1.352666,0.350079,0.185846,-0.164233,657.748389,525.654811,-132.093578,25.380926,20.662512,-4.718414,35.459285,6.851156,-28.608129,3.936699,7.996038,4.059339,3.608878,1.935746,-1.673132,0.828574,2.732922,1.904348,5.939868,3.97183,-1.968038,25.485881,0.056864,-25.429017,0,0,0,,,
2014-05-01,11547.945818,7280.714162,-4267.231656,37041.951002,24218.545042,-12823.40596,198237.075101927,136412.597923433,-61824.4771784938,15535.563377,0,-15535.563377,15714.871231,9244.223688,-6470.647543,35299.273282,27656.984112,-7642.28917,,,,12680.115057,15748.20506,3068.090003,55656.22267,48429.223693,-7226.998977,43451.926713,29060.174734,-14391.751979,3161.190558,3931.691976,770.501417999999,66589.945081,31290.310917,-35299.634164,200859.880099,138181.984632,-62677.8954669998,84582.763211,38563.305891,-46019.45732,2559.377817,2830.659295,271.281478,1327.524062,2448.649099,1121.125037,2502.968139,2583.149215,80.1810760000003,0.137299,0.734179,0.59688,30211.782657,27370.160527,-2841.62213,0.000529,0,-0.000529,25444.440013,21059.063166,-4385.376847,373.037337,508.303998,135.266661,7.028289,21.253642,14.225353,203.016854,327.052163,124.035309,395.576071,564.921844,169.345773,243.251945,69.434154,-173.817791,966.909061,614.981647,-351.927414,41.688701,897.594367,855.905666,2.483232,53.58642,51.103188,40.105138,207.802451,167.697313,0,14.638984,14.638984,24.49752,157.116387,132.618867,1.27074,21.311999,20.041259,2.064415,123.842654,121.778239,76.678909,128.070198,51.391289,377.586549,745.965489,368.37894,0.376526,3.304618,2.928092,0.370659,65.538738,65.168079,5.002411,22.472541,17.47013,1.055091,17.148522,16.093431,0.096856,0.915467,0.818611,0.170664,5.828711,5.658047,1.818322,15.029524,13.211202,0.117928,8.621126,8.503198,2.503393,5.321928,2.818535,4.376105,41.484173,37.108068,476.926187,196.352986,-280.573201,,,,4.528517,43.542573,39.014056,40.878186,31.074096,-9.80409,1.957596,187.835007,185.877411,0.218661,41.551042,41.332381,0.31898,35.569381,35.250401,1398.357026,1640.832634,242.475608,2588.659161,909.905127,-1678.754034,42.416826,25.314197,-17.102629,28.253355,43.996238,15.742883,0.025549,6.895106,6.869557,843.294366,903.696817,60.402451,442.4587,733.096906,290.638206,154.560972,80.690319,-73.870653,838.683807,1253.619518,414.935711,2569.779457,3661.803139,1092.023682,9.038793,191.103495,182.064702,37.775216,121.642317,83.867101,425.808666,998.104427,572.295761,5.09232,0.03799,-5.05433,23.459318,29.694183,6.234865,1061.083715,384.110737,-676.972978,0,1.603803,1.603803,486.432049,351.925911,-134.506138,493.155479,178.018007,-315.137472,12.222385,0.106914,-12.115471,594.735782,192.064886,-402.670896,4887.857479,4837.800103,-50.0573760000007,2933.234426,784.465722,-2148.768704,2006.974807,4020.070655,2013.095848,2200.033677,2871.959139,671.925462,129.697963,77.831537,-51.866426,0.138778,0.392905,0.254127,2.733159,63.497608,60.764449,4013.068126,2743.284772,-1269.783354,10840.263033,4060.192802,-6780.070231,932.480833,400.549668,-531.931165,,,,381.27153,263.058458,-118.213072,190.506766,30.620255,-159.886511,381.564002,143.586331,-237.977671,29.827679,2.169682,-27.657997,2671.956694,1577.252234,-1094.70446,48.725965,23.100163,-25.625802,24.70405,30.61952,5.91547,113.553057,47.811524,-65.741533,420.980447,287.104528,-133.875919,,,,2126.438375,1249.411238,-877.027137,10.549635,7.433587,-3.116048,138.506736,95.352495,-43.154241,8.246998,4.26651,-3.980488,0.399182,32.439838,32.040656,50.437507,43.095343,-7.342164,147.813346,78.190427,-69.622919,0.126026,5.118883,4.992857,2.467121,3.321165,0.854044,0.004377,4.921867,4.91749,1.512408,9.154651,7.642243,1.106159,40.358774,39.252615,1181.676655,927.161584,-254.515071,235.08918,105.548135,-129.541045,0.01177,119.175933,119.164163,13.70532,86.876428,73.171108,0.53003,2.125575,1.595545,0.038365,0.003335,-0.03503,3547.194105,1479.897357,-2067.296748,,,,40.209327,34.582274,-5.627053,54.814483,12.799315,-42.015168,6.721167,1.6083,-5.112867,9.928308,4.39334,-5.534968,,,,21.532927,10.671277,-10.86165,0.011598,0.611814,0.600216,0.56276,3.07534,2.51258,2.522551,4.935983,2.413432,97.718551,75.526362,-22.192189,161.874042,74.629246,-87.244796,53.776802,35.481275,-18.295527,653.738303,1095.320777,441.582474,2.0014,9.794259,7.792859,0.640322,0.094133,-0.546189,6.467443,79.606021,73.138578,961.143271,302.867992,-658.275279,0,11.629533,11.629533,1087.9,671.9,-416,0,0,0,0.363994,0.090238,-0.273756,95.592012,130.535965,34.943953,939.273549,178.362002,-760.911547,,,,4401.292227,1749.851939,-2651.440288,105.903325,337.13883,231.235505,208.300189,1719.942684,1511.642495,15.4742,41.162255,25.688055,125.183324,194.356086,69.172762,63.458253,73.815264,10.357011,1.668492,56.86674,55.198248,4143.098973,1736.875338,-2406.223635,307.526388,133.722584,-173.803804,5.714047,3.348184,-2.365863,414.224277,82.415359,-331.808918,198.814798,31.918222,-166.896576,5.969043,9.739379,3.770336,2279.849394,795.322768,-1484.526626,2384.169658,493.443747,-1890.725911,1.775764,4.025601,2.249837,183.801868,28.846871,-154.954997,2516.450086,1035.630208,-1480.819878,1401.685494,2449.114512,1047.429018,1516.435227,890.887806,-625.547421,0.032329,0.088234,0.055905,0.965636,74.288418,73.322782,744.014939,699.009562,-45.0053770000001,12.609249,29.523561,16.914312,0.026513,0.174678,0.148165,0.987977,1.950127,0.96215,38188.13577,9220.161982,-28967.973788,3.613807,62.982559,59.368752,0,0.224571,0.224571,6253.338162,3649.021564,-2604.316598,376.020268,2895.168119,2519.147851,3700.231663,2482.298195,-1217.933468,10577.747759,5451.450743,-5126.297016,939.331286,2118.413182,1179.081896,0,0.000666,0.000666,0.054268,0.105195,0.050927,1.199939,0.006442,-1.193497,0.000007,0.14393,0.143923,3.22818,8.920311,5.692131,359.751362,286.422754,-73.328608,0.080583,0.548318,0.467735,0.05499,0.227177,0.172187,0.002517,0.00317,0.000653,0.498198,1.808245,1.310047,0.209693,1.376312,1.166619,0.795757,0.231843,-0.563914,0.002233,0,-0.002233,0.089233,0.131207,0.041974,0.002498,0.078683,0.076185,2.953512,4.464353,1.510841,0,0.045356,0.045356,4.670038,10.478607,5.808569,1.104682,2.300514,1.195832,0.02965,2.954986,2.925336,0.062209,1.828421,1.766212,0.034724,0.051556,0.016832,13.257793,6.62286,-6.634933,0.112638,1.69039,1.577752,56.36484,207.174023,150.809183,410.332931,183.5304,-226.802531,60.455641,52.482319,-7.973322,146.205445,14.184914,-132.020531,127.545625,862.450063,734.904438,1.05656,7.814481,6.757921,0,5.752412,5.752412,0.000004,0.067453,0.067449,1.789714,25.259434,23.46972,0.277464,22.916586,22.639122,6.838747,25.947507,19.10876,1.489116,14.254633,12.765517,0.796738,1.585492,0.788754,7.55407,5.535118,-2.018952,0.845822,8.215754,7.369932,55.508956,13.507936,-42.00102,30.234771,68.954609,38.719838,0.005169,3.784606,3.779437,0.8687,4.776502,3.907802,0.504557,139.235348,138.730791,505.379046,715.337133,209.958087,0.712446,0.437337,-0.275109,79.9326,49.96793,-29.96467,202.113077,4.519335,-197.593742,1.802945,0,-1.802945,0.306056,9.108536,8.80248,0.794755,57.378141,56.583386,584.318945,227.698299,-356.620646,35.775442,15.998773,-19.776669,0.00097,0.416893,0.415923,0.359858,0.595724,0.235866,0.027683,0.066904,0.039221,9.396145,32.819519,23.423374,14.697747,25.955166,11.257419,0.315582,0.304114,-0.011468,1.592295,2.848499,1.256204,0.00157,3.963228,3.961658,13.223272,9.108682,-4.11459,0,0.281942,0.281942,0.157988,7.152443,6.994455,4.089534,6.4613,2.371766,42.838973,183.334865,140.495892,0.180447,1.037694,0.857247,0.771943,0.067646,-0.704297,10.907136,29.081176,18.17404,31.536994,2.476688,-29.060306,13.206174,19.728434,6.52226,26.200428,3.965286,-22.235142,0,0.851749,0.851749,0.004617,0.184923,0.180306,0.871017,1.514868,0.643851,0.010319,0.166292,0.155973,690.983829,499.13203,-191.851799,43.430647,64.739718,21.309071,31.894436,2.625663,-29.268773,13.870821,7.384979,-6.485842,4.674143,2.736841,-1.937302,2.875377,3.647522,0.772145,5.144423,1.698174,-3.446249,16.853477,0.068576,-16.784901,0,0,0,,,
2014-06-01,10576.566408,6817.806943,-3758.759465,36075.813452,24655.67192,-11420.141532,196110.427141681,135963.451945171,-60146.9751965098,14999.733866,0,-14999.733866,15583.741734,9601.653635,-5982.088099,35901.368828,28482.292856,-7419.075972,,,,12335.741125,15595.576063,3259.834938,55295.251682,47754.49038,-7540.761302,41967.795371,29613.426862,-12354.368509,2737.705342,3174.11979,436.414448,68566.375643,32323.909908,-36242.465735,198352.977195,138482.447486,-59870.5297090001,84758.750394,39672.010112,-45086.740282,2651.282413,2597.994593,-53.28782,1257.449881,2671.733579,1414.283698,2139.930744,2343.540134,203.609390000001,0.2834,1.0907,0.8073,30160.768175,27602.622669,-2558.145506,0,0,0,25134.483507,20151.867711,-4982.615796,399.926754,479.739205,79.812451,8.795092,18.134429,9.339337,210.488104,243.632131,33.144027,428.40076,558.660574,130.259814,263.8096,95.73198,-168.07762,954.352474,583.007833,-371.344641,35.978132,837.732964,801.754832,1.075219,41.555587,40.480368,43.854302,262.761159,218.906857,0,15.082988,15.082988,20.18052,186.567874,166.387354,0.601836,19.013237,18.411401,1.275919,59.296997,58.021078,82.203406,92.763295,10.559889,394.304721,637.22287,242.918149,0.604418,3.741374,3.136956,0.110683,13.287455,13.176772,4.802745,14.339624,9.536879,0.444272,13.536188,13.091916,0.082688,0.352876,0.270188,0.140641,5.04769,4.907049,1.30692,102.523126,101.216206,0.306203,12.533902,12.227699,0.864532,6.893869,6.029337,4.886599,44.715886,39.829287,480.866809,177.012113,-303.854696,,,,1.444277,36.017918,34.573641,36.420374,44.04288,7.62250599999999,1.701633,163.161839,161.460206,0.087535,42.88777,42.800235,0.538307,32.911688,32.373381,1203.745557,1695.257766,491.512209,2470.18993,969.770271,-1500.419659,49.788391,27.750821,-22.03757,23.857774,33.655376,9.797602,0.38715,1.011528,0.624378,753.556222,730.949448,-22.6067740000001,485.839317,794.191435,308.352118,172.274061,104.647924,-67.626137,751.735259,1506.141374,754.406115,2661.164819,3544.00858,882.843761,14.360053,168.461833,154.10178,44.79561,119.271823,74.476213,324.183822,1056.534048,732.350226,0.007685,0.014515,0.00683,24.747121,18.220505,-6.526616,1046.388984,490.97394,-555.415044,0,0.007273,0.007273,416.397593,345.031615,-71.365978,529.116122,240.842166,-288.273956,12.603786,0.394156,-12.20963,685.56939,224.223803,-461.345587,4413.937222,4617.363643,203.426421,3319.13275,657.78673,-2661.34602,1794.06399,3806.469045,2012.405055,1756.316328,3295.643735,1539.327407,59.925413,124.105288,64.179875,0.022077,0.36687,0.344793,3.194631,22.671834,19.477203,3949.291093,2790.137724,-1159.153369,9732.420594,4376.404,-5356.016594,947.328739,340.723686,-606.605053,,,,380.612751,270.08415,-110.528601,237.213998,35.763273,-201.450725,485.759835,152.489672,-333.270163,25.469969,2.045117,-23.424852,2361.33289,1960.899492,-400.433398,56.056111,32.211711,-23.8444,25.024476,26.584895,1.560419,93.900946,46.286378,-47.614568,433.762315,266.518447,-167.243868,,,,1966.47839,818.795816,-1147.682574,10.276866,7.501735,-2.775131,81.196473,85.805628,4.609155,5.40696,4.194139,-1.212821,119.822507,35.919703,-83.902804,52.058098,39.403005,-12.655093,133.06024,169.087814,36.027574,0.163331,4.695425,4.532094,3.321209,2.70401,-0.617199,0.072218,3.870682,3.798464,2.22902,9.831653,7.602633,0.585496,10.047197,9.461701,1439.790862,1032.634311,-407.156551,331.956103,90.762208,-241.193895,0.001153,264.624987,264.623834,12.787958,68.767025,55.979067,0.581724,1.418035,0.836311,0.083593,0.13646,0.052867,3901.736986,1414.364324,-2487.372662,,,,43.756114,36.69117,-7.064944,56.404126,20.859242,-35.544884,6.909029,6.091874,-0.817155000000001,15.904827,3.050937,-12.85389,,,,28.352022,8.449507,-19.902515,0.084815,1.999244,1.914429,0.030524,2.202113,2.171589,3.650426,3.768114,0.117688,90.249581,58.61658,-31.633001,200.525816,106.95302,-93.572796,47.271629,23.50824,-23.763389,617.944931,1124.520002,506.575071,5.51322,7.903514,2.390294,3.328372,0.410718,-2.917654,6.951758,80.696373,73.744615,1280.702255,150.625108,-1130.077147,0,17.644891,17.644891,947,707.8,-239.2,0.003122,0,-0.003122,0.24996,0.329755,0.079795,123.421784,139.938522,16.516738,1003.321043,315.487187,-687.833856,,,,3594.78964,1720.337603,-1874.452037,52.285309,179.015943,126.730634,260.822371,1814.46392,1553.641549,0.274551,17.405842,17.131291,67.695172,130.580483,62.885311,76.502149,81.132149,4.63,19.435732,61.46722,42.031488,3219.720466,1895.396968,-1324.323498,307.397102,131.423891,-175.973211,6.820722,2.451827,-4.368895,410.459105,97.482865,-312.97624,180.461149,26.972949,-153.4882,7.416299,5.467291,-1.949008,2313.668493,838.376206,-1475.292287,2532.58302,394.064777,-2138.518243,2.274069,2.507172,0.233103,216.85989,30.682397,-186.177493,2448.389002,1224.134196,-1224.254806,1553.211817,2423.278505,870.066688,1567.103572,664.73745,-902.366122,0.000038,0.249738,0.2497,0.549035,14.653581,14.104546,836.922298,697.634011,-139.288287,6.655021,33.734328,27.079307,0.007339,0.100052,0.092713,1.858431,2.933771,1.07534,39607.118661,9330.219574,-30276.899087,0.303284,10.158402,9.855118,0,1.640914,1.640914,5800.082912,3861.074334,-1939.008578,717.466709,3689.1818,2971.715091,3507.833317,2152.637743,-1355.195574,11298.190225,5650.820053,-5647.370172,865.811253,2133.134179,1267.322926,0,0.013149,0.013149,0.001652,0.428255,0.426603,0.069076,0.013556,-0.05552,0.00521,0,-0.00521,4.794635,13.445221,8.650586,352.247186,435.224933,82.977747,0.01589,0.569559,0.553669,0.014741,0.101164,0.086423,0.047298,0.003246,-0.044052,0.660756,2.178111,1.517355,0.448853,0.29216,-0.156693,0.65647,0.684436,0.027966,0.000703,0.000226,-0.000477,0.179249,0.624016,0.444767,0.004164,0.017638,0.013474,13.213049,4.865584,-8.347465,0.088735,0.009053,-0.079682,2.693299,10.589466,7.896167,0.92216,53.936361,53.014201,0.004339,3.264766,3.260427,0.159931,1.416412,1.256481,0.060429,0.009114,-0.051315,15.312054,8.980917,-6.331137,0.089664,1.849505,1.759841,51.492899,240.972119,189.47922,401.960506,79.70652,-322.253986,30.422544,44.16106,13.738516,91.572544,10.985341,-80.587203,111.727654,399.168916,287.441262,1.208146,14.038856,12.83071,0.000351,2.991131,2.99078,0.071727,0.114876,0.043149,15.842397,85.2911,69.448703,14.065556,8.373486,-5.69207,6.875447,31.514376,24.638929,2.394206,13.083246,10.68904,0.291843,4.683646,4.391803,8.486683,6.772039,-1.714644,0.48104,9.530196,9.049156,53.957878,17.383596,-36.574282,17.378171,93.665811,76.28764,0.023922,2.604287,2.580365,0.288357,3.579021,3.290664,0.523895,17.87827,17.354375,149.300917,451.369238,302.068321,0.05065,1.69826,1.64761,4.283413,21.999852,17.716439,290.212426,7.087939,-283.124487,0.000299,0,-0.000299,0.431295,6.405803,5.974508,0.218487,66.11944,65.900953,609.382813,324.348182,-285.034631,76.693473,19.105835,-57.587638,0.001158,0.395311,0.394153,0.129097,0.496327,0.36723,0.009556,0.423156,0.4136,0.574064,11.893312,11.319248,24.592676,13.558822,-11.033854,0.00515,0.989768,0.984618,0.452184,3.718418,3.266234,0.004109,1.522244,1.518135,11.092284,26.455702,15.363418,0.002587,0.090367,0.08778,0.059925,6.139514,6.079589,4.082801,6.135855,2.053054,55.152172,170.095622,114.94345,0.02392,0.805395,0.781475,1.840924,0.459645,-1.381279,4.512509,21.974479,17.46197,30.447366,3.472912,-26.974454,1.174719,20.890417,19.715698,12.22173,3.671473,-8.550257,0.000147,0.484,0.483853,0.00528,0,-0.00528,0.002633,1.077558,1.074925,0.00001,0.090915,0.090905,654.815955,558.318429,-96.497526,20.22421,41.302673,21.078463,24.164511,11.83298,-12.331531,2.850082,7.318053,4.467971,2.800606,2.126978,-0.673628,1.391191,2.764821,1.37363,3.471076,1.817108,-1.653968,24.91205,0.004533,-24.907517,0,0,0,,,
2014-07-01,12668.234449,6563.48476,-6104.749689,37033.408903,23357.956629,-13675.452274,196733.120722455,136452.101688471,-60281.0190339846,15381.561677,0,-15381.561677,14490.085546,8722.088952,-5767.996594,34283.110649,27150.336367,-7132.774282,,,,13505.866313,15295.557787,1789.691474,54594.965308,47062.890516,-7532.074792,43751.114186,27639.264849,-16111.849337,3017.771599,3199.002136,181.230537000001,69969.965693,30559.645516,-39410.320177,205134.173874,133326.645853,-71807.5280210001,88965.474101,37151.880638,-51813.593463,2502.8983,2527.69134,24.7930400000005,1298.566495,2977.298045,1678.73155,2218.681224,2280.911365,62.230141,0.413951,0.751882,0.337931,29285.94436,26230.066297,-3055.878063,0.001921,0,-0.001921,25309.020948,20832.824219,-4476.196729,339.819644,450.374523,110.554879,9.653366,16.032171,6.378805,243.897647,256.407941,12.510294,445.740501,519.814251,74.07375,276.691427,88.655484,-188.035943,782.071653,505.845673,-276.22598,46.59112,795.338846,748.747726,2.100082,51.724547,49.624465,27.757679,306.859547,279.101868,0,18.229457,18.229457,24.928776,171.126206,146.19743,0.76895,21.448659,20.679709,3.434567,86.409903,82.975336,78.28581,103.352398,25.066588,414.677428,706.593468,291.91604,0.460658,4.250551,3.789893,0.344273,58.403237,58.058964,4.509433,11.588066,7.078633,0.302178,14.896427,14.594249,0.199258,0.673948,0.47469,0.091268,5.45201,5.360742,1.402465,83.850824,82.448359,0.104394,5.864462,5.760068,0.86309,7.283239,6.420149,4.13687,46.099896,41.963026,576.960175,196.968731,-379.991444,,,,2.832408,37.81937,34.986962,18.296951,58.390405,40.093454,3.303232,71.395934,68.092702,0.168153,43.466852,43.298699,10.149683,26.321016,16.171333,1248.548457,1524.617106,276.068649,3084.10903,942.121472,-2141.987558,42.635389,32.287225,-10.348164,69.156109,35.798532,-33.357577,0.000133,0.954399,0.954266,904.975939,782.890322,-122.085617,592.870768,866.252923,273.382155,189.595395,104.634113,-84.961282,768.483119,1278.026914,509.543795,2908.834877,3636.629309,727.794432,27.02959,192.054133,165.024543,39.144343,104.981542,65.837199,308.268018,1023.366293,715.098275,1.672007,0.005462,-1.666545,23.774825,27.280903,3.506078,856.346996,293.133047,-563.213949,0.001052,0,-0.001052,473.678632,277.556273,-196.122359,443.583165,209.218552,-234.364613,9.766955,0.486606,-9.280349,657.804949,174.087188,-483.717761,4893.727924,5079.599393,185.871469000001,2583.288829,697.243383,-1886.045446,1554.360743,3680.714688,2126.353945,2123.738931,2912.561753,788.822822,67.579413,273.984261,206.404848,0.125743,0.118841,-0.00690199999999999,2.813885,2.276236,-0.537649,4164.094659,2458.448172,-1705.646487,10502.915742,3965.585159,-6537.330583,974.777152,175.179089,-799.598063,,,,405.134028,184.539845,-220.594183,189.859721,30.403376,-159.456345,516.403894,163.627031,-352.776863,27.427373,2.705462,-24.721911,2998.979029,1272.805546,-1726.173483,78.340225,25.874459,-52.465766,19.867523,35.113899,15.246376,100.273585,52.473426,-47.800159,473.40491,292.272438,-181.132472,,,,2114.822893,840.331588,-1274.491305,12.585696,7.143586,-5.44211,73.85862,81.591597,7.73297699999999,6.519599,3.200338,-3.319261,115.898005,19.857562,-96.040443,43.317201,38.994711,-4.32248999999999,125.362084,88.484266,-36.877818,0.169066,5.511212,5.342146,4.31774,2.9957,-1.32204,0.00341,1.247758,1.244348,2.094412,13.186213,11.091801,0.611185,27.130067,26.518882,1404.283961,909.898332,-494.385629,303.205996,69.032627,-234.173369,0.005513,339.577235,339.571722,14.219659,49.226984,35.007325,0.389235,1.102018,0.712783,0.075028,0.297377,0.222349,4206.513211,1403.335179,-2803.178032,,,,45.253611,10.607247,-34.646364,67.706422,60.697475,-7.00894700000001,8.852567,12.796248,3.943681,12.313672,2.532566,-9.781106,,,,23.651283,10.816524,-12.834759,0.011811,1.040205,1.028394,0.003389,2.179174,2.175785,2.170198,6.136979,3.966781,113.62228,48.546368,-65.075912,213.521808,56.324746,-157.197062,46.350626,39.656553,-6.694073,634.105182,1191.925429,557.820247,13.22894,6.571959,-6.656981,1.819896,0.770668,-1.049228,6.749806,172.349546,165.59974,1800.324157,130.686314,-1669.637843,0,18.851588,18.851588,1026,565.1,-460.9,0,0,0,0.254401,0.035533,-0.218868,137.549385,101.701347,-35.848038,1023.877317,225.150842,-798.726475,,,,4314.272672,1485.089138,-2829.183534,79.458386,330.111404,250.653018,286.866049,1819.759816,1532.893767,0.32876,25.363072,25.034312,64.170434,132.362088,68.191654,65.030294,129.28197,64.251676,1.410149,61.912927,60.502778,3925.873674,1858.241803,-2067.631871,336.566356,103.149781,-233.416575,7.671494,3.021488,-4.650006,524.511511,39.317113,-485.194398,237.493556,37.318013,-200.175543,6.703039,5.400505,-1.302534,2361.104319,1139.288226,-1221.816093,2686.014255,410.082915,-2275.93134,5.056637,1.197649,-3.858988,239.38417,32.346191,-207.037979,2612.727668,1052.217613,-1560.510055,1494.861422,2206.45296,711.591538,1736.265497,520.692092,-1215.573405,0.00217,0.024322,0.022152,2.598133,9.239999,6.641866,884.286249,622.030443,-262.255806,6.482753,27.739848,21.257095,0.009072,0.289481,0.280409,0.98964,1.882035,0.892395,40319.618346,9291.791064,-31027.827282,3.306447,8.214069,4.907622,0,0.017713,0.017713,6176.944037,3709.977198,-2466.966839,426.806833,2495.040915,2068.234082,3501.364452,2214.870692,-1286.49376,11544.225212,5470.134652,-6074.09056,855.880993,2443.366122,1587.485129,0,0,0,0.143878,0.242571,0.098693,0.434022,0.007386,-0.426636,0,0.008784,0.008784,7.357422,7.287044,-0.0703779999999998,400.546676,488.804874,88.258198,0.296778,0.452426,0.155648,0.022756,0.123873,0.101117,0.016658,0,-0.016658,1.031012,2.490664,1.459652,0.369234,0.30715,-0.062084,0.801988,0.264785,-0.537203,0.000124,0.002292,0.002168,0.24853,0.097299,-0.151231,0.013224,0.050966,0.037742,10.288535,5.05743,-5.231105,0,0.027184,0.027184,2.716185,10.358231,7.642046,1.158215,2.271383,1.113168,0.088459,3.604673,3.516214,0.001782,2.447299,2.445517,0.036103,0.387688,0.351585,16.96814,7.86554,-9.1026,0.147029,1.767904,1.620875,94.150681,132.626952,38.476271,509.836386,188.517454,-321.318932,55.096964,30.152997,-24.943967,0,0,0,136.436018,515.088682,378.652664,1.105304,13.145001,12.039697,0.031732,3.413727,3.381995,0,0,0,15.526658,33.984633,18.457975,19.535893,13.286752,-6.249141,10.491495,31.201695,20.7102,1.666449,17.868519,16.20207,0.544273,2.713165,2.168892,5.243988,3.72115,-1.522838,0.442546,9.175002,8.732456,75.927102,29.261223,-46.665879,32.419653,132.49859,100.078937,0.016917,5.415051,5.398134,1.13586,3.910703,2.774843,0.635302,143.864058,143.228756,189.427026,447.207131,257.780105,0.054163,1.183401,1.129238,90.557091,158.346368,67.789277,197.52628,6.919788,-190.606492,2.222403,0.029548,-2.192855,0.843324,6.124204,5.28088,0.255405,58.269211,58.013806,474.998734,143.426791,-331.571943,42.871801,34.093158,-8.778643,0.00091,0.242327,0.241417,0.122707,0.522153,0.399446,0.327695,0.128388,-0.199307,14.358162,9.724729,-4.633433,8.877383,25.4409,16.563517,0.051052,0.22722,0.176168,1.006003,0.834111,-0.171892,0.088047,1.174773,1.086726,14.007949,11.123528,-2.884421,0.0008,0.116979,0.116179,0.979836,8.736042,7.756206,2.392767,6.493234,4.100467,43.811726,217.255376,173.44365,0.505779,0.779598,0.273819,0.995925,0.013048,-0.982877,4.817795,16.320063,11.502268,34.482227,2.381518,-32.100709,13.462417,76.190305,62.727888,15.788697,2.743991,-13.044706,0.003958,0.303086,0.299128,0.712522,0.078636,-0.633886,0.200764,0.521269,0.320505,0.062481,0.285025,0.222544,756.128682,558.094878,-198.033804,41.198622,25.995913,-15.202709,45.376401,4.119793,-41.256608,1.067117,8.91582,7.848703,7.459705,2.138082,-5.321623,2.675347,4.452827,1.77748,2.188531,4.971693,2.783162,32.043594,0.548454,-31.49514,0,0,0,,,
2014-08-01,10586.972399,7368.539072,-3218.433327,34770.040493,23589.197685,-11180.842808,195646.868808895,137357.08680442,-58289.7820044748,15134.977818,0,-15134.977818,14565.611814,8932.03378,-5633.578034,33373.190299,28879.825093,-4493.365206,,,,12911.42847,16439.888732,3528.460262,53931.355421,46901.548498,-7029.806923,40639.479386,28350.811017,-12288.668369,3040.839719,3406.708777,365.869058,68765.153245,32905.175092,-35859.978153,197312.135523,137625.837418,-59686.2981050001,85390.629341,39751.491506,-45639.137835,2458.749311,2797.253282,338.503971,1397.961084,2774.951004,1376.98992,2249.246737,2474.904631,225.657893999999,0.441937,0.437884,-0.00405300000000003,29082.373669,26448.180167,-2634.193502,0.000165,0,-0.000165,24848.981752,20453.368331,-4395.613421,373.409714,618.158369,244.748655,13.02293,20.139084,7.116154,220.341331,323.047113,102.705782,404.666399,488.378412,83.712013,290.371843,95.560189,-194.811654,762.59917,562.137683,-200.461487,35.698989,735.332392,699.633403,2.183316,82.873493,80.690177,31.748589,243.60553,211.856941,0,15.224055,15.224055,22.100387,226.299281,204.198894,0.399172,27.451325,27.052153,2.296781,58.589316,56.292535,89.364313,100.05953,10.695217,407.360854,709.971516,302.610662,0.415777,4.261345,3.845568,0.291465,54.844413,54.552948,4.395208,11.847916,7.452708,0.239339,9.718908,9.479569,0.092569,1.749297,1.656728,0.018833,4.86145,4.842617,1.118665,51.893261,50.774596,0.071192,7.751557,7.680365,0.571884,5.784174,5.21229,3.650561,58.496727,54.846166,589.154841,216.286893,-372.867948,,,,2.972558,47.183083,44.210525,16.958467,30.807708,13.849241,2.763598,87.704469,84.940871,0.213389,34.434174,34.220785,8.83055,32.929114,24.098564,1528.354885,1727.141089,198.786204,2527.059629,1153.389285,-1373.670344,43.087471,40.544889,-2.542582,45.776521,47.568503,1.791982,0.000237,127.261822,127.261585,1044.277887,825.354468,-218.923419,379.599607,843.650486,464.050879,146.726054,106.710092,-40.015962,678.303378,1640.835645,962.532267,2764.939742,3683.949865,919.010123,26.568946,207.888134,181.319188,43.327153,118.613364,75.286211,395.457951,949.481637,554.023686,0.626325,0.117676,-0.508649,25.493345,25.089822,-0.403523,654.829543,345.674139,-309.155404,0,0.249481,0.249481,458.219675,311.974912,-146.244763,418.989255,149.172242,-269.817013,10.453662,0.214455,-10.239207,618.818313,201.505823,-417.31249,4056.721912,4780.331414,723.609502,2807.888648,624.597185,-2183.291463,1636.314532,3864.61032,2228.295788,1353.110969,3147.578058,1794.467089,63.525777,50.295215,-13.230562,0.017951,0.386094,0.368143,3.037305,6.734541,3.697236,3665.114465,2857.759674,-807.354791,11339.200237,4247.794627,-7091.40561,977.259124,199.256322,-778.002802,,,,372.445721,171.904495,-200.541226,159.54121,23.597258,-135.943952,474.469257,136.03202,-338.437237,24.664011,2.824321,-21.83969,2211.61211,1951.073714,-260.538396,63.071467,20.32507,-42.746397,21.50374,33.667648,12.163908,86.312072,49.476837,-36.835235,439.428098,319.193258,-120.23484,,,,2185.972928,758.306141,-1427.666787,7.545402,8.095107,0.549705,82.108348,112.318388,30.21004,11.537392,3.574157,-7.963235,29.563586,353.214253,323.650667,44.68995,44.938964,0.249013999999995,124.789786,86.306238,-38.483548,0.091237,6.786317,6.69508,3.619561,4.311431,0.69187,0.063177,1.629534,1.566357,4.109164,7.182061,3.072897,1.184255,7.706781,6.522526,1114.83767,682.88282,-431.95485,309.485214,67.691456,-241.793758,0.008281,158.914309,158.906028,13.941875,203.46711,189.525235,0.63393,0.267627,-0.366303,0.337526,0.800838,0.463312,3689.306909,1213.803537,-2475.503372,,,,31.675083,19.159933,-12.51515,59.299201,24.574364,-34.724837,7.820869,3.280411,-4.540458,11.86767,1.381893,-10.485777,,,,25.97388,8.518969,-17.454911,0.010972,0.616312,0.60534,0.06613,1.371073,1.304943,23.648745,4.273958,-19.374787,100.781877,45.98382,-54.798057,192.097743,79.042842,-113.054901,47.715985,23.960769,-23.755216,570.298045,889.27123,318.973185,2.354596,5.859429,3.504833,0.244934,0.764388,0.519454,4.994229,116.902081,111.907852,1595.696895,161.507361,-1434.189534,0,18.34104,18.34104,973.7,531.6,-442.1,0.022816,0.008617,-0.014199,0.161282,0.040284,-0.120998,153.349552,237.361084,84.011532,997.913055,482.30201,-515.611045,,,,2939.742145,1414.200722,-1525.541423,141.82376,524.858903,383.035143,273.798677,1654.837933,1381.039256,0.309538,37.963555,37.654017,61.99778,117.37632,55.37854,81.91453,76.358199,-5.556331,3.726638,62.339224,58.612586,3891.522959,1922.319463,-1969.203496,319.977197,115.532661,-204.444536,7.529226,2.830057,-4.699169,523.171407,34.482986,-488.688421,233.220161,30.427616,-202.792545,7.730603,6.777858,-0.952745,2327.722193,941.554176,-1386.168017,2597.498307,413.146322,-2184.351985,2.904193,1.914089,-0.990104,241.194309,36.12365,-205.070659,2662.906557,1169.780951,-1493.125606,1653.617689,2567.840405,914.222716,1676.051382,620.612127,-1055.439255,0.002942,0.110984,0.108042,0.834942,8.601494,7.766552,912.746161,820.237376,-92.508785,5.698971,40.154919,34.455948,0.144385,0.379284,0.234899,1.952615,2.275693,0.323078,40093.817085,9625.172763,-30468.644322,0.59366,6.464341,5.870681,0,0.106765,0.106765,5637.018098,3871.291319,-1765.726779,321.006586,3109.626397,2788.619811,3318.383856,2035.899591,-1282.484265,11112.927109,6303.158952,-4809.768157,1027.334956,2413.432988,1386.098032,0,0,0,0.123344,0.044512,-0.078832,0.147095,0.02183,-0.125265,0,0.012085,0.012085,11.222194,11.119378,-0.102816000000001,331.587659,308.246432,-23.3412269999999,0.003466,0.287226,0.28376,0.019289,0.038914,0.019625,0.0147,0.053433,0.038733,0.527532,1.499071,0.971539,0.434604,0.39678,-0.037824,0.534307,0.705901,0.171594,0.000497,0.006938,0.006441,0.193337,0.143297,-0.05004,0.000542,0.018064,0.017522,4.867197,14.73214,9.864943,0.000308,0,-0.000308,3.697057,11.504716,7.807659,1.07576,2.299839,1.224079,0.012914,2.739595,2.726681,0.004658,1.396716,1.392058,0.007812,0,-0.007812,15.995254,4.417882,-11.577372,0.151334,1.847359,1.696025,81.090588,137.211736,56.121148,513.008144,265.026913,-247.981231,25.720539,21.590566,-4.129973,0,0,0,127.305411,435.115518,307.810107,0.923955,2.104205,1.18025,0.01109,0.331648,0.320558,0.02226,0,-0.02226,101.182476,17.479254,-83.703222,24.042512,7.908067,-16.134445,9.835114,29.486801,19.651687,1.757781,14.626339,12.868558,0.48977,1.589716,1.099946,4.155734,7.178552,3.022818,0.716417,6.587925,5.871508,67.003292,16.708355,-50.294937,16.27896,88.566844,72.287884,0.06805,2.518886,2.450836,0.113089,1.673713,1.560624,0.564525,68.074107,67.509582,144.380244,583.174149,438.793905,0.078087,2.894795,2.816708,144.457662,21.736684,-122.720978,252.26312,5.595865,-246.667255,1.965906,0,-1.965906,2.089256,9.534575,7.445319,0.366162,78.098935,77.732773,372.511656,217.583684,-154.927972,9.517064,28.392408,18.875344,0.018535,0.250283,0.231748,0.145738,0.693834,0.548096,0.010702,0.083773,0.073071,6.971788,12.087898,5.11611,11.349097,17.44961,6.100513,0.000414,0.085151,0.084737,1.231808,0.835709,-0.396099,0.050967,2.710549,2.659582,13.236245,10.683099,-2.553146,0.006381,0.315427,0.309046,0.23988,16.281128,16.041248,2.793022,5.369015,2.575993,61.62255,325.464909,263.842359,0.622614,0.7504,0.127786,1.253267,0.005955,-1.247312,3.674216,68.414955,64.740739,31.876227,1.782219,-30.094008,2.044689,45.761283,43.716594,20.808396,4.022876,-16.78552,0.051808,0.372688,0.32088,0.075168,2.538453,2.463285,4.369181,0.483381,-3.8858,0.095843,3.517948,3.422105,849.30035,558.705619,-290.594731,13.062047,32.652332,19.590285,21.790494,6.748331,-15.042163,3.458173,6.669662,3.211489,4.959874,1.708401,-3.251473,3.956454,3.073335,-0.883119,4.362979,5.695106,1.332127,29.526028,0.017282,-29.508746,0,0,0,,,
2014-09-01,10840.234542,7251.070466,-3589.164076,34088.85946,22012.834247,-12076.025213,196867.519810028,134635.238493024,-62232.2813170037,15284.39185,0,-15284.39185,15621.090319,8860.45164,-6760.638679,38698.902571,28321.2288,-10377.673771,,,,12794.51684,15430.956814,2636.439974,55846.523553,46896.600273,-8949.92328,39526.712995,26096.20156,-13430.511435,2770.233595,2616.068259,-154.165336000001,74087.328566,32578.903369,-41508.425197,203729.650379,133668.613617,-70061.0367620002,91537.987497,39531.90977,-52006.077727,2252.111717,2387.420205,135.308488,1253.223648,3096.425625,1843.201977,1959.542668,1867.703567,-91.839101,0.452251,0.451316,-0.000935000000000019,30813.104753,26831.334322,-3981.770431,0,0,0,25033.4188,20065.265951,-4968.152849,317.616099,496.768578,179.152479,8.297749,18.628468,10.330719,206.421019,258.528025,52.107006,412.904249,457.280024,44.375775,275.055846,89.55234,-185.503506,668.297947,470.313371,-197.984576,41.763578,876.227146,834.463568,3.129165,32.667619,29.538454,71.633846,302.208454,230.574608,0,15.998667,15.998667,29.814623,191.745805,161.931182,1.035898,24.485327,23.449429,1.465647,58.05515,56.589503,88.911131,101.030612,12.119481,371.816557,614.977867,243.16131,0.46714,3.099623,2.632483,7.878425,17.542631,9.664206,3.91721,13.725024,9.807814,0.389756,16.851494,16.461738,0.034572,0.745215,0.710643,0.074858,5.411116,5.336258,1.161705,51.084063,49.922358,0.218653,7.361187,7.142534,0.328623,5.981066,5.652443,5.256517,43.826099,38.569582,388.569339,202.399176,-186.170163,,,,3.323451,43.689936,40.366485,11.376538,39.111837,27.735299,2.37436,155.726302,153.351942,0.481278,39.108289,38.627011,14.041036,36.020681,21.979645,1655.489987,1666.109003,10.6190160000001,2568.832997,1054.758439,-1514.074558,47.214157,32.70919,-14.504967,97.788509,51.128297,-46.660212,0.006711,3.365829,3.359118,1133.098236,728.041787,-405.056449,524.488419,785.124576,260.636157,157.976505,68.143662,-89.832843,712.547741,1593.853546,881.305805,2498.456448,3585.31482,1086.858372,29.145415,165.495449,136.350034,41.003674,114.728557,73.724883,390.411041,891.67403,501.262989,0.000185,0.358437,0.358252,22.840545,25.529702,2.689157,868.571578,358.457583,-510.113995,0.000151,0.010165,0.010014,300.700756,410.374287,109.673531,410.718424,177.607285,-233.111139,11.372435,0.151329,-11.221106,615.237867,172.856077,-442.38179,4463.793808,4514.80938,51.0155719999993,3142.964919,646.238708,-2496.726211,1651.304901,3184.238545,1532.933644,1737.322207,2726.006353,988.684146,92.669015,236.775288,144.106273,0.00831,0.626686,0.618376,1.680699,5.496237,3.815538,3607.484839,2305.917456,-1301.567383,10269.615481,4077.172716,-6192.442765,915.428223,224.601385,-690.826838,,,,386.795796,175.670185,-211.125611,134.754582,32.37071,-102.383872,546.272809,167.736852,-378.535957,22.433304,3.010662,-19.422642,2469.205907,1551.159809,-918.046098,47.032492,30.039836,-16.992656,26.293562,29.518049,3.224487,80.334768,61.998542,-18.336226,467.843445,287.601589,-180.241856,,,,1828.112249,712.197717,-1115.914532,8.693148,8.30459,-0.388558000000002,57.86558,97.956026,40.090446,5.449069,6.230699,0.781630000000001,0.29879,30.812325,30.513535,12.405644,42.192668,29.787024,25.725871,61.759543,36.033672,0.28236,5.874398,5.592038,3.140239,2.272303,-0.867936,0.037369,1.076974,1.039605,1.865865,9.664001,7.798136,3.070349,40.269892,37.199543,1014.124299,785.67973,-228.444569,244.589767,79.227659,-165.362108,0.003647,185.918095,185.914448,21.797555,10.355317,-11.442238,0.434147,0.034679,-0.399468,0.087383,0.066119,-0.021264,2931.697262,1474.386357,-1457.310905,,,,36.687256,39.666426,2.97917,49.237237,17.085524,-32.151713,5.337877,1.462793,-3.875084,16.817232,3.82444,-12.992792,,,,23.466446,7.464959,-16.001487,0.190033,1.630362,1.440329,0.834704,1.078964,0.24426,21.512435,1.930236,-19.582199,72.718809,50.519382,-22.199427,190.807707,105.036477,-85.77123,61.363087,24.274093,-37.088994,593.980991,864.986653,271.005662,1.397765,16.986743,15.588978,0.434649,2.209351,1.774702,4.573021,108.241902,103.668881,1228.878101,148.259309,-1080.618792,0,11.368324,11.368324,808,437.1,-370.9,0.027477,0,-0.027477,0.545323,0.206656,-0.338667,138.368031,108.474213,-29.893818,734.713055,571.081731,-163.631324,,,,3493.037868,1535.281792,-1957.756076,123.248648,436.64594,313.397292,308.122784,2072.731745,1764.608961,12.296988,26.557687,14.260699,69.189243,141.163122,71.973879,87.99032,81.552038,-6.438282,2.291087,57.280954,54.989867,4020.231395,1922.844153,-2097.387242,288.190599,113.399546,-174.791053,10.578846,1.757151,-8.821695,381.508902,41.050601,-340.458301,233.234382,46.518407,-186.715975,9.091617,8.114975,-0.976642,2367.457292,1151.132401,-1216.324891,2870.826454,416.056337,-2454.770117,3.525121,2.345525,-1.179596,278.673847,27.784955,-250.888892,2732.532524,1015.742141,-1716.790383,1505.41529,2454.814545,949.399255,1479.350163,838.827325,-640.522838,0.005157,0.472606,0.467449,0.827494,12.011595,11.184101,982.203948,651.676771,-330.527177,5.697015,25.625664,19.928649,0.000042,0.236032,0.23599,2.384002,3.013188,0.629186,45102.77541,9313.967699,-35788.807711,2.515487,7.77244,5.256953,0,1.979146,1.979146,5783.44672,3465.06628,-2318.38044,842.952696,4167.181649,3324.228953,3599.447757,2153.782098,-1445.665659,10839.859037,5424.170934,-5415.688103,909.751318,2423.5197,1513.768382,0.014468,0.049536,0.035068,0.024066,0.030954,0.006888,0.004982,0.013456,0.008474,0.000076,0.001521,0.001445,11.350242,7.004599,-4.345643,291.718952,625.512369,333.793417,0.052835,0.466461,0.413626,0.046308,0.067947,0.021639,0.022229,0.003225,-0.019004,0.308882,2.262022,1.95314,1.427553,0.358416,-1.069137,0.518105,0.616938,0.0988329999999999,0.000814,0,-0.000814,0.127412,0.068133,-0.059279,0.000902,0.00879,0.007888,7.672989,14.057261,6.384272,0.000154,0.004748,0.004594,2.724476,7.924838,5.200362,0.889499,2.306438,1.416939,0.024377,3.610641,3.586264,0.134164,1.524717,1.390553,0.041227,0,-0.041227,25.035727,4.861018,-20.174709,1.199503,2.038331,0.838828,153.04193,158.39254,5.35060999999999,501.151718,162.74643,-338.405288,30.180705,25.274557,-4.906148,0,0,0,124.494573,387.695264,263.200691,0.626,24.018713,23.392713,0.000153,15.984558,15.984405,0.012898,0.080197,0.067299,22.641925,18.686661,-3.955264,2.350655,23.715377,21.364722,7.649245,19.097628,11.448383,1.502045,10.318576,8.816531,1.356107,2.854609,1.498502,6.049218,3.121457,-2.927761,1.965667,4.626123,2.660456,39.95795,16.68013,-23.27782,27.608944,181.752819,154.143875,0.021044,2.893218,2.872174,0.11547,1.554423,1.438953,0.73867,4.49796,3.75929,227.653074,362.533746,134.880672,0.001273,10.84444,10.843167,9.101797,18.984661,9.882864,188.179149,7.083899,-181.09525,0.338884,0,-0.338884,0.302091,5.073399,4.771308,0.495591,55.949993,55.454402,521.425807,154.867207,-366.5586,4.874482,25.180782,20.3063,0.000595,0.068208,0.067613,0.240037,0.653804,0.413767,0.277827,0.162711,-0.115116,6.443215,19.293192,12.849977,16.740145,19.886609,3.146464,0.005752,1.489411,1.483659,4.519273,0.497436,-4.021837,0.012377,0.165108,0.152731,10.301648,33.321665,23.020017,0.00948,0.239998,0.230518,0.578068,8.946839,8.368771,4.979362,4.472473,-0.506889,51.149665,182.053107,130.903442,0.028792,0.875493,0.846701,0.433916,0.009938,-0.423978,5.552246,22.57523,17.022984,35.535376,4.121646,-31.41373,17.016469,66.123652,49.107183,19.01271,4.504398,-14.508312,0,0.282247,0.282247,0.27365,0.02133,-0.25232,0.963936,0.628346,-0.33559,0.000111,0.158816,0.158705,597.859735,501.965045,-95.89469,6.850283,30.17633,23.326047,30.660179,3.119141,-27.541038,4.927513,8.967746,4.040233,9.382272,2.409914,-6.972358,13.721875,3.667388,-10.054487,5.479132,1.115615,-4.363517,47.201998,0.018585,-47.183413,0,0,0,,,
2014-10-01,9565.150022,7735.77703,-1829.372992,36883.107873,23869.341074,-13013.766799,197659.725766755,136752.756146723,-60906.9696200317,17277.069296,0,-17277.069296,15515.451937,9361.063555,-6154.388382,39581.626034,30465.638855,-9115.987179,,,,12791.072193,15959.279949,3168.207756,58280.876018,50741.894323,-7538.98169499999,43456.927591,28176.952071,-15279.97552,2833.305732,3358.879249,525.573517,76033.767451,36742.037284,-39291.730167,211643.112866,145613.923496,-66029.1893700001,92941.386336,44578.437617,-48362.948719,2331.352156,2724.108394,392.756238,1337.85082,2798.176248,1460.325428,2221.074504,2238.916585,17.8420810000016,1.693741,0.299675,-1.394066,30715.273887,28392.840265,-2322.433622,0.000435,0.004364,0.003929,27565.602131,22349.054058,-5216.548073,337.084739,573.415636,236.330897,4.180036,23.616366,19.43633,209.893217,295.769653,85.876436,424.158282,514.418256,90.2599740000001,285.836434,91.450323,-194.386111,672.077926,585.281151,-86.796775,38.745968,951.852826,913.106858,1.006456,34.81401,33.807554,43.861607,189.24327,145.381663,0,16.950119,16.950119,24.630096,172.741349,148.111253,0.66579,31.35995,30.69416,2.081511,67.063936,64.982425,92.463854,106.696175,14.232321,402.301558,663.773375,261.471817,0.533965,9.139996,8.606031,0.233332,49.574618,49.341286,4.335632,18.615467,14.279835,0.475491,20.707451,20.23196,0.006566,0.54136,0.534794,0.124962,6.728715,6.603753,1.314374,75.396911,74.082537,0.118018,11.142023,11.024005,0.518821,8.337173,7.818352,6.710301,65.838892,59.128591,482.392477,227.848395,-254.544082,,,,2.879883,78.120256,75.240373,21.643051,74.708679,53.065628,2.387323,97.779179,95.391856,0.082939,25.701843,25.618904,8.405444,18.903889,10.498445,1517.945722,1764.161464,246.215742,2614.991465,1245.00966,-1369.981805,35.505387,32.678931,-2.826456,34.615719,52.098865,17.483146,0.005048,4.839664,4.834616,990.696509,677.651808,-313.044701,404.677785,837.288371,432.610586,168.603489,63.874321,-104.729168,715.138281,1122.713588,407.575307,2743.334639,3865.913603,1122.578964,15.762963,167.884002,152.121039,40.527998,242.39553,201.867532,432.928828,775.132891,342.204063,5.188307,0.106009,-5.082298,33.531063,18.868325,-14.662738,962.315583,361.713147,-600.602436,0.001455,0.492768,0.491313,388.668995,303.869922,-84.799073,409.386318,149.216403,-260.169915,11.376221,0.061506,-11.314715,678.204035,165.48018,-512.723855,4814.106127,4786.152401,-27.9537259999997,2619.593562,813.224633,-1806.368929,1938.879379,3423.119412,1484.240033,1972.383662,3171.392245,1199.008583,49.24021,56.575754,7.33554400000001,0.635989,0.225401,-0.410588,4.906812,2.16329,-2.743522,4253.200942,2819.055436,-1434.145506,10930.39068,3990.307989,-6940.082691,936.07705,270.291294,-665.785756,,,,396.592284,190.897311,-205.694973,184.816345,94.238549,-90.577796,520.701661,162.037346,-358.664315,26.543442,3.891877,-22.651565,2828.506887,1781.224186,-1047.282701,41.616474,20.504115,-21.112359,28.220796,43.309504,15.088708,75.828376,73.999444,-1.82893200000001,460.657571,312.027125,-148.630446,,,,1936.234708,1050.568067,-885.666641,11.75771,7.247128,-4.510582,47.742306,74.044797,26.302491,12.615817,7.522288,-5.093529,335.943796,30.677237,-305.266559,14.174875,45.884147,31.709272,153.639022,64.661696,-88.977326,0.24189,13.689035,13.447145,2.799551,3.101455,0.301904,0.002754,0.419998,0.417244,3.247794,7.692991,4.445197,0.759425,3.902741,3.143316,1139.352055,967.510845,-171.84121,270.105031,147.746111,-122.35892,0.00729,61.797087,61.789797,13.607335,90.046602,76.439267,0.488767,0.200202,-0.288565,0,0.006633,0.006633,3785.351908,1408.798034,-2376.553874,,,,29.106509,14.665507,-14.441002,68.578844,70.098414,1.51957,6.624676,1.182494,-5.442182,13.790735,5.958525,-7.83221,,,,23.981089,9.390066,-14.591023,0.011634,1.557908,1.546274,0.273891,0.760368,0.486477,1.533706,2.837229,1.303523,80.798431,128.426611,47.62818,165.551805,108.78517,-56.766635,54.87867,20.084628,-34.794042,713.777418,803.71163,89.934212,3.56623,9.636864,6.070634,0.275886,0.109623,-0.166263,4.597684,179.065578,174.467894,830.452415,129.171661,-701.280754,0,15.509603,15.509603,1018.9,513.6,-505.3,0.02696,0,-0.02696,0.213242,0.616072,0.40283,121.870505,347.044928,225.174423,869.267253,230.697717,-638.569536,,,,2673.151815,1603.396977,-1069.754838,141.910758,878.337057,736.426299,274.242962,2031.714666,1757.471704,0.043396,30.679911,30.636515,88.596466,118.967514,30.371048,90.656884,90.283383,-0.373501000000005,2.088038,55.91286,53.824822,4225.616172,2037.423434,-2188.192738,351.056161,130.58264,-220.473521,7.543908,2.499389,-5.044519,446.825458,36.06829,-410.757168,244.706131,26.971038,-217.735093,9.487496,7.525175,-1.962321,2490.144949,1044.94205,-1445.202899,3128.571277,494.507985,-2634.063292,3.092121,2.750845,-0.341276,281.362048,31.328315,-250.033733,2899.475561,1188.975034,-1710.500527,1450.201222,2954.194938,1503.993716,1860.804027,731.772601,-1129.031426,0.120161,0.030585,-0.089576,0.884373,10.070084,9.185711,887.696542,744.370099,-143.326443,6.900075,78.54107,71.640995,0.003909,0.236653,0.232744,2.264573,2.440665,0.176092,45335.351722,12593.334298,-32742.017424,1.055659,5.948028,4.892369,0,0.028837,0.028837,6038.462698,3626.880417,-2411.582281,512.247382,3952.580434,3440.333052,3705.306455,2484.422217,-1220.884238,12024.072185,5621.792714,-6402.279471,1010.853519,2411.084675,1400.231156,0.001932,0.011495,0.009563,2.38402,0.132599,-2.251421,0.080056,0.017599,-0.062457,0.000025,0,-0.000025,11.765267,7.163094,-4.602173,289.746423,336.855609,47.109186,0.027196,0.725287,0.698091,0.454125,0.086737,-0.367388,0.034886,0,-0.034886,0.225009,1.85895,1.633941,0.83875,0.332566,-0.506184,0.353932,0.186016,-0.167916,0.000305,0,-0.000305,0.247376,0.266628,0.019252,0.014075,0.076356,0.062281,1.317375,4.562167,3.244792,0.000388,0.071191,0.070803,3.40156,12.288455,8.886895,1.094789,4.925028,3.830239,0.017476,6.513378,6.495902,0.075655,1.343945,1.26829,0.039176,0.148991,0.109815,14.706373,6.443951,-8.262422,0.180661,3.07944,2.898779,71.523164,92.319652,20.796488,393.628014,200.113135,-193.514879,31.210596,117.176966,85.96637,0,0,0,112.872774,683.0457,570.172926,1.1958,14.196763,13.000963,0.01134,12.15431,12.14297,0,0,0,7.1881,27.805329,20.617229,8.842745,9.562034,0.719289,16.481038,36.315232,19.834194,1.554245,8.710601,7.156356,0.524349,3.017476,2.493127,7.051264,6.685616,-0.365648,0.867423,7.232564,6.365141,104.490288,16.732642,-87.757646,17.809227,83.754071,65.944844,0.043769,2.19797,2.154201,0.178182,4.089478,3.911296,0.500069,5.723059,5.22299,176.036213,567.230682,391.194469,0.020937,9.98161,9.960673,131.226652,23.233321,-107.993331,270.174317,11.099812,-259.074505,0.006831,0.070454,0.063623,0.224743,7.733258,7.508515,0.235768,62.845997,62.610229,600.187614,133.27963,-466.907984,8.842624,31.548465,22.705841,0.000567,0.194334,0.193767,0.096967,0.843046,0.746079,0.055803,0.029277,-0.026526,4.085853,17.747036,13.661183,2.793849,9.61734,6.823491,0.001937,0.325879,0.323942,3.118759,0.608315,-2.510444,0.104053,0.374143,0.27009,9.900656,32.402225,22.501569,0.035172,0.557798,0.522626,0.701575,13.785313,13.083738,4.762382,5.501254,0.738872000000001,49.713987,227.78571,178.071723,0.270857,0.869729,0.598872,2.113894,0.000071,-2.113823,6.409565,24.066236,17.656671,44.630247,4.413184,-40.217063,11.742175,23.585171,11.842996,19.635768,6.309451,-13.326317,0,0.627375,0.627375,0.263531,0.061516,-0.202015,0.290383,0.875856,0.585473,0.00009,1.316136,1.316046,619.709863,572.647586,-47.062277,11.585044,19.363038,7.777994,17.79049,5.799754,-11.990736,3.02575,7.135403,4.109653,5.715268,1.820295,-3.894973,8.98477,4.156852,-4.827918,17.578027,2.494845,-15.083182,22.657129,0.116965,-22.540164,0,0,0,,,
2014-11-01,7695.883069,6865.447538,-830.435531000002,34267.083197,22006.269578,-12260.813619,194611.759601644,134748.50004369,-59863.2595579542,15223.061595,0,-15223.061595,13824.932523,8368.004697,-5456.927826,39734.834493,28216.83529,-11517.999203,,,,10427.558742,15123.166292,4695.60755,51440.360305,45171.733196,-6268.62710899999,39494.081865,27199.217024,-12294.864841,2456.252985,3211.448065,755.195079999999,70697.149252,33583.197224,-37113.952028,190689.694315,134722.680199,-55967.0141159999,85626.55017,41547.727895,-44078.822275,1925.926041,2562.139548,636.213507,1244.750768,2469.133782,1224.383014,1868.895208,2224.764501,355.869292999999,0.13948,0.253945,0.114465,27058.340548,25465.027401,-1593.313147,0,0,0,24382.019757,19706.705795,-4675.313962,312.196357,468.369986,156.173629,3.634171,21.160929,17.526758,175.732108,289.291952,113.559844,331.228471,479.045201,147.81673,259.929731,89.167358,-170.762373,472.509641,540.668116,68.1584750000001,26.129763,833.312633,807.18287,1.326212,80.333714,79.007502,31.172104,211.715834,180.54373,0,12.719571,12.719571,22.676631,176.47648,153.799849,0.433648,21.558532,21.124884,3.057138,93.761973,90.704835,71.907412,123.787899,51.880487,374.329733,695.596935,321.267202,0.36769,7.444915,7.077225,0.308221,23.104547,22.796326,4.480528,17.575706,13.095178,0.181467,20.77334,20.591873,0.011201,1.098964,1.087763,0.055738,4.118077,4.062339,1.38024,58.359474,56.979234,0.029572,7.514103,7.484531,0.495783,7.895371,7.399588,3.232626,43.006814,39.774188,510.614327,219.514483,-291.099844,,,,5.257542,99.092491,93.834949,43.989395,58.968759,14.979364,1.61977,109.138195,107.518425,0.321479,26.964723,26.643244,8.224296,36.141389,27.917093,1378.688959,1599.274129,220.58517,1667.148319,1068.634675,-598.513644,48.154997,33.854668,-14.300329,29.506412,53.516434,24.010022,0.008556,3.895742,3.887186,629.765072,605.158734,-24.6063380000001,491.589157,860.623022,369.033865,125.705207,77.701057,-48.00415,559.26642,1546.834367,987.567947,2463.080121,3225.031563,761.951442,15.08437,198.168885,183.084515,39.501703,109.054504,69.552801,313.214481,863.475143,550.260662,0.011973,0.264905,0.252932,24.104316,68.689705,44.585389,771.200599,343.104757,-428.095842,0.000111,0.25665,0.256539,353.782023,353.040318,-0.741704999999968,389.251722,164.707271,-224.544451,9.525159,0.047891,-9.477268,524.492883,196.95162,-327.541263,4341.23254,4240.793842,-100.438698,2432.723681,548.905896,-1883.817785,1528.851008,3793.550287,2264.699279,1588.29069,2912.967816,1324.677126,49.477298,51.066953,1.589655,0.01816,0.178625,0.160465,2.722181,2.135356,-0.586825,3900.605675,2319.056855,-1581.54882,10565.987757,4002.387545,-6563.600212,904.492791,212.433361,-692.05943,,,,342.00785,169.597787,-172.410063,179.575482,28.833903,-150.741579,427.082246,142.699208,-284.383038,23.395076,2.436572,-20.958504,2510.663791,2465.328814,-45.334977,34.709573,26.074838,-8.634735,32.049608,31.078056,-0.971551999999999,78.744759,80.543531,1.798772,434.98204,298.068292,-136.913748,,,,1142.487323,913.88396,-228.603363,11.374389,12.752942,1.378553,54.781861,85.617023,30.835162,11.802835,4.275282,-7.527553,164.962473,69.054266,-95.908207,106.720562,114.473119,7.752557,149.074954,52.989077,-96.085877,0.10833,4.315936,4.207606,2.756422,2.344387,-0.412035,0.007565,3.294713,3.287148,0.331642,5.558374,5.226732,0.54914,8.582066,8.032926,1335.763598,835.04035,-500.723248,265.008011,78.792522,-186.215489,0.088409,102.289165,102.200756,12.039564,67.415747,55.376183,0.596964,0.010112,-0.586852,0.005858,0.020922,0.015064,3722.403774,1255.672516,-2466.731258,,,,34.73596,23.209692,-11.526268,67.024126,14.200703,-52.823423,5.862814,10.90433,5.041516,24.386758,1.607809,-22.778949,,,,16.155554,9.987431,-6.168123,0.109688,1.594809,1.485121,0.169009,0.927862,0.758853,2.08139,4.955085,2.873695,84.035556,55.948036,-28.08752,167.890979,54.626228,-113.264751,50.365369,24.862189,-25.50318,608.373911,891.394845,283.020934,2.058058,33.679777,31.621719,0.902202,0.383607,-0.518595,6.520562,127.603856,121.083294,1024.229121,152.375601,-871.85352,0,16.67943,16.67943,1093.3,521.6,-571.7,0,0.056301,0.056301,0.221536,0.004361,-0.217175,105.166647,355.090283,249.923636,449.012576,264.403875,-184.608701,,,,2633.731693,1487.277039,-1146.454654,110.030192,314.824137,204.793945,191.819267,2041.802909,1849.983642,0.182242,37.119226,36.936984,69.151273,336.985153,267.83388,47.450665,92.31242,44.861755,3.900694,50.915784,47.01509,3379.038196,2133.200282,-1245.837914,264.337064,119.729749,-144.607315,7.214641,2.954989,-4.259652,318.194674,56.391566,-261.803108,200.137949,22.523843,-177.614106,6.475683,8.695597,2.219914,2187.921387,939.989764,-1247.931623,2863.001123,556.130702,-2306.870421,2.394564,1.891603,-0.502961,208.917666,24.710895,-184.206771,2786.169111,1102.781178,-1683.387933,1111.610041,2528.104587,1416.494546,1501.485275,654.182732,-847.302543,0.01939,0.01125,-0.00814,8.282294,9.008973,0.726678999999999,833.009223,686.960545,-146.048678,4.616143,37.710197,33.094054,0.007703,0.181618,0.173915,2.290109,2.302692,0.0125829999999998,42483.529438,12125.930519,-30357.598919,1.585083,7.691959,6.106876,0,2.008196,2.008196,6446.797189,3506.267597,-2940.529592,359.583345,3323.317168,2963.733823,3244.645432,2123.795928,-1120.849504,10707.019485,5063.241285,-5643.7782,925.304016,2130.517868,1205.213852,0,0.0429,0.0429,0.136105,0,-0.136105,0.165027,0.008901,-0.156126,0.000849,0.014106,0.013257,7.39022,9.173235,1.783015,277.70804,282.205412,4.49737200000004,0.021944,0.339621,0.317677,0.086266,0,-0.086266,0.002859,0,-0.002859,0.133424,2.130657,1.997233,0.80282,0.30714,-0.49568,0.267256,0.574297,0.307041,0.001829,0,-0.001829,0.3149,0.198787,-0.116113,0.001369,0,-0.001369,11.293036,13.677576,2.38454,0.000041,0,-0.000041,3.235545,12.892186,9.656641,1.056989,4.665499,3.60851,0.086251,3.747588,3.661337,0.018658,1.664839,1.646181,0.047111,0.0513,0.004189,16.510378,4.953013,-11.557365,0.165968,1.822249,1.656281,82.014278,144.136064,62.121786,262.817238,262.231956,-0.58528199999995,23.012991,123.643297,100.630306,0,0,0,90.592379,414.615816,324.023437,1.201602,6.174579,4.972977,0.011838,0.424481,0.412643,0,0,0,13.88557,68.736401,54.850831,0.086627,9.537056,9.450429,27.908932,28.179409,0.270477,1.892094,11.361191,9.469097,0.229083,1.557911,1.328828,5.351866,4.737242,-0.614624,9.249581,6.831268,-2.418313,34.750847,56.962978,22.212131,7.763428,102.890302,95.126874,0.002772,3.494518,3.491746,0.443904,8.788755,8.344851,0.770613,4.659037,3.888424,126.483341,462.168566,335.685225,0.191145,1.791851,1.600706,16.670727,13.531677,-3.13905,140.40634,3.635678,-136.770662,0.479561,0.052757,-0.426804,0.451302,5.607582,5.15628,0.470531,62.276396,61.805865,473.238879,150.49537,-322.743509,25.955566,73.753132,47.797566,0,0.440645,0.440645,0.284174,1.055667,0.771493,0.061085,0.008441,-0.052644,12.711573,12.754012,0.0424389999999999,8.353738,11.394957,3.041219,0.326143,0.122768,-0.203375,16.02001,0.608651,-15.411359,0.058686,0.427861,0.369175,7.310129,38.591017,31.280888,0.004142,0.469212,0.46507,2.699525,8.366478,5.666953,4.647012,6.61505,1.968038,46.192358,43.336629,-2.855729,0.296651,1.563634,1.266983,0.817769,0.04375,-0.774019,6.492828,16.86581,10.372982,23.588887,3.76676,-19.822127,4.935665,8.288693,3.353028,17.80561,4.572036,-13.233574,0.014215,0.773058,0.758843,0.394208,0.069563,-0.324645,0.014742,1.340369,1.325627,0.000048,0.990525,0.990477,729.861173,546.698687,-183.162486,7.930321,5.834764,-2.095557,25.204121,2.545319,-22.658802,8.208394,6.235318,-1.973076,18.979776,3.1733,-15.806476,9.560993,4.708933,-4.85206,4.90473,1.345624,-3.559106,19.706512,0.354778,-19.351734,0,0,0,,,
2014-12-01,9154.292548,7792.769111,-1361.523437,35840.972727,22129.023113,-13711.949614,196566.849057632,133744.385247476,-62822.463810156,15065.244648,0,-15065.244648,13963.663071,8191.478758,-5772.184313,39137.010615,31117.949516,-8019.061099,,,,12104.358988,14740.060949,2635.701961,52852.825,43594.827895,-9257.99710499999,41627.423175,26445.477895,-15181.94528,2993.250928,2837.183381,-156.067547,69400.396225,34879.297052,-34521.099173,195996.473951,133722.05346,-62274.420491,85031.322719,43626.937838,-41404.384881,2101.325942,2224.39899,123.073048,1387.264563,2477.084214,1089.819651,2341.842475,1819.67798,-522.164495,0.028578,0.379455,0.350877,28829.06026,24756.651664,-4072.408596,0,0,0,24023.76474,18838.176231,-5185.588509,367.273925,468.944756,101.670831,4.18039,20.904747,16.724357,202.437865,230.082998,27.645133,396.214989,383.192239,-13.02275,266.544203,81.577318,-184.966885,472.140638,465.886177,-6.25446100000005,43.873354,834.256384,790.38303,19.092769,84.77774,65.684971,41.275034,296.354449,255.079415,0,26.312891,26.312891,22.707078,200.962303,178.255225,1.308735,28.095366,26.786631,1.185977,57.227148,56.041171,73.105901,117.72817,44.622269,396.714322,594.715502,198.00118,0.296179,10.975882,10.679703,0.325097,16.80757,16.482473,4.880565,18.630209,13.749644,0.389096,36.15047,35.761374,0.019847,0.824473,0.804626,0.093713,5.925044,5.831331,1.163393,112.491456,111.328063,0.055614,12.973043,12.917429,0.252775,6.787629,6.534854,3.974848,39.386153,35.411305,512.779737,212.200332,-300.579405,,,,4.276803,99.85669,95.579887,63.444587,83.450265,20.005678,7.233133,71.176627,63.943494,0.123539,18.388182,18.264643,5.788094,17.037775,11.249681,1646.050791,1906.109474,260.058683,1979.977372,1124.214828,-855.762544,52.015145,31.098617,-20.916528,22.150725,49.935278,27.784553,0.00027,0.513231,0.512961,865.322608,661.494739,-203.827869,556.175589,819.32998,263.154391,141.035892,68.697705,-72.338187,766.241599,1163.92627,397.684671,2772.0664,3120.282441,348.216041,17.727885,185.002454,167.274569,40.483535,110.34641,69.862875,330.866966,844.968802,514.101836,1.092011,0.060732,-1.031279,20.360157,29.204222,8.844065,914.692661,350.162885,-564.529776,0,0.151826,0.151826,367.82413,308.112537,-59.7115930000001,441.39023,183.650929,-257.739301,8.284591,0.329224,-7.955367,559.525194,247.330448,-312.194746,4864.818042,4579.596383,-285.221659,3615.748012,545.978128,-3069.769884,1641.661751,3593.879696,1952.217945,1678.950957,2552.167497,873.21654,51.114214,117.230172,66.115958,0.027255,0.257128,0.229873,2.915023,2.963952,0.0489289999999998,3902.893688,2535.485819,-1367.407869,10198.912367,3806.559157,-6392.35321,802.467773,195.214073,-607.2537,,,,419.657477,164.057634,-255.599843,143.205588,27.039212,-116.166376,494.603929,164.475136,-330.128793,25.519213,2.156977,-23.362236,2672.517935,1777.318257,-895.199678,40.316944,18.927169,-21.389775,20.092428,26.944419,6.851991,79.298648,40.607,-38.691648,460.460136,296.56887,-163.891266,,,,1702.153302,545.827713,-1156.325589,16.127432,7.74423,-8.383202,91.109149,104.560635,13.451486,8.274387,3.358089,-4.916298,2.436769,268.210785,265.774016,22.096322,43.659719,21.563397,123.906792,101.834624,-22.072168,0.522667,4.456211,3.933544,3.273253,1.798998,-1.474255,0.013054,1.921499,1.908445,1.3238,16.42351,15.09971,1.594609,32.676295,31.081686,1252.428716,817.651757,-434.776959,240.30012,121.259303,-119.040817,0.014473,78.80562,78.791147,17.478678,87.082406,69.603728,0.592693,0.260986,-0.331707,0.017779,0.312087,0.294308,3598.296791,1416.663439,-2181.633352,,,,37.838544,21.526744,-16.3118,61.43098,20.503748,-40.927232,6.015809,0.666372,-5.349437,14.127792,2.06376,-12.064032,,,,21.807233,9.102143,-12.70509,0.038809,2.513636,2.474827,0.018259,1.334773,1.316514,1.770338,4.46498,2.694642,81.088756,59.058539,-22.030217,165.473516,110.374333,-55.099183,52.550069,20.641928,-31.908141,671.767423,963.963994,292.196571,4.276518,8.386289,4.109771,2.018082,0.930557,-1.087525,6.646328,107.928213,101.281885,1055.259242,304.393926,-750.865316,0,18.042444,18.042444,965,561.5,-403.5,0.003795,0,-0.003795,0.692248,0.165338,-0.52691,110.852441,162.961105,52.108664,656.960291,356.871046,-300.089245,,,,2976.296129,2239.600386,-736.695743,152.100591,213.602657,61.502066,193.607612,2093.364858,1899.757246,0.027481,16.735767,16.708286,65.257004,223.759484,158.50248,84.115803,111.430646,27.314843,2.418623,55.36973,52.951107,3467.309552,1943.023883,-1524.285669,283.896776,144.696929,-139.199847,6.380587,2.002739,-4.377848,377.582203,97.89295,-279.689253,238.360207,27.379392,-210.980815,14.765108,9.704329,-5.060779,2491.883056,1195.832887,-1296.050169,2625.215118,597.631391,-2027.583727,4.25365,1.931916,-2.321734,192.802767,18.744161,-174.058606,2889.777289,1216.488857,-1673.288432,1314.545491,2394.523671,1079.97818,1499.485452,531.149531,-968.335921,0.000797,0.026485,0.025688,0.727479,77.195451,76.467972,890.964501,689.670252,-201.294249,4.565886,45.315669,40.749783,0.001705,0.239602,0.237897,2.291349,2.422912,0.131563,40395.902459,12175.209863,-28220.692596,0.7152,7.488375,6.773175,0,0.083619,0.083619,5912.962163,3834.668277,-2078.293886,409.54005,3300.696624,2891.156574,3244.487933,2375.427102,-869.060831,11479.628273,5793.153528,-5686.474745,949.618588,1984.863854,1035.245266,0,0,0,0.043388,0.01613,-0.027258,0.097459,0.020401,-0.077058,0,0,0,9.618085,8.736061,-0.882024000000001,398.572576,452.198312,53.625736,0.056344,0.467112,0.410768,0.021973,0.158107,0.136134,0.018546,0.003698,-0.014848,0.04208,0.945468,0.903388,0.682009,0.687611,0.005602,0.679375,0.172848,-0.506527,0.000019,0.006668,0.006649,0.359422,0.128617,-0.230805,0.005136,0.673198,0.668062,4.478699,3.556332,-0.922367,0.003677,0.009203,0.005526,2.60572,7.391086,4.785366,0.918447,7.057306,6.138859,0.013482,2.557447,2.543965,0.007251,1.726124,1.718873,0.193431,0,-0.193431,19.07874,5.717343,-13.361397,0.150743,0.574711,0.423968,58.059545,125.563357,67.503812,400.230607,221.707268,-178.523339,27.126089,171.442115,144.316026,0,0,0,114.002329,456.170766,342.168437,0.591374,1.091137,0.499763,0.000308,0.411433,0.411125,0,0.014461,0.014461,13.907905,166.19724,152.289335,0.306898,8.725439,8.418541,34.336517,25.795033,-8.541484,4.888423,19.070257,14.181834,0.101986,1.897649,1.795663,7.684061,8.297346,0.613284999999999,0.644776,9.53074,8.885964,43.957346,17.315346,-26.642,17.765344,123.982837,106.217493,0.003143,3.24532,3.242177,0.274087,3.312724,3.038637,0.976372,75.980771,75.004399,382.320122,387.963376,5.64325399999996,0.004583,1.516818,1.512235,0.557469,17.809327,17.251858,202.504365,3.696354,-198.808011,0.026179,0.009466,-0.016713,0.634458,2.495169,1.860711,0.371989,68.506255,68.134266,443.067174,132.710466,-310.356708,56.589395,35.322612,-21.266783,0,0.264005,0.264005,0.035042,0.443609,0.408567,0.182375,0.086907,-0.095468,3.589772,13.476053,9.886281,10.012515,14.804035,4.79152,0.6966,0.377068,-0.319532,5.640859,4.753674,-0.887185,0.083036,1.137532,1.054496,7.302466,32.968122,25.665656,0.034308,0.080177,0.045869,5.027282,8.47211,3.444828,6.571805,6.072036,-0.499769000000001,60.75876,22.378896,-38.379864,0.218895,1.23129,1.012395,0.966923,1.400076,0.433153,10.286409,16.468849,6.18244,42.615259,2.16422,-40.451039,5.971067,18.350262,12.379195,16.336354,3.404933,-12.931421,0,0.21615,0.21615,0.234808,0.207143,-0.027665,1.842365,0.608792,-1.233573,0.000171,1.286504,1.286333,844.635249,522.118816,-322.516433,18.957417,14.365526,-4.591891,31.603668,2.55763,-29.046038,3.797019,12.713495,8.916476,9.535036,1.51294,-8.022096,12.170478,4.708865,-7.461613,5.586797,2.776072,-2.810725,22.308818,0.240426,-22.068392,0,0.101833,0.101833,,,
2015-01-01,6746.540713,5651.988647,-1094.552066,32089.314425,22145.02853,-9944.28589499999,190913.898879462,128127.901241579,-62785.9976378831,12764.33585,0,-12764.33585,12576.084788,6658.245005,-5917.839783,32126.972128,27118.523251,-5008.448877,,,,10652.965457,12596.416297,1943.45084,48098.143389,41607.432891,-6490.710498,37246.922924,26055.121927,-11191.800997,2150.916678,2254.827783,103.911105,66973.138635,29405.88744,-37567.251195,181173.098198,120880.02606,-60293.072138,81721.800002,36070.46573,-45651.334272,1646.07078,2276.074863,630.004083,1302.277535,2295.463468,993.185933,1609.830806,1452.847783,-156.983023,0.072211,0.271913,0.199702,25840.933297,22474.316101,-3366.617196,0.000002,0.026051,0.026049,22257.210092,19133.11679,-3124.093302,330.747397,467.468402,136.721005,4.206538,19.216562,15.010024,168.689807,243.846076,75.156269,304.45327,418.481068,114.027798,214.331087,88.904384,-125.426703,371.463686,474.51102,103.047334,31.860224,714.424405,682.564181,4.521217,69.42595,64.904733,32.857966,170.516367,137.658401,0,25.335168,25.335168,22.333764,137.436612,115.102848,0.31385,25.219811,24.905961,1.476256,47.995045,46.518789,48.890471,83.902383,35.011912,256.385533,582.863913,326.47838,0.687501,2.528671,1.84117,0.966208,13.456458,12.49025,7.972333,13.053829,5.081496,0.29955,74.594479,74.294929,0.268151,0.495245,0.227094,0.110622,5.542084,5.431462,0.963019,44.573982,43.610963,0.024929,3.932887,3.907958,0.515203,10.493907,9.978704,2.645987,65.109977,62.46399,523.265181,177.691311,-345.57387,,,,4.472147,96.659623,92.187476,8.442162,26.235727,17.793565,1.192598,119.163638,117.97104,0.085736,21.887721,21.801985,7.980143,28.635367,20.655224,1210.683343,1371.121282,160.437939,1583.919886,715.016849,-868.903037,37.585385,22.318232,-15.267153,27.614879,31.529901,3.915022,0.002526,1.017866,1.01534,912.129624,438.057148,-474.072476,541.403703,735.416295,194.012592,125.073304,66.655472,-58.417832,977.294418,1172.263458,194.96904,2457.334513,2777.529491,320.194978,18.1258,166.483735,148.357935,45.473851,140.775294,95.301443,362.779924,684.521109,321.741185,1.121765,0.108093,-1.013672,26.291415,28.791014,2.499599,723.605747,294.687449,-428.918298,0,0,0,292.459599,243.037401,-49.422198,408.132619,141.194691,-266.937928,4.887646,0.103927,-4.783719,621.477313,194.451184,-427.026129,4212.572474,4433.444658,220.872184000001,3011.937193,621.423297,-2390.513896,1616.425362,3229.843537,1613.418175,1386.618712,2823.469243,1436.850531,45.738202,55.864127,10.125925,0.063104,0.092235,0.029131,1.798149,1.894164,0.096015,3543.29942,2507.152787,-1036.146633,9310.91545,3750.248402,-5560.667048,844.242303,790.480291,-53.762012,,,,373.441339,173.646538,-199.794801,116.161312,53.077704,-63.083608,424.650592,135.110652,-289.53994,25.021688,2.205889,-22.815799,2186.756469,1705.374097,-481.382372,36.086788,26.068437,-10.018351,23.783079,21.924687,-1.858392,57.847325,45.019154,-12.828171,395.275376,299.484302,-95.791074,,,,1623.763449,631.797162,-991.966287,15.678096,2.593612,-13.084484,66.79018,89.097082,22.306902,4.748318,3.076256,-1.672062,4.101654,22.867218,18.765564,26.295593,33.119782,6.824189,96.852219,43.716225,-53.135994,0.068891,5.143043,5.074152,2.619888,1.327228,-1.29266,0.036245,0.672256,0.636011,0.622902,9.244825,8.621923,0.901208,16.508155,15.606947,1056.597943,916.397086,-140.200857,182.022098,94.212495,-87.809603,0.012313,185.562006,185.549693,11.822561,63.90114,52.078579,0.62286,0.105137,-0.517723,0.000984,0.292687,0.291703,3275.493011,1225.263314,-2050.229697,,,,37.33658,31.371825,-5.964755,51.707304,32.767097,-18.940207,6.38314,1.718255,-4.664885,14.32257,0.572946,-13.749624,,,,43.512271,6.181577,-37.330694,0.036965,0.392389,0.355424,0.286239,0.539135,0.252896,24.54275,2.093928,-22.448822,96.315176,71.378142,-24.937034,179.386203,80.777202,-98.609001,42.932467,25.243857,-17.68861,688.131694,871.973766,183.842072,3.490476,7.125232,3.634756,0.707581,0.301236,-0.406345,4.187823,134.527142,130.339319,421.749772,244.599819,-177.149953,0,13.22172,13.22172,1101.8,558.6,-543.2,0,0.04973,0.04973,0.772429,0.032166,-0.740263,122.486091,118.434827,-4.051264,711.778113,180.33836,-531.439753,,,,2156.170624,1540.041156,-616.129468,157.437868,145.778043,-11.659825,203.32768,1875.637181,1672.309501,28.793164,13.457552,-15.335612,126.524507,117.707411,-8.81709600000001,102.577939,99.497565,-3.08037400000001,1.969612,31.23694,29.267328,3664.866486,1543.647594,-2121.218892,302.338739,131.823585,-170.515154,9.657416,1.336663,-8.320753,489.888926,30.566681,-459.322245,261.895803,21.526584,-240.369219,8.956339,14.29724,5.340901,2209.557082,1046.874232,-1162.68285,2703.201137,519.494009,-2183.707128,3.780997,2.489193,-1.291804,229.26771,25.780284,-203.487426,2606.060326,960.939905,-1645.120421,1270.656152,2287.685747,1017.029595,1661.133001,575.753812,-1085.379189,0.000296,0.062585,0.062289,1.521569,9.646408,8.124839,847.781336,694.670637,-153.110699,5.981321,26.705568,20.724247,0.00202,0.136438,0.134418,2.170053,2.191565,0.0215120000000004,38587.208452,9472.450738,-29114.757714,1.347349,5.251488,3.904139,0,0.146892,0.146892,6307.735959,3288.664214,-3019.071745,372.540666,2858.456097,2485.915431,3145.818364,1874.711933,-1271.106431,10892.738369,5095.305086,-5797.433283,917.682371,1967.928211,1050.24584,1.14315,0.004148,-1.139002,0.058149,0,-0.058149,0.18098,0.216544,0.035564,0,0,0,6.564522,38.456072,31.89155,349.716227,254.513012,-95.203215,0.170397,0.338548,0.168151,0.015116,0.053368,0.038252,0.006096,0,-0.006096,0.23555,3.176547,2.940997,1.400358,0.16644,-1.233918,0.542156,0.290573,-0.251583,0.000022,0,-0.000022,0.337168,2.569516,2.232348,0.001635,0.067163,0.065528,3.10543,4.206415,1.100985,0.013056,0.010878,-0.002178,3.793084,10.578253,6.785169,1.103719,3.160811,2.057092,0.020114,2.237025,2.216911,0.000177,1.835579,1.835402,0.009483,0.007639,-0.001844,15.906112,4.584773,-11.321339,0.278588,1.048489,0.769901,79.716538,220.232228,140.51569,270.374533,148.801495,-121.573038,44.272877,58.547779,14.274902,,,,120.083022,353.49355,233.410528,0.7856,2.806874,2.021274,0,1.1168,1.1168,0.004405,0.0048,0.000395,0.525676,12.012605,11.486929,0.199683,5.816492,5.616809,9.3861,16.716838,7.330738,1.819493,30.113951,28.294458,0.632243,3.132798,2.500555,5.74764,3.203877,-2.543763,0.341647,5.423723,5.082076,109.687677,26.177935,-83.509742,15.725916,55.320746,39.59483,0.006506,2.478202,2.471696,0.153953,1.760535,1.606582,0.921176,10.847375,9.926199,145.136148,251.966101,106.829953,0.02651,0.216398,0.189888,12.815029,17.871294,5.056265,120.595792,8.665061,-111.930731,0.541015,0.054361,-0.486654,0.349446,1.652419,1.302973,0.74057,66.274397,65.533827,161.340408,80.047838,-81.29257,66.085622,18.916468,-47.169154,0.000154,0.164082,0.163928,0.402613,0.344784,-0.057829,0.012522,0.033964,0.021442,3.896101,10.798605,6.902504,13.863091,9.11057,-4.752521,0.923533,0.310078,-0.613455,5.421741,0.271438,-5.150303,0.069635,3.863009,3.793374,4.866045,31.701098,26.835053,0.01138,0.131582,0.120202,11.333104,12.966425,1.633321,6.18131,6.053869,-0.127441,53.238428,87.052599,33.814171,0.335477,1.332463,0.996986,0.463244,0.008527,-0.454717,13.965818,11.003971,-2.961847,28.449108,1.62379,-26.825318,18.947738,23.303483,4.355745,19.640505,9.706948,-9.933557,0.009053,0.639472,0.630419,0.136851,0.050874,-0.085977,2.45393,0.646584,-1.807346,0.000251,1.084365,1.084114,707.727699,479.541238,-228.186461,2.693296,10.649352,7.956056,6.372535,3.788761,-2.583774,11.243141,8.139448,-3.103693,0.409968,1.52104,1.111072,11.741542,2.490474,-9.251068,5.491274,2.263746,-3.227528,24.726332,0.078646,-24.647686,0,0,0,,,
2015-02-01,5163.144471,5854.604236,691.459765000001,31786.318368,22155.831101,-9630.487267,184095.718273524,126664.646953961,-57431.0713195629,13172.50289,0,-13172.50289,10758.923476,6837.139453,-3921.784023,28789.091723,25621.752975,-3167.338748,,,,9079.071366,12399.138316,3320.06695,45965.678933,39999.662812,-5966.016121,36474.063593,25891.138886,-10582.924707,1739.116711,2035.130288,296.013577000001,55717.591384,28698.74482,-27018.846564,162916.19201,118236.531486,-44679.6605240001,68501.50003,35847.665484,-32653.834546,1952.976358,2153.536221,200.559863,1156.580537,2063.744529,907.163991999999,1207.938298,1334.022104,126.083806,0.180835,0.051171,-0.129664,23255.865981,21845.640058,-1410.225923,0.000005,0,-0.000005,22709.812952,18154.022754,-4555.790198,336.925167,406.42941,69.504243,4.883421,20.443598,15.560177,206.296782,246.086754,39.789972,396.408428,441.581845,45.173417,241.206165,90.607538,-150.598627,400.945911,427.418394,26.472483,23.668257,548.614698,524.946441,70.195361,31.108688,-39.086673,35.688068,155.304089,119.616021,0,14.535658,14.535658,25.294407,137.776543,112.482136,0.404753,19.683856,19.279103,1.864232,47.054482,45.19025,70.190729,64.040774,-6.14995500000001,371.193905,541.41228,170.218375,0.305239,3.47268,3.167441,0.300366,14.417262,14.116896,4.713859,12.207805,7.493946,0.146301,97.936524,97.790223,0.007352,1.132617,1.125265,0.170583,5.58808,5.417497,1.551361,36.483594,34.932233,0.127934,5.701656,5.573722,0.482614,6.726671,6.244057,9.257504,37.605391,28.347887,389.209698,215.741499,-173.468199,,,,5.139741,88.258272,83.118531,26.849697,44.473821,17.624124,1.317995,115.384769,114.066774,0.522743,7.490964,6.968221,3.393821,12.581663,9.187842,933.796045,1207.000125,273.20408,1133.17101,619.356223,-513.814787,35.795753,56.611598,20.815845,18.950504,34.106112,15.155608,0.002581,128.965652,128.963071,693.06904,474.120739,-218.948301,370.213273,679.81123,309.597957,72.980271,62.914032,-10.066239,862.187425,1490.149427,627.962002,2026.664563,2815.687952,789.023389,11.566937,139.584995,128.018058,38.039297,119.256804,81.217507,253.955108,674.166491,420.211383,0.017165,0.105061,0.087896,24.534272,43.895987,19.361715,711.4674,337.359408,-374.107992,0.002724,0,-0.002724,367.545999,270.809854,-96.736145,335.661486,97.900756,-237.76073,4.900825,0.138272,-4.762553,563.64205,173.840046,-389.802004,4356.844129,4337.996036,-18.8480930000005,2700.991628,734.797991,-1966.193637,1283.269378,3274.491141,1991.221763,1515.717047,2668.30971,1152.592663,72.416187,118.881387,46.4652,0.094746,0.347733,0.252987,0.647699,5.811401,5.163702,3499.630615,2344.232432,-1155.398183,9353.939886,4067.850002,-5286.089884,876.272386,1035.932856,159.66047,,,,347.066715,149.680841,-197.385874,149.833055,24.047236,-125.785819,478.282993,154.262218,-324.020775,24.938931,1.60916,-23.329771,2058.070942,1685.175492,-372.89545,37.821399,15.122656,-22.698743,16.935953,23.683336,6.747383,81.796011,31.471739,-50.324272,389.601457,280.859866,-108.741591,,,,1243.716191,591.479022,-652.237169,36.254526,4.475697,-31.778829,105.937173,65.233505,-40.703668,6.344272,3.447281,-2.896991,125.226959,25.851282,-99.375677,7.742486,34.044641,26.302155,34.550469,74.482501,39.932032,0.020327,2.423664,2.403337,3.844531,0.541608,-3.302923,0.094069,1.094061,0.999992,0.249775,7.549871,7.300096,1.068591,39.53118,38.462589,994.444255,790.054198,-204.390057,266.901027,113.203245,-153.697782,0.015291,106.188012,106.172721,13.338545,5.631632,-7.706913,0.341539,0.159933,-0.181606,0.085021,0.413201,0.32818,3374.365446,1175.137956,-2199.22749,,,,61.183755,23.825378,-37.358377,43.007392,15.756764,-27.250628,4.253945,1.419654,-2.834291,25.020062,1.134332,-23.88573,,,,19.121503,10.438139,-8.683364,0.033815,0.601461,0.567646,0.052861,0.290254,0.237393,2.860092,2.210894,-0.649198,77.320436,71.366428,-5.954008,137.398217,65.100268,-72.297949,45.600061,19.236103,-26.363958,590.175589,754.509693,164.334104,1.569459,5.799472,4.230013,0.129971,0.231869,0.101898,7.273267,154.191923,146.918656,448.54591,220.281694,-228.264216,0,17.072102,17.072102,923.3,582.3,-341,0,0,0,0.131919,0.078399,-0.05352,100.664417,80.310702,-20.353715,481.118046,287.71155,-193.406496,,,,1571.856329,1270.362873,-301.493456,98.227116,676.272387,578.045271,193.508311,1726.831359,1533.323048,17.98151,25.808602,7.827092,91.778819,167.299315,75.520496,73.576385,129.957686,56.381301,5.899848,37.258645,31.358797,3313.130345,1616.228915,-1696.90143,278.405132,162.778364,-115.626768,5.950995,1.375875,-4.57512,502.747778,84.628682,-418.119096,208.602938,37.514486,-171.088452,7.629846,19.277368,11.647522,1935.702021,779.207243,-1156.494778,2329.750655,505.879371,-1823.871284,3.941155,1.990705,-1.95045,205.741356,24.907144,-180.834212,2278.363197,936.48401,-1341.879187,1187.772771,1971.898601,784.12583,1324.228123,602.640472,-721.587651,0.027857,0.04694,0.019083,6.528017,28.870781,22.342764,663.276559,597.211392,-66.065167,5.436935,34.15441,28.717475,0.013976,0.127794,0.113818,0.773982,1.854513,1.080531,31568.996408,8760.712957,-22808.283451,0.322787,5.321737,4.99895,0,0.05581,0.05581,4974.960502,3346.784575,-1628.175927,367.467748,3492.027396,3124.559648,2831.262439,1813.480295,-1017.782144,9367.720782,5087.090793,-4280.629989,817.101924,1793.539321,976.437397,0,0,0,0.248223,0.003453,-0.24477,0.150326,0.106497,-0.043829,0.000094,0.104584,0.10449,5.79607,13.16052,7.36445,318.679909,220.689297,-97.990612,0.05285,0.539511,0.486661,0.025494,0.054514,0.02902,0.008746,0,-0.008746,0.096912,1.843029,1.746117,0.029064,0.267579,0.238515,0.429364,0.088867,-0.340497,0,0,0,0.160233,0.316309,0.156076,0.006031,0.071855,0.065824,3.310223,8.039253,4.72903,0.036192,0.021816,-0.014376,1.788247,9.264326,7.476079,0.965461,3.306981,2.34152,0.031106,3.118469,3.087363,0.05961,3.035298,2.975688,0.047115,0.019491,-0.027624,7.450831,3.325989,-4.124842,0.143939,2.430613,2.286674,89.738634,181.729369,91.990735,257.699472,102.888388,-154.811084,54.102531,35.944846,-18.157685,,,,125.111734,370.17932,245.067586,0.072418,3.046837,2.974419,0.00182,0.190533,0.188713,0.000114,0,-0.000114,12.393662,21.154586,8.760924,0.021151,6.109852,6.088701,22.516515,27.92119,5.404675,1.452103,8.519536,7.067433,0.168887,13.560843,13.391956,2.924339,2.761741,-0.162598,0.549414,10.078754,9.52934,119.472784,38.227553,-81.245231,18.8636,61.781178,42.917578,0.051282,2.34412,2.292838,0.071255,1.978994,1.907739,0.862836,4.392358,3.529522,59.954041,336.761153,276.807112,0.092953,0.251855,0.158902,12.200875,15.059423,2.858548,139.446823,4.484975,-134.961848,0.016349,0.61576,0.599411,0.313551,2.701307,2.387756,0.581971,55.78606,55.204089,225.371497,115.111795,-110.259702,2.946586,17.951999,15.005413,0.000011,0.126771,0.12676,0.004355,0.539541,0.535186,0.02849,0.044637,0.016147,0.289162,18.846967,18.557805,10.192152,24.543065,14.350913,0.277778,0.486816,0.209038,2.978717,0.866859,-2.111858,0.016372,1.38529,1.368918,6.498102,36.595794,30.097692,0.005559,0.217902,0.212343,2.824711,11.041249,8.216538,4.764849,11.14616,6.381311,37.985339,45.513596,7.528257,0.554915,1.318067,0.763152,1.252986,0.273441,-0.979545,8.733485,9.395033,0.661548,28.132585,2.431256,-25.701329,0.929696,5.847403,4.917707,18.430343,2.255394,-16.174949,0,0.98587,0.98587,0.019505,0.058006,0.038501,2.602193,0.505341,-2.096852,0.004902,0.788039,0.783137,416.927368,398.080181,-18.847187,3.783807,9.164784,5.380977,20.029151,2.224008,-17.805143,2.728031,8.227221,5.49919,0.181942,2.053373,1.871431,1.71977,1.934468,0.214698,1.189259,1.165784,-0.0234750000000001,15.022438,0.058764,-14.963674,0,0,0,,,
2015-03-01,5237.60215,6344.917678,1107.315528,37026.072931,24132.003536,-12894.069395,197354.63488115,127161.699880747,-70192.935000403,15414.3776,0,-15414.3776,12139.778076,8343.091228,-3796.686848,35943.382465,29798.475155,-6144.90731,,,,10763.406666,13708.455634,2945.048968,51425.939256,45390.069144,-6035.870112,43170.604463,29514.929118,-13655.675345,2132.522241,2204.740521,72.21828,73779.646903,32493.063667,-41286.583236,198186.862503,133664.107737,-64522.7547659999,89293.689129,40349.022621,-48944.666508,2182.721436,2491.510507,308.789071000001,1400.424043,2495.417683,1094.99364,1634.680839,1465.903984,-168.776855,0.27663,1.454862,1.178232,25776.338315,25505.97819,-270.360124999999,0.000075,0.018154,0.018079,25649.600941,19884.090954,-5765.509987,379.577409,489.799658,110.222249,7.100443,28.486216,21.385773,227.478314,269.282279,41.803965,456.248847,432.672648,-23.576199,285.420449,120.302331,-165.118118,415.652481,555.472594,139.820113,43.227116,682.036409,638.809293,1.024458,163.179457,162.154999,38.976,290.937382,251.961382,0,33.790504,33.790504,24.350571,143.737345,119.386774,0.40939,22.791416,22.382026,7.057556,52.363236,45.30568,80.514316,108.280309,27.765993,418.343936,623.980997,205.637061,0.292148,3.449918,3.15777,0.730671,15.812782,15.082111,5.571037,12.504799,6.933762,0.152274,122.928142,122.775868,0.023621,0.598001,0.57438,0.165378,5.561333,5.395955,3.93063,29.020908,25.090278,0.18108,5.712306,5.531226,0.941549,6.282913,5.341364,3.917596,32.758293,28.840697,551.923236,205.583718,-346.339518,,,,7.091797,76.375446,69.283649,49.918051,60.21524,10.297189,2.69565,62.860951,60.165301,0.162971,4.004634,3.841663,0.222248,14.366139,14.143891,1513.138123,1493.888668,-19.2494549999999,1449.319452,772.590477,-676.728975,43.28161,38.280913,-5.000697,11.475125,35.974673,24.499548,0.00301,1.682337,1.679327,654.881103,497.562884,-157.318219,384.235919,767.587105,383.351186,88.708645,86.595705,-2.11294000000001,994.244657,1442.136397,447.89174,2198.889742,2829.880765,630.991023,10.818728,107.806159,96.987431,61.205983,126.37244,65.166457,336.005479,832.549867,496.544388,3.897867,0.39894,-3.498927,32.561519,27.122486,-5.439033,866.792371,345.168339,-521.624032,0.000095,0.206347,0.206252,399.610115,393.150837,-6.45927799999998,405.61032,125.060042,-280.550278,7.899822,0.733046,-7.166776,844.881168,182.056546,-662.824622,4630.976187,4479.852448,-151.123739000001,3244.374385,897.030221,-2347.344164,1570.236775,3875.278037,2305.041262,1640.730571,2904.548087,1263.817516,59.790914,243.092489,183.301575,0.046852,0.183636,0.136784,3.532555,5.150744,1.618189,4155.013565,2608.688043,-1546.325522,10853.594491,4668.506839,-6185.087652,1036.521879,216.344754,-820.177125,,,,389.864775,174.607002,-215.257773,244.322285,33.013224,-211.309061,560.395108,144.989958,-415.40515,23.67668,2.047108,-21.629572,3285.629975,2763.99257,-521.637405,49.816764,23.97181,-25.844954,30.25283,24.773472,-5.479358,127.768116,55.715496,-72.05262,500.833284,440.00273,-60.830554,,,,1446.104914,702.471777,-743.633137,22.733664,5.005859,-17.727805,67.20357,79.324494,12.120924,7.030187,3.508973,-3.521214,38.181442,21.764026,-16.417416,16.213069,27.534723,11.321654,8.998021,40.122902,31.124881,0.047575,3.711284,3.663709,3.928569,1.263693,-2.664876,9.748749,1.03547,-8.713279,0.726665,14.415891,13.689226,0.483102,10.294426,9.811324,1225.501562,779.286926,-446.214636,296.477923,86.59005,-209.887873,0.012428,167.753104,167.740676,14.629283,27.465607,12.836324,0.378875,0.036346,-0.342529,0.055442,0.304274,0.248832,3813.062674,1540.055066,-2273.007608,,,,54.049966,44.980352,-9.06961399999999,60.438684,20.622165,-39.816519,5.078938,0.637354,-4.441584,15.824739,1.425618,-14.399121,,,,25.790282,10.302229,-15.488053,0.431241,0.291825,-0.139416,0.064642,1.530505,1.465863,2.555908,3.835992,1.280084,109.658027,54.191973,-55.466054,182.701381,78.99284,-103.708541,55.411085,24.8899,-30.521185,719.981897,1093.768043,373.786146,2.366558,32.22912,29.862562,0.342226,0.307965,-0.034261,3.56136,78.264305,74.702945,284.31106,168.277432,-116.033628,0,44.206021,44.206021,997,538.7,-458.3,0,0,0,0.170031,0.071294,-0.098737,116.975499,106.855501,-10.119998,321.979683,265.569118,-56.410565,,,,1538.824502,1699.177378,160.352876,225.480585,384.786996,159.306411,267.55241,1962.321292,1694.768882,0.222033,31.465141,31.243108,101.922578,252.396495,150.473917,96.124688,98.13576,2.011072,1.447167,88.788872,87.341705,4111.79049,1816.54135,-2295.24914,310.646591,184.587129,-126.059462,7.101085,2.068504,-5.032581,548.756858,89.013885,-459.742973,287.35861,27.889061,-259.469549,9.680618,11.707746,2.027128,2639.096656,1115.106814,-1523.989842,3217.302341,596.441446,-2620.860895,4.796085,2.385338,-2.410747,291.616999,35.201386,-256.415613,2946.314475,1178.579306,-1767.735169,1372.257067,2703.157816,1330.900749,1736.155966,737.466311,-998.689655,0.025717,0.265889,0.240172,1.235092,12.682449,11.447357,1032.794396,690.23068,-342.563716,8.014657,65.700491,57.685834,0.000232,0.145709,0.145477,2.390649,2.696531,0.305882,41129.73444,9886.429029,-31243.305411,1.738491,6.599936,4.861445,0,0.00744,0.00744,6263.178903,4031.059496,-2232.119407,855.660082,3085.426309,2229.766227,4138.32312,1942.436881,-2195.886239,12926.100178,5708.250811,-7217.849367,891.113321,2147.670469,1256.557148,0,0.008556,0.008556,0.125994,0.033659,-0.092335,0.139512,0,-0.139512,0,0.020719,0.020719,6.115984,12.147015,6.031031,472.649222,291.826604,-180.822618,0.152507,0.261706,0.109199,0.248254,0.043141,-0.205113,0.04403,0.007007,-0.037023,0.277793,2.674513,2.39672,0.767749,0.32843,-0.439319,0.108326,2.16671,2.058384,0.000757,0,-0.000757,0.074627,1.063133,0.988506,0.014875,0.138587,0.123712,6.196877,6.963387,0.76651,0.001845,0.02206,0.020215,2.857627,14.529726,11.672099,1.235674,3.307933,2.072259,0.175118,2.687314,2.512196,0.110762,2.414202,2.30344,0.012241,0.434112,0.421871,17.809465,5.614107,-12.195358,0.196423,1.094961,0.898538,154.413556,158.698409,4.284853,153.345983,151.552091,-1.793892,46.981476,34.400041,-12.581435,,,,119.588378,379.395808,259.80743,0.744,19.734539,18.990539,0.000017,0.912764,0.912747,0.020944,0,-0.020944,0.165896,10.819009,10.653113,0.083822,10.98278,10.898958,13.707263,11.037349,-2.669914,7.671399,19.896898,12.225499,0.224258,6.463143,6.238885,9.278319,38.764001,29.485682,0.691913,8.289285,7.597372,130.016656,24.595752,-105.420904,30.144932,96.50801,66.363078,0.002714,4.138305,4.135591,0.099859,2.477434,2.377575,0.875262,3.080939,2.205677,99.647307,286.537809,186.890502,0.038643,0.470915,0.432272,64.461969,15.60908,-48.852889,106.219641,5.07967,-101.139971,0.00059,0.70926,0.70867,0.228074,4.634218,4.406144,0.62672,56.97521,56.34849,220.282608,99.466251,-120.816357,81.911132,63.913615,-17.997517,0.025042,0.153727,0.128685,0.020997,0.614781,0.593784,0.031832,0.372089,0.340257,7.415835,12.595167,5.179332,8.506573,16.772262,8.265689,0.600223,0.982762,0.382539,5.258812,1.65091,-3.607902,0.099176,2.319595,2.220419,8.066734,49.926376,41.859642,0.002006,0.109703,0.107697,2.224517,12.912849,10.688332,21.724182,4.987625,-16.736557,48.856872,33.780945,-15.075927,0.591647,1.15628,0.564633,1.322922,0.020507,-1.302415,14.803921,23.803796,8.999875,31.227464,2.304561,-28.922903,6.506027,13.709329,7.203302,38.681426,6.934801,-31.746625,0.000684,0.602092,0.601408,0.039,0.121024,0.082024,0.19004,0.460235,0.270195,0.000056,0.522066,0.52201,605.604773,473.114165,-132.490608,9.409215,19.358521,9.949306,18.451174,3.995092,-14.456082,3.786543,6.30323,2.516687,0.330295,1.935674,1.605379,6.356027,2.545647,-3.81038,3.62059,12.313281,8.692691,23.109074,0.041001,-23.068073,0,0,0,,,
2015-04-01,5948.496725,5913.491517,-35.0052080000005,37240.546094,23561.719046,-13678.827048,190263.526031046,128970.700537963,-61292.8254930832,14916.820025,0,-14916.820025,12104.068518,8395.663493,-3708.405025,35363.206081,28828.999625,-6534.206456,,,,10119.848237,12761.157182,2641.308945,49454.180382,44478.816267,-4975.364115,42581.742888,27880.425488,-14701.3174,2277.063801,2505.53978,228.475979,69088.255186,31248.991448,-37839.263738,190025.641714,128509.973777,-61515.6679370002,84174.361986,38488.070437,-45686.291549,2045.087972,2413.982416,368.894444,1417.968603,2392.711279,974.742676,1676.979414,1586.833844,-90.1455699999995,0.475817,3.253344,2.777527,24752.082903,24443.781945,-308.300958,0,0,0,24702.097479,20035.034322,-4667.063157,374.184871,478.322172,104.137301,4.934552,21.248551,16.313999,178.651695,281.264778,102.613083,375.14818,414.419304,39.271124,273.559039,103.775905,-169.783134,409.216643,490.796117,81.579474,25.157754,670.308476,645.150722,1.588817,40.543621,38.954804,80.179973,203.641182,123.461209,0,11.891615,11.891615,27.563384,149.343548,121.780164,0.811894,23.924983,23.113089,11.393106,61.759475,50.366369,84.828453,124.233096,39.404643,434.327544,645.40414,211.076596,0.48472,3.484228,2.999508,3.150148,17.217872,14.067724,6.356231,12.93288,6.576649,0.222119,63.415574,63.193455,0.013468,0.430249,0.416781,0.119975,7.383366,7.263391,1.497151,66.950685,65.453534,0.046817,5.673826,5.627009,1.120057,7.081125,5.961068,5.24997,39.216207,33.966237,332.192431,195.794332,-136.398099,,,,4.320168,50.691554,46.371386,50.682369,76.495716,25.813347,1.133797,27.333647,26.19985,0.521815,5.226478,4.704663,2.99925,9.489322,6.490072,1313.53518,1356.638715,43.103535,1568.9268,661.7337,-907.1931,40.200753,25.428423,-14.77233,8.103638,36.768951,28.665313,0.001267,2.629019,2.627752,525.013927,378.719025,-146.294902,383.872952,775.256803,391.383851,115.31881,79.567634,-35.751176,838.964019,1097.521105,258.557086,2333.71092,2977.459548,643.748628,9.02146,117.272997,108.251537,37.369836,82.44833,45.078494,250.332008,859.060033,608.728025,3.820276,0.958875,-2.861401,23.851106,37.853712,14.002606,910.976653,319.660348,-591.316305,0,0,0,338.918469,306.781323,-32.137146,356.848552,158.543735,-198.304817,8.715553,0.13585,-8.579703,619.931662,229.023301,-390.908361,5671.85804,4381.049078,-1290.808962,3347.027826,775.451377,-2571.576449,1370.391746,3946.838403,2576.446657,1690.667906,2969.847666,1279.17976,42.355392,51.485072,9.12968,0.062117,0.245464,0.183347,33.412887,2.580931,-30.831956,4011.994087,2750.985366,-1261.008721,10833.458793,4272.774875,-6560.683918,889.27337,183.70171,-705.57166,,,,381.278811,158.433487,-222.845324,198.703369,26.03197,-172.671399,483.718306,131.503128,-352.215178,23.232228,2.053154,-21.179074,2334.067521,1858.370482,-475.697039,38.167002,17.436161,-20.730841,27.742261,17.698216,-10.044045,71.586433,37.744554,-33.841879,521.004513,319.842083,-201.16243,,,,1562.279408,768.396408,-793.883,12.227369,5.772483,-6.454886,75.834236,53.316763,-22.517473,9.46415,2.599432,-6.864718,0.420265,18.71087,18.290605,22.236913,25.112635,2.875722,131.039911,39.012327,-92.027584,0.056412,2.824837,2.768425,3.446155,1.171484,-2.274671,20.36749,1.083742,-19.283748,0.422734,5.63007,5.207336,1.625431,5.501238,3.875807,1304.132,941.786106,-362.345894,262.89292,80.717543,-182.175377,0.006325,165.216054,165.209729,12.546309,90.38711,77.840801,0.380254,0.070027,-0.310227,0.001175,0.259607,0.258432,3728.515139,1466.063703,-2262.451436,,,,44.302753,49.578774,5.276021,55.239915,28.108354,-27.131561,5.834989,1.321279,-4.51371,26.144611,1.278413,-24.866198,,,,18.478021,13.004721,-5.4733,0.093093,1.110838,1.017745,0.145805,2.89077,2.744965,14.358584,4.084614,-10.27397,116.662286,61.542485,-55.119801,188.187317,65.278929,-122.908388,59.511813,22.640873,-36.87094,674.073582,992.316914,318.243332,1.57092,7.564639,5.993719,0.392091,0.658357,0.266266,7.34733,99.872951,92.525621,166.743493,203.069646,36.326153,0,24.812895,24.812895,938.7,588.6,-350.1,0,0.0114,0.0114,0.243229,0.042699,-0.20053,109.431752,98.793477,-10.638275,531.322618,232.717238,-298.60538,,,,2160.195024,1820.60109,-339.593934,113.489235,359.632173,246.142938,244.724479,1713.018382,1468.293903,0.460642,3.31975,2.859108,84.035724,125.20588,41.170156,59.185935,86.30964,27.123705,2.804596,39.720168,36.915572,4122.646551,1945.594496,-2177.052055,329.646409,191.285707,-138.360702,5.686663,3.691471,-1.995192,496.625326,46.814475,-449.810851,249.096523,20.0384,-229.058123,9.062465,6.566945,-2.49552,2561.884961,980.555399,-1581.329562,3009.16584,523.413925,-2485.751915,3.080464,1.902372,-1.178092,273.703659,34.254986,-239.448673,3056.425766,1011.099757,-2045.326009,1986.871595,2471.687201,484.815606,1821.181064,539.263445,-1281.917619,0.023,0.040419,0.017419,1.79402,6.920476,5.126456,972.74719,695.968865,-276.778325,6.237305,40.036248,33.798943,0.019483,0.321183,0.3017,2.992993,2.838134,-0.154859,36120.498904,9301.700464,-26818.79844,6.887521,8.740755,1.853234,0,0.267176,0.267176,6624.106681,4118.762624,-2505.344057,435.659326,2976.247491,2540.588165,3888.009605,2135.507485,-1752.50212,12782.812872,5591.915569,-7190.897303,937.259295,2041.431936,1104.172641,0.0001,0.003202,0.003102,0.464083,0,-0.464083,0.315993,0.071617,-0.244376,0.000022,0.06599,0.065968,6.643874,12.911931,6.268057,448.007689,305.537956,-142.469733,0.022035,0.327937,0.305902,1.179672,0.001215,-1.178457,0.005068,0.024883,0.019815,0.417419,1.872853,1.455434,0.237825,0.180527,-0.057298,0.235123,0.413414,0.178291,0.000169,0.000146,-0.000023,0.11353,0.082965,-0.030565,0.012465,0.014454,0.001989,2.516931,5.350024,2.833093,0,0,0,2.792861,9.347365,6.554504,1.161154,2.522537,1.361383,0.152243,3.140428,2.988185,0.067004,1.966934,1.89993,0.047513,0,-0.047513,16.215749,5.240477,-10.975272,0.109459,2.078453,1.968994,115.439041,218.111769,102.672728,292.52627,103.750966,-188.775304,49.985324,87.375417,37.390093,,,,122.295696,477.680511,355.384815,0.564,2.973187,2.409187,0.000841,0.368997,0.368156,0,0,0,0.137565,12.448623,12.311058,0.004687,18.702021,18.697334,9.192464,41.434014,32.24155,3.123579,11.167318,8.043739,0.239983,3.966776,3.726793,1.769782,11.320456,9.550674,0.515074,5.927839,5.412765,125.458963,30.404176,-95.054787,59.632084,92.669622,33.037538,0.003805,4.165006,4.161201,0.124478,1.829969,1.705491,1.121993,31.878312,30.756319,173.271444,245.651985,72.380541,0.012546,2.048318,2.035772,15.837639,12.555112,-3.282527,117.622383,2.415573,-115.20681,6.612931,0.479185,-6.133746,0.559445,4.76675,4.207305,0.042767,48.974058,48.931291,165.731103,140.204056,-25.527047,13.973105,17.334137,3.361032,0.000209,0.010705,0.010496,0.098497,0.26099,0.162493,0.014639,0.087312,0.072673,4.751153,14.274045,9.522892,14.029826,6.049381,-7.980445,0.340382,0.247788,-0.092594,2.763401,0.794829,-1.968572,0.136668,2.948548,2.81188,8.506196,21.251793,12.745597,0.000635,0.36931,0.368675,4.344632,15.058467,10.713835,3.712996,5.668351,1.955355,44.585452,89.128073,44.542621,0.778794,1.188547,0.409753,3.994401,0.178168,-3.816233,8.632573,14.724615,6.092042,43.368871,3.040397,-40.328474,6.415963,15.224443,8.80848,39.309855,3.965676,-35.344179,0.002314,0.162708,0.160394,0.077448,0.176735,0.099287,2.678349,0.583723,-2.094626,0.000043,0.360128,0.360085,696.670809,493.849037,-202.821772,18.361952,8.846533,-9.515419,13.50901,3.442284,-10.066726,2.446583,5.928245,3.481662,2.100387,2.117152,0.0167649999999999,3.015503,2.968498,-0.047005,3.308513,4.126134,0.817621,20.221771,0.108854,-20.112917,0,0,0,,,
2015-05-01,5719.961563,5886.426774,166.465211,36262.733851,23382.204787,-12880.529064,187840.194380973,127475.834432689,-60364.3599482841,14327.166144,0,-14327.166144,11786.881331,8443.134456,-3343.746875,34841.292864,27472.892726,-7368.400138,,,,9469.153929,14074.976347,4605.822418,48762.441964,44436.256724,-4326.18524,41441.976579,27409.505191,-14032.471388,2055.472771,2917.532817,862.060046,68259.895464,29997.971296,-38261.924168,186508.5315,128160.664929,-58347.866571,83322.672694,36789.864446,-46532.808248,2045.63477,2567.194942,521.560172,1456.73465,2532.183491,1075.448841,1378.277832,1874.822368,496.544536,0.023988,0.258966,0.234978,24281.083037,24781.857753,500.774716,0.054925,0.086947,0.032022,24481.358927,19654.398971,-4826.959956,345.032553,511.47829,166.445737,13.876388,30.480476,16.604088,206.011052,278.832387,72.821335,397.7129,495.84411,98.13121,260.822213,121.137029,-139.685184,408.695521,530.829441,122.13392,42.291098,703.253778,660.96268,1.566211,45.21012,43.643909,24.907353,193.250093,168.34274,0,26.789074,26.789074,23.269631,177.942391,154.67276,0.572543,20.732437,20.159894,10.788914,45.749847,34.960933,79.915332,121.689302,41.77397,427.360531,629.073685,201.713154,0.446186,3.742587,3.296401,0.531891,15.403348,14.871457,5.243991,10.182967,4.938976,0.332931,49.825694,49.492763,0.212798,0.542152,0.329354,0.045731,6.152425,6.106694,1.492719,31.43927,29.946551,0.208359,10.744316,10.535957,1.095907,7.77637,6.680463,3.650821,69.780813,66.129992,273.878429,213.484931,-60.393498,,,,7.593858,38.786811,31.192953,17.212259,68.274746,51.062487,29.584484,89.742496,60.158012,0.292846,15.051083,14.758237,4.444853,12.500785,8.055932,1434.458698,1600.519888,166.06119,1221.895877,879.704021,-342.191856,47.117621,21.567601,-25.55002,9.793884,50.549534,40.75565,0.001626,259.689802,259.688176,529.074428,567.320448,38.24602,381.415996,743.006315,361.590319,104.502097,79.194988,-25.307109,613.580132,1186.673682,573.09355,2110.418683,2916.711279,806.292596,11.333698,131.569811,120.236113,67.730879,108.969046,41.238167,347.222386,953.492531,606.270145,1.517621,0.284147,-1.233474,31.498483,35.83741,4.338927,829.24304,349.010159,-480.232881,0.021484,0,-0.021484,576.779521,299.019141,-277.76038,368.116608,129.694974,-238.421634,7.565642,0.158075,-7.407567,697.847525,161.674432,-536.173093,5220.11727,5288.52317,68.4059000000007,3194.019227,633.519521,-2560.499706,1470.977736,3319.733561,1848.755825,1866.30715,2990.047728,1123.740578,48.85806,122.652083,73.794023,1.070734,0.10213,-0.968604,1.669749,8.083193,6.413444,3785.852815,2637.349996,-1148.502819,10207.583834,4026.917325,-6180.666509,959.205701,199.01764,-760.188061,,,,373.25456,171.616991,-201.637569,244.075771,29.16703,-214.908741,442.60492,145.693054,-296.911866,22.548804,1.980081,-20.568723,2447.849667,1809.29421,-638.555457,37.328646,28.067119,-9.261527,22.740367,19.304147,-3.43622,92.147896,40.807495,-51.340401,491.489496,304.53589,-186.953606,,,,1180.44566,668.493882,-511.951778,11.097893,5.484274,-5.613619,71.277789,116.117501,44.839712,8.345872,2.923552,-5.42232,1.622076,22.216281,20.594205,28.766088,19.043769,-9.722319,36.357205,36.968539,0.611333999999999,0.416711,4.477667,4.060956,4.191604,2.471363,-1.720241,0.092983,0.393527,0.300544,0.636734,3.780426,3.143692,0.616305,14.402542,13.786237,1236.630367,957.071478,-279.558889,291.120543,73.568536,-217.552007,0.002376,232.03627,232.033894,13.169111,59.260835,46.091724,0.548894,0.062439,-0.486455,0.181564,0.025665,-0.155899,3883.957259,1486.174971,-2397.782288,,,,59.07544,37.858294,-21.217146,57.858266,19.32732,-38.530946,7.632697,1.026728,-6.605969,11.013456,3.857318,-7.156138,,,,20.000461,12.833399,-7.167062,0.561584,8.615396,8.053812,0.284049,2.266771,1.982722,12.453402,3.096707,-9.356695,118.653411,61.021999,-57.631412,188.959424,62.303982,-126.655442,58.553723,19.634097,-38.919626,693.693241,712.232148,18.5389070000001,2.985685,8.65096,5.665275,0.649406,0.227198,-0.422208,11.829558,104.823796,92.994238,462.682342,125.147959,-337.534383,0,13.332879,13.332879,1121.9,548.5,-573.4,0,0,0,0.426566,0.016711,-0.409855,115.680623,160.374695,44.694072,342.363398,203.164964,-139.198434,,,,2036.220638,1615.65102,-420.569618,122.225618,334.831415,212.605797,218.011351,1618.032335,1400.020984,0.084327,19.873158,19.788831,71.767556,265.919071,194.151515,65.699115,97.244485,31.54537,2.373845,29.170536,26.796691,4042.035126,1788.31708,-2253.718046,300.934639,192.155698,-108.778941,4.490848,9.792814,5.301966,453.515276,82.405093,-371.110183,212.86632,30.120431,-182.745889,9.768141,10.872379,1.104238,2351.393198,929.074149,-1422.319049,3105.406145,508.947908,-2596.458237,2.574733,2.001374,-0.573359,221.920709,32.794461,-189.126248,2910.456516,1039.350858,-1871.105658,1373.453443,2440.877308,1067.423865,1583.150518,571.388263,-1011.762255,0,0.434606,0.434606,1.199767,9.694946,8.495179,861.661578,641.061466,-220.600112,4.787297,37.875136,33.087839,0.01697,0.120129,0.103159,1.37103,4.382048,3.011018,39072.129476,8747.20856,-30324.920916,0.742599,7.957115,7.214516,0,2.450424,2.450424,6413.115255,3698.437687,-2714.677568,602.753599,2562.999553,1960.245954,3350.233321,2335.349735,-1014.883586,10657.896217,5420.357885,-5237.538332,1006.154336,2215.061876,1208.90754,0.000103,0.23721,0.237107,0.008507,0.296642,0.288135,0.218077,0.013922,-0.204155,0,0.015816,0.015816,6.090465,15.819642,9.729177,416.813676,262.488381,-154.325295,0.046687,0.602683,0.555996,0.059184,0.009753,-0.049431,0.015341,0,-0.015341,0.245197,1.847306,1.602109,0.053132,0.644367,0.591235,0.244321,0.571832,0.327511,0,0,0,0.164973,0.085497,-0.079476,0.083447,0.082372,-0.00107499999999999,6.698071,5.856447,-0.841623999999999,0.005633,0.039337,0.033704,4.2303,10.968894,6.738594,0.815835,4.451287,3.635452,0.073077,3.815351,3.742274,0.052109,1.214993,1.162884,0.161981,0,-0.161981,14.370874,6.12248,-8.248394,0.192642,1.735622,1.54298,59.660873,153.717046,94.056173,432.227096,141.02769,-291.199406,45.067477,65.244642,20.177165,,,,112.754399,648.540219,535.78582,0.4199,2.483276,2.063376,0.136403,1.438201,1.301798,0,0,0,13.349295,10.542053,-2.807242,0.116684,6.643401,6.526717,6.913922,23.013705,16.099783,2.934166,12.922323,9.988157,0.10056,7.220302,7.119742,6.444782,9.681968,3.237186,9.345579,5.085118,-4.260461,89.341553,23.999782,-65.341771,40.451733,64.629444,24.177711,0.063102,2.878088,2.814986,1.704781,16.97537,15.270589,0.960056,61.653858,60.693802,137.039461,232.732769,95.693308,0.060661,4.508705,4.448044,13.587517,28.97711,15.389593,43.364907,10.440812,-32.924095,1.359525,0.142934,-1.216591,0.126905,4.680303,4.553398,0.030124,55.542431,55.512307,194.300059,123.133611,-71.166448,2.13187,16.539334,14.407464,0.013246,0.403294,0.390048,0.1446,0.830566,0.685966,0.148126,0.019993,-0.128133,5.382121,8.251846,2.869725,18.783042,16.89682,-1.886222,1.531575,0.063732,-1.467843,1.725785,0.56424,-1.161545,0.002259,3.02072,3.018461,10.606402,27.627525,17.021123,0.00845,0.427736,0.419286,7.638505,16.359088,8.720583,5.827832,5.45597,-0.371862,45.978732,165.193475,119.214743,0.846838,5.553466,4.706628,1.054194,0,-1.054194,11.967346,16.362058,4.394712,23.143734,2.081123,-21.062611,5.841935,45.548532,39.706597,34.890242,3.853279,-31.036963,0.000661,0,-0.000661,0.63296,0.138336,-0.494624,1.149239,0.21235,-0.936889,0.000841,0.626156,0.625315,564.843203,441.832572,-123.010631,2.014828,10.558023,8.543195,22.980194,3.762408,-19.217786,4.602319,4.227508,-0.374810999999999,0.328584,1.498654,1.17007,9.122503,3.155201,-5.967302,3.802562,3.700608,-0.101954,20.481079,0.06273,-20.418349,0,0,0,,,
2015-06-01,5978.917384,6387.11064,408.193256,37550.657142,22969.102673,-14581.554469,190021.410574,126790.175133771,-63231.2354402285,15967.958492,0,-15967.958492,13012.43306,8828.001884,-4184.431176,38592.010902,29864.049266,-8727.961636,,,,10300.864589,13478.315441,3177.450852,54260.165607,45291.672496,-8968.493111,43497.540344,26996.514109,-16501.026235,2128.290015,2469.642468,341.352453,70780.775997,31889.744794,-38891.031203,197324.43,130949.390816,-66375.0391840002,85757.564722,40326.468861,-45431.095861,2042.678027,2347.906662,305.228635,1379.416923,2385.936594,1006.519671,1531.191704,1673.657493,142.465789,0.571215,0.837881,0.266666,27342.186102,24798.342487,-2543.843615,0.016585,0.002966,-0.013619,26917.979505,20493.330009,-6424.649496,349.934954,465.018822,115.083868,4.130794,21.327798,17.197004,219.733,227.472606,7.73960600000001,418.132312,434.725376,16.593064,276.837032,113.835228,-163.001804,363.181251,504.179663,140.998412,38.125476,695.738451,657.612975,6.953489,34.925201,27.971712,66.022024,155.522992,89.500968,0,10.495089,10.495089,42.666449,147.700706,105.034257,0.972106,23.17851,22.206404,9.205945,52.150481,42.944536,90.479761,89.203516,-1.276245,414.859478,602.674967,187.815489,0.542736,3.494243,2.951507,0.328087,14.401538,14.073451,3.922149,9.12925,5.207101,2.884377,59.971972,57.087595,0.092494,0.396113,0.303619,0.21026,5.754759,5.544499,1.420113,70.262147,68.842034,0.2969,7.601889,7.304989,1.174268,6.80875,5.634482,4.242074,46.532964,42.29089,344.289837,184.179338,-160.110499,,,,2.141641,41.698693,39.557052,43.857532,28.306023,-15.551509,1.141739,239.885156,238.743417,0.463032,8.032082,7.56905,3.674055,16.129199,12.455144,1330.094269,1318.804884,-11.289385,1463.097897,867.135226,-595.962671,33.226138,28.9303,-4.295838,14.348345,43.088644,28.740299,0.007798,1.697828,1.69003,682.617087,576.500478,-106.116609,363.780556,785.107192,421.326636,79.973723,117.531195,37.557472,652.63118,1454.470196,801.839016,2538.170268,2971.244969,433.074701,11.593969,132.719313,121.125344,60.680089,106.686269,46.00618,358.70424,753.541026,394.836786,0.023665,0.124399,0.100734,23.689366,18.806915,-4.882451,866.592233,337.917403,-528.67483,0.000437,0,-0.000437,499.315786,256.306127,-243.009659,399.606416,114.868463,-284.737953,7.752273,0.070168,-7.682105,591.941907,196.416547,-395.52536,5512.935269,5303.486192,-209.449076999999,3164.830916,798.501578,-2366.329338,1389.980569,3016.274876,1626.294307,1978.21567,2904.463208,926.247538,68.532974,149.637588,81.104614,0.234911,0.165087,-0.069824,1.34301,8.872904,7.529894,4281.485088,2587.815086,-1693.670002,10554.956713,4065.315412,-6489.641301,935.476073,274.426994,-661.049079,,,,402.61745,165.932637,-236.684813,287.468015,35.545688,-251.922327,471.91529,127.84957,-344.06572,31.543943,1.800632,-29.743311,2640.307878,2044.878113,-595.429765,44.393968,22.373234,-22.020734,25.16127,31.613736,6.452466,56.319709,30.971013,-25.348696,487.514275,283.51046,-204.003815,,,,1831.782336,574.785018,-1256.997318,12.332975,4.261526,-8.071449,72.649427,51.790532,-20.858895,6.940929,2.612138,-4.328791,64.003342,17.362179,-46.641163,1.787807,31.43959,29.651783,88.698204,36.149229,-52.548975,0.103226,4.118502,4.015276,5.069597,1.285435,-3.784162,0.248385,1.780428,1.532043,9.080611,4.143793,-4.936818,0.438982,5.840893,5.401911,1302.059248,815.30011,-486.759138,288.953992,55.763343,-233.190649,0.059882,181.175226,181.115344,86.138992,8.776516,-77.362476,1.232745,0.118724,-1.114021,0.011823,0.251819,0.239996,3848.429708,1381.46344,-2466.966268,,,,58.868079,26.124276,-32.743803,66.720896,46.170884,-20.550012,8.261877,1.942466,-6.319411,14.813899,1.663561,-13.150338,,,,21.194668,9.739275,-11.455393,0.006976,0.967474,0.960498,0.223669,0.766118,0.542449,17.515847,3.221386,-14.294461,140.561532,107.319651,-33.241881,185.989094,47.996602,-137.992492,50.852367,24.222167,-26.6302,586.238391,761.096178,174.857787,2.139429,9.045999,6.90657,0.978209,0.0389,-0.939309,7.28972,150.177378,142.887658,258.269075,191.795141,-66.473934,0,28.312421,28.312421,932.5,742.7,-189.8,0,0.07555,0.07555,0.436903,0.229188,-0.207715,110.212742,133.682413,23.469671,569.111361,269.047187,-300.064174,,,,2100.342013,1602.821628,-497.520385,104.231508,212.848799,108.617291,177.061989,2023.534695,1846.472706,0.1782,0.905693,0.727493,55.13349,221.912785,166.779295,61.196786,97.239756,36.04297,1.335968,37.764776,36.428808,3788.742514,2315.151743,-1473.590771,325.148172,119.232045,-205.916127,6.403276,5.113691,-1.289585,513.876886,39.012975,-474.863911,218.145476,28.139843,-190.005633,10.79874,50.188167,39.389427,2480.694047,1037.145854,-1443.548193,3412.298777,486.199144,-2926.099633,2.480421,1.225612,-1.254809,245.083279,31.954909,-213.12837,2743.98687,1161.237239,-1582.749631,1566.417059,2464.172169,897.75511,1825.07695,627.907917,-1197.169033,0.00506,0.07749,0.07243,0.990013,7.113507,6.123494,870.781573,748.499778,-122.281795,10.696632,51.94536,41.248728,0.160886,0.277725,0.116839,1.789882,2.765303,0.975421,41451.861195,9617.716392,-31834.144803,0.365251,7.713742,7.348491,0,0.063899,0.063899,6218.519694,3734.349381,-2484.170313,682.257761,3216.104086,2533.846325,3534.598082,2689.025359,-845.572723,10522.251383,5221.11042,-5301.140963,918.678925,2062.697287,1144.018362,0.05,0,-0.05,0.115355,0.112565,-0.00279,0.248724,0.074232,-0.174492,0.001704,0.015849,0.014145,4.738836,13.7865,9.047664,429.921024,274.079399,-155.841625,0.009912,0.358803,0.348891,0.031347,0.053125,0.021778,0.044392,0.023765,-0.020627,0.196871,1.479709,1.282838,0.077981,0.524324,0.446343,0.128284,0.319324,0.19104,0.003593,0,-0.003593,0.293809,1.214992,0.921183,0.007058,0.066234,0.059176,3.103908,6.713442,3.609534,0.000039,0.020667,0.020628,4.623626,9.76661,5.142984,1.305246,3.713199,2.407953,0.049805,3.421865,3.37206,0.060946,1.728062,1.667116,0.066418,0.105443,0.039025,15.353713,4.284573,-11.06914,0.133716,1.36042,1.226704,60.734935,86.151085,25.41615,327.85509,169.30209,-158.553,80.799651,18.651641,-62.14801,,,,123.428792,493.849426,370.420634,1.225996,7.149321,5.923325,0.014108,2.771542,2.757434,0.000045,0,-0.000045,14.287387,10.002765,-4.284622,0.142052,6.069139,5.927087,6.762124,13.27483,6.512706,4.737861,13.42971,8.691849,0.154565,3.113201,2.958636,6.962117,7.03433,0.0722129999999996,1.95592,5.218829,3.262909,103.024117,15.900297,-87.12382,31.692734,87.31718,55.624446,0.173318,2.70275,2.529432,0.495906,2.042655,1.546749,0.95341,73.425061,72.471651,82.402485,316.425265,234.02278,0.00859,12.439283,12.430693,2.183442,13.331234,11.147792,114.596916,7.972843,-106.624073,1.639713,1.058511,-0.581202,0.237646,7.189836,6.95219,0.739431,58.762203,58.022772,213.917401,104.178139,-109.739262,65.542708,27.54858,-37.994128,0.000376,0.137126,0.13675,0.012746,0.896434,0.883688,0.079049,0.119504,0.040455,3.909216,12.599741,8.690525,21.89114,21.119313,-0.771827000000002,1.239515,0.164169,-1.075346,0.411005,1.351851,0.940846,0.107425,3.393219,3.285794,9.142056,13.654234,4.512178,0.003136,0.112423,0.109287,0.48794,19.992021,19.504081,2.566446,7.375851,4.809405,36.944965,31.991216,-4.953749,0.349324,0.725247,0.375923,1.209648,0,-1.209648,7.129636,11.67096,4.541324,38.132309,3.330813,-34.801496,10.428221,14.711202,4.282981,31.916788,2.226084,-29.690704,0.000414,0.024754,0.02434,0.00584,0.046795,0.040955,1.41879,0.974896,-0.443894,0.000022,0.303755,0.303733,586.107572,490.49315,-95.614422,4.159909,9.228232,5.068323,30.3445,3.081731,-27.262769,4.822258,5.964434,1.142176,0.399343,3.081256,2.681913,8.438316,1.880458,-6.557858,5.190661,2.131263,-3.059398,22.67009,0.043493,-22.626597,0,0,0,,,
2015-07-01,6541.42459,6391.639781,-149.784809000002,37096.767828,21585.782972,-15510.984856,187417.666629595,126836.844875878,-60580.8217537169,14407.941102,0,-14407.941102,11078.285602,7516.921799,-3561.363803,35340.003533,27966.092042,-7373.911491,,,,10602.577891,12429.805061,1827.22717,49490.137073,43999.993569,-5490.143504,43026.450355,25627.886612,-17398.563743,2447.363488,2222.532172,-224.831316,70922.688262,30444.690288,-40477.997974,193578.739781,124200.916855,-69377.8229260001,86709.398931,36904.362749,-49805.036182,2182.519131,2363.119827,180.600696,1302.629809,3016.169242,1713.539433,1857.774583,1478.256951,-379.517632,0.14224,0.16745,0.02521,24705.92129,22869.90267,-1836.01862,0.039994,0,-0.039994,24784.215783,21130.090899,-3654.124884,361.267547,476.645147,115.3776,3.919034,20.407452,16.488418,272.34239,277.937209,5.59481899999997,438.926456,434.435883,-4.49057299999998,292.617835,99.443035,-193.1748,394.940997,506.017235,111.076238,32.487369,562.489946,530.002577,2.036369,36.196892,34.160523,22.074762,204.786023,182.711261,0,5.437893,5.437893,26.453736,159.980032,133.526296,0.448595,25.81779,25.369195,10.020808,57.755151,47.734343,90.449862,104.627957,14.178095,422.423906,568.641318,146.217412,0.400761,3.74097,3.340209,0.331924,15.674573,15.342649,3.73877,13.014333,9.275563,0.794708,58.233759,57.439051,0.076781,0.49946,0.422679,0.214266,6.417303,6.203037,1.551468,41.62247,40.071002,0.254182,7.609325,7.355143,0.679471,7.293397,6.613926,17.219391,51.521742,34.302351,385.669792,210.322953,-175.346839,,,,2.741406,39.766367,37.024961,29.293175,42.121509,12.828334,1.891218,87.554518,85.6633,0.140614,10.24469,10.104076,5.307502,5.03962,-0.267882,1391.990614,1439.383483,47.392869,1485.082588,806.231386,-678.851202,35.349317,21.84206,-13.507257,12.002436,35.903561,23.901125,0,118.252387,118.252387,703.635629,524.295306,-179.340323,401.526294,748.612354,347.08606,61.461694,58.43169,-3.030004,819.568848,1086.118536,266.549688,2412.670321,2408.067078,-4.60324300000002,11.653183,113.664518,102.011335,53.241947,104.078209,50.836262,393.679231,823.624627,429.945396,0.000694,0.003914,0.00322,22.808072,97.45202,74.643948,855.272955,293.743129,-561.529826,0.000496,0.06671,0.066214,419.652146,215.074617,-204.577529,450.660212,166.067244,-284.592968,9.088844,0.237522,-8.851322,568.108075,176.367942,-391.740133,4662.676615,4556.723266,-105.953349,3016.122405,696.987297,-2319.135108,1336.396469,2996.866734,1660.470265,2043.434512,2720.586102,677.15159,35.777881,93.867973,58.090092,0.095804,0.095778,-0.0000259999999999982,1.93907,17.129942,15.190872,4277.365385,2615.438389,-1661.926996,10693.63406,4069.977298,-6623.656762,978.893708,163.536433,-815.357275,,,,388.245682,142.555077,-245.690605,321.529831,23.929986,-297.599845,479.243685,142.139997,-337.103688,26.274379,2.163837,-24.110542,2829.783359,2162.602159,-667.1812,47.716912,20.04865,-27.668262,28.831112,26.339687,-2.491425,124.581133,31.683813,-92.89732,480.536216,308.773614,-171.762602,,,,1477.586085,409.489446,-1068.096639,9.872713,9.829342,-0.0433709999999987,69.423033,62.711762,-6.711271,4.48911,4.683081,0.193970999999999,120.800264,27.186134,-93.61413,29.245501,20.333744,-8.911757,76.463001,48.318815,-28.144186,13.612775,2.368183,-11.244592,4.804768,1.038033,-3.766735,0.132985,1.762723,1.629738,0.758434,4.518674,3.76024,0.554584,3.591175,3.036591,1356.654688,814.338381,-542.316307,332.065271,72.146962,-259.918309,1.52462,298.926379,297.401759,16.166415,51.643035,35.47662,1.30821,0.124126,-1.184084,0.022077,0,-0.022077,4086.571853,1229.369265,-2857.202588,,,,48.6301,28.785984,-19.844116,65.416276,14.677541,-50.738735,7.423746,1.627621,-5.796125,17.284107,3.882666,-13.401441,,,,24.526546,7.539657,-16.986889,0.123845,1.205137,1.081292,0.127538,0.737937,0.610399,20.781212,2.078808,-18.702404,154.204745,40.483297,-113.721448,197.198721,54.375741,-142.82298,47.81679,28.954158,-18.862632,739.175203,635.327612,-103.847591,3.016121,5.375977,2.359856,0.561935,0.594019,0.032084,6.105834,123.609201,117.503367,315.644243,180.117888,-135.526355,0,16.845162,16.845162,1171,513.7,-657.3,0.011958,0.0197,0.007742,0.211856,0.01449,-0.197366,163.699961,89.515813,-74.184148,397.512757,196.654225,-200.858532,,,,2460.178687,1612.087681,-848.091006,66.795207,358.720319,291.925112,221.40287,2088.869261,1867.466391,0.000055,13.028795,13.02874,72.896056,116.228891,43.332835,86.704374,114.70155,27.997176,0.597439,26.732565,26.135126,4102.422033,1872.198347,-2230.223686,342.11777,93.357196,-248.760574,6.466007,4.989531,-1.476476,556.390251,67.709465,-488.680786,251.931378,32.952438,-218.97894,12.297743,7.094331,-5.203412,2321.074163,815.932551,-1505.141612,3325.147498,468.550122,-2856.597376,3.489797,3.298093,-0.191704,275.375501,36.964126,-238.411375,2915.122123,1094.496208,-1820.625915,1677.135257,2194.992973,517.857716,1763.868771,419.792972,-1344.075799,0.008484,0.108324,0.09984,0.797244,6.755625,5.958381,832.498269,584.388482,-248.109787,24.438222,49.799228,25.361006,0.103529,0.086457,-0.017072,0.540528,2.12158,1.581052,41211.609331,9488.434994,-31723.174337,0.661022,5.989708,5.328686,0,0.453885,0.453885,6321.826857,3682.172292,-2639.654565,573.979965,2568.221471,1994.241506,3364.380193,2108.117156,-1256.263037,10967.104245,5267.815704,-5699.288541,917.05851,2574.259991,1657.201481,0.012112,0,-0.012112,1.264711,0.079104,-1.185607,0.152036,0.0043,-0.147736,0.00024,0,-0.00024,7.904705,9.854913,1.950208,344.96457,395.588279,50.623709,0.151759,0.407913,0.256154,0.058571,0.001369,-0.057202,0.138639,0.008703,-0.129936,0.523323,1.084444,0.561121,0.180071,1.884161,1.70409,0.458305,0.333711,-0.124594,0.000181,0,-0.000181,0.105274,0.067094,-0.03818,0,0,0,5.17806,8.038769,2.860709,0.000765,0.019949,0.019184,9.195123,9.664871,0.469747999999999,0.641906,3.61501,2.973104,0.017111,4.623234,4.606123,0.06,1.450841,1.390841,0.030262,0.610382,0.58012,14.328192,4.138315,-10.189877,0.185127,0.366822,0.181695,51.315948,120.772257,69.456309,345.691338,212.357883,-133.333455,45.89327,31.996064,-13.897206,,,,136.402537,355.28323,218.880693,2.835155,5.95281,3.117655,0.017813,1.493349,1.475536,0,0,0,5.237939,25.384636,20.146697,0.270775,11.531744,11.260969,5.123716,10.753986,5.63027,22.70723,16.161204,-6.546026,0.207348,5.350327,5.142979,8.733204,37.584962,28.851758,0.735051,9.08554,8.350489,70.883533,22.463929,-48.419604,18.975801,162.234173,143.258372,0.100648,2.114771,2.014123,0.039652,5.139229,5.099577,1.526731,56.101146,54.574415,278.914941,269.185667,-9.72927399999998,0.35428,4.305038,3.950758,58.016519,14.010194,-44.006325,160.435419,1.103814,-159.331605,0.524133,0.110892,-0.413241,0.937321,3.354941,2.41762,0.757912,57.935503,57.177591,260.62215,104.233966,-156.388184,21.920412,12.843972,-9.07644,0.003528,0.329691,0.326163,0.238581,0.570769,0.332188,0.097795,0.06906,-0.028735,4.507739,10.873326,6.365587,14.668885,8.175465,-6.49342,0.125687,0.04269,-0.082997,0.885143,0.928637,0.043494,0.017095,18.497469,18.480374,13.501344,28.869399,15.368055,0.000555,0.821584,0.821029,0.394608,10.176751,9.782143,3.441905,6.664727,3.222822,59.874592,33.977888,-25.896704,0.487865,1.554259,1.066394,2.219819,0.000166,-2.219653,10.868152,13.756285,2.888133,33.726,2.728926,-30.997074,3.977088,12.688984,8.711896,22.811002,3.37798,-19.433022,0.002004,0.031047,0.029043,0.003077,0.114315,0.111238,1.586522,0.985476,-0.601046,0.0072,0.42513,0.41793,679.432488,430.584455,-248.848033,2.568781,8.575592,6.006811,13.654102,2.845156,-10.808946,0.689932,6.908273,6.218341,0.659021,1.244647,0.585626,4.570455,4.869719,0.299264,4.202816,1.707919,-2.494897,48.877152,0.034737,-48.842415,0,0.040109,0.040109,,,
2015-08-01,4868.037592,5664.280268,796.242676,34848.565864,21088.142596,-13760.423268,187780.910597833,123595.262908976,-64185.6476888577,14557.308848,0,-14557.308848,11905.223773,7929.51395,-3975.709823,35363.659223,28206.61714,-7157.042083,,,,9505.24153,13075.603939,3570.362409,49508.463064,42596.538678,-6911.924386,40302.572233,24880.623081,-15421.949152,2011.677956,2128.369115,116.691159,73069.196839,30470.971179,-42598.22566,189931.965412,122722.092898,-67209.8725139999,87192.870564,37391.923348,-49800.947216,1998.378403,2512.651497,514.273094,1410.983615,2648.888302,1237.904687,1474.800361,1504.320302,29.519941,0.15645,0.146435,-0.010015,24814.513952,23023.886585,-1790.627367,0,0,0,24693.949112,19572.652093,-5121.297019,356.554418,517.397079,160.842661,7.581616,22.323303,14.741687,198.620504,342.335492,143.714988,434.929517,451.583206,16.653689,278.378886,100.553346,-177.82554,328.656856,523.171507,194.514651,43.218342,530.541252,487.32291,14.145514,32.360062,18.214548,19.430216,203.500003,184.069787,0,3.059338,3.059338,21.07973,118.900176,97.820446,6.808463,19.99479,13.186327,5.970997,49.77506,43.804063,86.467542,79.085464,-7.38207799999999,401.238222,577.610867,176.372645,0.873498,4.259663,3.386165,0.938465,12.829625,11.89116,3.965143,8.031095,4.065952,0.641111,42.058359,41.417248,0.036966,0.364707,0.327741,0.116197,6.347372,6.231175,1.292425,32.050845,30.75842,0.092752,7.450237,7.357485,0.521877,10.178444,9.656567,4.353404,50.892989,46.539585,342.266349,177.302993,-164.963356,,,,1.182549,39.292341,38.109792,23.270848,26.231239,2.960391,1.417214,107.352525,105.935311,0.061558,4.536228,4.47467,0.375525,7.007922,6.632397,1039.434482,1255.434872,216.00039,1206.2725,793.658132,-412.614368,35.728414,23.44085,-12.287564,11.781572,32.321528,20.539956,0.00025,281.323446,281.323196,646.130494,499.689619,-146.440875,413.770535,643.763238,229.992703,75.101739,62.698615,-12.403124,571.716061,1741.083901,1169.36784,2595.807696,2516.814738,-78.9929579999998,13.200252,136.074554,122.874302,54.697712,94.209921,39.512209,254.520014,886.154602,631.634588,2.593105,0.558394,-2.034711,24.746594,19.668412,-5.078182,625.933203,309.190306,-316.742897,0,0.015684,0.015684,436.786511,304.935844,-131.850667,387.431765,106.50996,-280.921805,7.996417,0.036875,-7.959542,533.796573,163.290518,-370.506055,4554.186511,4428.838303,-125.348207999999,3157.754106,678.702066,-2479.05204,1286.502262,3121.067214,1834.564952,1345.408458,2772.581636,1427.173178,50.311809,64.822658,14.510849,0.138586,0.100264,-0.038322,1.983109,1.59361,-0.389499,3880.071115,2330.689448,-1549.381667,10918.772516,3923.816161,-6994.956355,994.17107,192.964944,-801.206126,,,,357.056007,157.907915,-199.148092,155.702609,28.305798,-127.396811,440.437482,134.562967,-305.874515,26.687857,2.019341,-24.668516,2306.980874,1645.362885,-661.617989,28.232032,38.70966,10.477628,23.67101,20.992891,-2.678119,91.639482,34.418092,-57.22139,491.984155,273.11485,-218.869305,,,,1650.235433,494.176365,-1156.059068,6.818195,5.275558,-1.542637,56.181731,65.290034,9.10830300000001,3.155507,5.589141,2.433634,57.844968,228.806352,170.961384,19.838304,25.057328,5.219024,73.622513,38.317302,-35.305211,0.046397,1.206476,1.160079,3.376632,1.097474,-2.279158,0.021707,0.530187,0.50848,38.074037,11.906259,-26.167778,0.513786,10.890422,10.376636,1105.087675,783.062774,-322.024901,337.643868,70.165502,-267.478366,0.037062,257.940102,257.90304,13.924492,45.506092,31.5816,0.824688,0.373646,-0.451042,0.302318,0,-0.302318,3595.666485,1267.26258,-2328.403905,,,,53.684824,9.143157,-44.541667,57.373782,14.314936,-43.058846,7.748033,12.221519,4.473486,9.791248,1.796957,-7.994291,,,,22.005304,10.733857,-11.271447,0.000168,1.139007,1.138839,0.066675,0.265418,0.198743,26.709464,2.241252,-24.468212,106.929733,38.689495,-68.240238,203.09513,49.053353,-154.041777,49.967215,26.178794,-23.788421,671.472251,643.892914,-27.579337,2.130495,4.280526,2.150031,0.384844,0,-0.384844,5.435726,90.791304,85.355578,119.172365,162.82594,43.653575,0,13.175771,13.175771,972.8,611.7,-361.1,0,0,0,0.178936,0.05956,-0.119376,148.159698,113.827495,-34.332203,242.627562,229.711977,-12.915585,,,,1700.719103,1629.235602,-71.4835009999999,79.007056,157.091773,78.084717,183.181516,1611.259503,1428.077987,0.244858,11.386519,11.141661,62.48917,143.786186,81.297016,75.676129,82.724008,7.04787899999999,0.972349,29.578361,28.606012,3805.245861,1875.056365,-1930.189496,291.062609,185.048412,-106.014197,9.401922,1.965419,-7.436503,531.880639,77.246512,-454.634127,261.854183,47.117223,-214.73696,16.803317,6.30348,-10.499837,2357.344795,955.469964,-1401.874831,3620.132789,869.393603,-2750.739186,3.936451,0.922161,-3.01429,303.472047,32.404109,-271.067938,2958.934688,1017.053366,-1941.881322,1533.028394,2479.249857,946.221463,1514.926509,619.044604,-895.881905,0.015269,0.02437,0.009101,1.081557,9.506205,8.424648,860.560415,685.320104,-175.240311,13.09257,39.787904,26.695334,0.280282,0.231707,-0.048575,1.542319,2.366546,0.824227,44137.531618,9167.606406,-34969.925212,1.407048,4.08124,2.674192,0,0.956092,0.956092,6186.502293,3712.584667,-2473.917626,497.058017,2656.740282,2159.682265,3434.84123,2038.89732,-1395.94391,10548.525468,5433.92827,-5114.597198,990.994507,2143.228193,1152.233686,0.007987,0.003111,-0.004876,0.089354,0.004869,-0.084485,0.055631,0.437196,0.381565,0,0,0,6.111488,20.595177,14.483689,386.008085,447.428824,61.420739,0.071038,0.173108,0.10207,0.059183,0.054871,-0.004312,0.057072,0.000518,-0.056554,0.693582,1.622604,0.929022,0.409954,0.624399,0.214445,0.310355,0.379406,0.069051,0,0.046398,0.046398,0.237676,0.174097,-0.063579,0,0,0,5.036339,10.601825,5.565486,0.030678,0.003913,-0.026765,3.063957,9.49711,6.433153,0.627268,3.751102,3.123834,0.081164,3.145176,3.064012,0.020177,1.397578,1.377401,0.016979,0,-0.016979,16.884771,5.335079,-11.549692,0.143696,0.354121,0.210425,72.725017,99.810034,27.085017,314.235723,101.042278,-213.193445,26.058287,45.38773,19.329443,,,,114.932797,352.116301,237.183504,1.380515,1.102492,-0.278023,0,3.993779,3.993779,0,0,0,6.816156,23.533785,16.717629,0.127949,20.320046,20.192097,7.405301,36.464464,29.059163,7.773474,28.870859,21.097385,0.892365,5.061874,4.169509,8.207136,3.830267,-4.376869,0.620051,5.012419,4.392368,28.517928,17.770455,-10.747473,19.395875,66.345043,46.949168,0.048499,3.953437,3.904938,0.27491,19.146902,18.871992,0.600235,33.319919,32.719684,205.914282,345.558247,139.643965,0.085679,7.372323,7.286644,28.483514,10.342528,-18.140986,82.982057,4.174453,-78.807604,2.189882,0.33456,-1.855322,0.082766,3.753778,3.671012,0.653784,52.634687,51.980903,165.860042,96.502659,-69.357383,37.577165,14.81373,-22.763435,0.000417,0.068765,0.068348,0.088631,0.491533,0.402902,0.052864,0,-0.052864,1.927317,7.788678,5.861361,15.307805,7.380902,-7.926903,0.212841,0.112448,-0.100393,1.846866,1.438299,-0.408567,0.092413,1.78566,1.693247,13.770523,33.3702,19.599677,0.00177,0.571347,0.569577,0.781505,13.871586,13.090081,3.162485,11.733084,8.570599,61.752804,24.612356,-37.140448,0.18839,0.801687,0.613297,0.337139,0.000262,-0.336877,3.746024,16.931785,13.185761,27.602809,17.817088,-9.785721,9.770871,27.671368,17.900497,22.961907,12.546062,-10.415845,0.000004,0.0388,0.038796,0.000163,0.143618,0.143455,1.429982,0.313813,-1.116169,0.000011,0.14238,0.142369,628.61363,483.746633,-144.866997,3.510256,15.509318,11.999062,15.048808,3.213461,-11.835347,0.864907,6.519509,5.654602,0.835407,1.790161,0.954754,4.770251,4.209551,-0.5607,2.673846,3.556755,0.882909,31.232661,0.068161,-31.1645,0,0,0,,,
2015-09-01,5402.301451,6806.105429,1403.803978,34655.534561,22772.201647,-11883.332914,186049.156450167,124500.643595177,-61548.5128549901,14977.500397,0,-14977.500397,11362.145075,7668.581342,-3693.563733,40356.760113,29402.372061,-10954.388052,,,,9195.565594,12263.76837,3068.202776,50618.435141,42555.213127,-8063.22201400001,39422.863464,26576.909672,-12845.953792,2404.923403,2229.363249,-175.560154,74057.726716,31170.95973,-42886.766986,191470.21354,124852.586071,-66617.6274689999,88507.888367,38813.802273,-49694.086094,2004.316625,2294.167673,289.851048,1319.831517,2413.400596,1093.569079,1736.371675,1478.495427,-257.876248,0.684478,0.058877,-0.625601,25286.683589,23032.586248,-2254.097341,0.021576,0.069907,0.048331,25331.751552,19522.626879,-5809.124673,336.440809,487.98562,151.544811,5.027252,20.527498,15.500246,246.34905,276.868906,30.519856,405.884802,385.580571,-20.304231,278.256334,114.85222,-163.404114,348.492264,476.038709,127.546445,29.049962,578.938117,549.888155,1.163608,37.768259,36.604651,39.336316,193.685209,154.348893,0,23.024798,23.024798,26.381376,132.816981,106.435605,0.9459,21.867762,20.921862,9.122454,54.496374,45.37392,84.533562,101.528766,16.995204,388.893366,552.841647,163.948281,0.716845,3.743994,3.027149,0.771452,13.440819,12.669367,3.566486,11.44128,7.874794,0.424553,23.906935,23.482382,0.065449,0.421907,0.356458,0.060842,4.525146,4.464304,1.60016,33.727345,32.127185,0.04816,6.174182,6.126022,0.784605,5.428786,4.644181,4.27753,57.890926,53.613396,362.485169,324.334768,-38.150401,,,,2.416075,31.541236,29.125161,24.361575,26.063493,1.701918,2.789057,122.488078,119.699021,0.394396,3.858268,3.463872,1.059563,6.932136,5.872573,983.712817,1283.63513,299.922313,1169.677048,582.952416,-586.724632,22.917125,26.085166,3.168041,10.269436,44.008149,33.738713,0,2.120027,2.120027,601.656762,522.1899,-79.466862,437.339075,698.314058,260.974983,71.775277,78.726531,6.95125399999999,632.594167,1352.521197,719.92703,2272.895293,2569.838568,296.943275,14.659776,112.179182,97.519406,46.754833,109.827774,63.072941,325.590275,746.413509,420.823234,0.024738,0.216027,0.191289,24.83733,16.097833,-8.739497,767.930627,315.733517,-452.19711,0,0.091423,0.091423,343.736858,337.280058,-6.45679999999999,323.421358,190.341225,-133.080133,9.393139,0.159211,-9.233928,723.893572,200.141169,-523.752403,5848.347248,4698.303765,-1150.043483,3223.385779,795.306229,-2428.07955,1394.830254,3222.884857,1828.054603,1615.544387,2964.988174,1349.443787,58.722825,274.188917,215.466092,1.266326,0.288686,-0.97764,1.112283,2.552577,1.440294,3488.929122,2292.039577,-1196.889545,9814.269591,4248.243438,-5566.026153,855.685723,211.210763,-644.47496,,,,385.420312,182.540855,-202.879457,110.226883,41.934834,-68.292049,485.917342,150.013431,-335.903911,25.711196,1.384363,-24.326833,2391.228519,1657.556773,-733.671746,44.433961,21.357921,-23.07604,28.741936,21.216571,-7.525365,45.96145,42.972513,-2.988937,448.907359,299.730041,-149.177318,,,,1135.546805,470.983185,-664.56362,16.412981,4.370202,-12.042779,87.072179,57.732461,-29.339718,2.498026,3.968757,1.470731,0.78869,20.096857,19.308167,21.047626,47.926605,26.878979,71.095,27.490701,-43.604299,0.859858,1.03058,0.170722,3.744419,1.555765,-2.188654,0.010138,3.269347,3.259209,1.997596,3.864165,1.866569,0.474705,13.678116,13.203411,1123.456045,852.587102,-270.868943,259.636146,94.797078,-164.839068,0.128993,161.046524,160.917531,17.872777,39.665941,21.793164,1.13034,0.056609,-1.073731,0.054668,0.60586,0.551192,3187.341446,1397.181163,-1790.160283,,,,33.086759,16.279405,-16.807354,53.279245,54.138051,0.858805999999994,7.498132,1.012931,-6.485201,15.914452,3.363965,-12.550487,,,,15.934289,6.272056,-9.662233,0.458579,0.87633,0.417751,0.143187,0.263,0.119813,2.656446,1.903339,-0.753107,88.909284,59.819996,-29.089288,177.284378,55.586564,-121.697814,45.343778,21.418924,-23.924854,584.576143,957.929746,373.353603,4.754974,7.579626,2.824652,0.39275,0.247907,-0.144843,8.034264,103.370195,95.335931,356.307878,212.527382,-143.780496,0,14.502319,14.502319,964.4,471.2,-493.2,0.000576,0,-0.000576,0.571893,0.129266,-0.442627,144.833803,86.04227,-58.791533,279.590144,243.584409,-36.005735,,,,1791.202848,1888.193239,96.990391,105.283566,330.845718,225.562152,168.908252,2324.355344,2155.447092,0.000173,1.074906,1.074733,83.139206,123.329223,40.190017,78.113883,167.261307,89.147424,1.254457,30.621537,29.36708,3672.416897,1725.723699,-1946.693198,324.856312,108.111234,-216.745078,9.115616,1.638761,-7.476855,510.008246,56.450613,-453.557633,230.868617,36.989046,-193.879571,15.30926,5.454949,-9.854311,2384.121965,1033.026006,-1351.095959,3500.355854,655.657725,-2844.698129,2.755873,2.214581,-0.541292,288.424867,33.798284,-254.626583,2909.937683,954.387273,-1955.55041,1664.02881,2266.936431,602.907621,1700.914061,680.505424,-1020.408637,0.086909,0.137837,0.050928,1.343575,13.124643,11.781068,935.22308,653.415964,-281.807116,14.523933,47.965112,33.441179,0.000127,0.097185,0.097058,1.31049,3.118886,1.808396,45711.389215,9416.971968,-36294.417247,1.044098,5.614163,4.570065,0,0.086686,0.086686,5577.381767,3597.383619,-1979.998148,942.449915,4438.156222,3495.706307,3427.214964,2057.195475,-1370.019489,9891.474032,4664.358977,-5227.115055,996.295765,2099.307232,1103.011467,0.000103,0.082264,0.082161,1.078079,0.005547,-1.072532,0.183128,0.357534,0.174406,0.008464,0,-0.008464,15.183741,10.988375,-4.195366,270.366175,270.263015,-0.103160000000003,0.013807,0.198036,0.184229,0.04015,0.00316,-0.03699,0.02656,0,-0.02656,0.49467,1.84206,1.34739,0.067633,0.060023,-0.00761,0.029999,0.282613,0.252614,0.000013,0,-0.000013,0.129339,1.21799,1.088651,0,0,0,2.369665,5.615678,3.246013,0.006999,0.045134,0.038135,2.314828,9.007342,6.692514,0.488222,2.094835,1.606613,0.027334,2.654265,2.626931,0.044849,2.830732,2.785883,0.000677,0.088682,0.088005,30.381459,5.429807,-24.951652,0.293833,1.028988,0.735155,131.771515,107.191425,-24.58009,349.386121,244.154912,-105.231209,42.175709,57.341676,15.165967,,,,130.358355,323.991833,193.633478,0.033434,4.29662,4.263186,0.000466,2.020087,2.019621,0.003275,0.020085,0.01681,44.306872,5.693938,-38.612934,0.010857,13.36308,13.352223,25.513541,12.782285,-12.731256,8.475866,13.019558,4.543692,0.713133,6.617426,5.904293,8.205278,3.609376,-4.595902,8.129975,5.406485,-2.72349,51.064035,14.373976,-36.690059,11.736216,58.016776,46.28056,0.039288,2.182816,2.143528,0.096834,2.59005,2.493216,1.341149,22.999566,21.658417,181.58131,321.604136,140.022826,1.593385,1.467225,-0.12616,9.072375,11.040322,1.967947,128.72166,3.879872,-124.841788,0.012176,0.066531,0.054355,0.055001,14.058476,14.003475,0.074446,45.429609,45.355163,385.199845,104.12114,-281.078705,3.979419,12.611699,8.63228,0.000409,0.073235,0.072826,0.244381,0.596901,0.35252,0.043843,0.049385,0.005542,4.736181,11.274736,6.538555,10.528286,12.687851,2.159565,0.249839,0.586121,0.336282,4.507739,1.363558,-3.144181,0.005133,1.908203,1.90307,14.744953,29.551549,14.806596,0.041806,0.039812,-0.001994,0.095162,7.397127,7.301965,3.337097,6.926805,3.589708,44.884915,26.41158,-18.473335,0.195454,1.007637,0.812183,0.470457,0.003073,-0.467384,4.762326,10.355853,5.593527,41.864585,12.880014,-28.984571,9.545049,40.02562,30.480571,30.112449,2.267326,-27.845123,0.000541,0.00305,0.002509,0.0962,0.115516,0.019316,0.866429,0.560527,-0.305902,0.000014,0.180999,0.180985,580.816844,444.533926,-136.282918,22.513141,7.421407,-15.091734,20.334939,2.61958,-17.715359,5.55594,6.903793,1.347853,6.825548,2.81193,-4.013618,5.478217,4.624877,-0.85334,2.945072,1.494106,-1.450966,38.630434,0.182567,-38.447867,0,0,0,,,
2015-10-01,4614.82987,5668.014092,1053.184222,37859.961762,24279.45344,-13580.508322,183774.377529714,122200.479358728,-61573.8981709862,16722.259937,0,-16722.259937,11531.947392,8004.648547,-3527.298845,41390.872132,31027.675159,-10363.196973,,,,8894.928391,12545.589738,3650.661347,51323.342376,45041.538666,-6281.80371,43729.357746,27721.783239,-16007.574507,2044.921406,2344.919346,299.997939999999,73231.621505,33303.308643,-39928.312862,195181.05525,130332.962827,-64848.092423,88012.025663,40188.638629,-47823.387034,1944.066065,2740.840163,796.774098,1175.283549,2489.407627,1314.124078,1548.699843,1794.153758,245.453915,1.196119,1.06584,-0.130279,23652.192159,23841.062267,188.870108000003,0,0.019742,0.019742,27671.150217,21200.476399,-6470.673818,320.571988,546.189409,225.617421,12.106129,24.211144,12.105015,219.534312,282.964276,63.429964,378.034351,502.404945,124.370594,284.873557,121.68652,-163.187037,345.290766,621.527723,276.236957,32.587005,778.46707,745.880065,2.524895,42.744035,40.21914,38.815555,207.487593,168.672038,0,14.538359,14.538359,21.997841,133.979384,111.981543,1.008573,23.105294,22.096721,11.155081,81.780377,70.625296,82.518894,69.510651,-13.008243,395.761091,666.06729,270.306199,0.334878,6.168638,5.83376,1.412802,16.517075,15.104273,3.898417,18.923756,15.025339,0.461869,30.102016,29.640147,0.017567,0.488629,0.471062,0.315631,5.276067,4.960436,4.037188,33.342798,29.30561,0.047552,7.376498,7.328946,0.764174,6.658566,5.894392,5.273264,47.547116,42.273852,303.220652,210.716611,-92.504041,,,,5.100963,62.807485,57.706522,26.006949,46.197933,20.190984,1.620314,65.535844,63.91553,0.142434,5.978063,5.835629,6.669044,4.827059,-1.841985,797.537973,1556.889315,759.351342,1184.063143,690.224426,-493.838717,32.757027,27.911288,-4.845739,8.285307,35.835168,27.549861,0,1.182469,1.182469,551.034521,485.941719,-65.0928020000001,440.503554,708.604199,268.100645,87.522661,67.06093,-20.461731,670.737219,1039.824215,369.086996,2195.200141,2230.585917,35.3857760000001,19.111164,124.218102,105.106938,53.931811,114.91421,60.982399,348.052168,777.161946,429.109778,0.087966,0.10761,0.019644,29.630523,31.277565,1.647042,944.777231,409.526184,-535.251047,0.002995,0,-0.002995,477.137443,260.140728,-216.996715,422.285254,103.742435,-318.542819,10.014635,0.251853,-9.762782,720.83256,180.21667,-540.61589,4800.068902,5337.985063,537.916161,3838.388158,936.364668,-2902.02349,1394.899634,3293.854736,1898.955102,1433.864014,2957.581558,1523.717544,68.301741,102.919103,34.617362,0.443419,0.419419,-0.024,6.182411,8.341644,2.159233,4451.233674,2601.923746,-1849.309928,11373.399558,4748.216772,-6625.182786,999.115621,253.997042,-745.118579,,,,382.232282,162.019955,-220.212327,153.080776,26.097816,-126.98296,469.847139,133.002534,-336.844605,22.913374,3.340164,-19.57321,3184.414804,1747.33466,-1437.080144,33.927213,27.346992,-6.580221,31.802113,21.17607,-10.626043,111.42526,38.160281,-73.264979,479.33154,298.829654,-180.501886,,,,1113.271501,485.026282,-628.245219,4.718746,3.368007,-1.350739,90.152599,90.084404,-0.0681949999999887,3.345737,5.528808,2.183071,90.594125,23.862638,-66.731487,2.607992,22.736506,20.128514,69.495162,28.277383,-41.217779,0.086325,1.990649,1.904324,3.251464,1.26726,-1.984204,0.126339,0.391719,0.26538,2.339373,6.605754,4.266381,1.116066,10.226295,9.110229,1096.592431,981.775899,-114.816532,262.169713,56.612312,-205.557401,0.008301,55.262977,55.254676,13.442285,49.585984,36.143699,0.977622,0.119368,-0.858254,0.00381,0.030366,0.026556,3884.67072,1395.33183,-2489.33889,,,,45.134917,14.030504,-31.104413,57.643439,21.903011,-35.740428,7.501116,2.385104,-5.116012,17.166805,3.454772,-13.712033,,,,19.450051,9.655037,-9.795014,0.47691,0.760461,0.283551,0.027904,0.564525,0.536621,16.441795,2.009254,-14.432541,143.791831,43.594634,-100.197197,190.7439,47.787626,-142.956274,54.692858,30.347137,-24.345721,695.496637,637.616197,-57.8804399999999,2.266998,5.523224,3.256226,1.245486,0.025732,-1.219754,8.392116,82.022798,73.630682,396.391301,79.532252,-316.859049,0,28.770017,28.770017,1193.2,540.3,-652.9,0,0.027554,0.027554,0.310888,0.027408,-0.28348,151.169071,105.042354,-46.126717,263.030206,179.065432,-83.964774,,,,1261.106452,1381.554603,120.448151,130.469581,184.376374,53.906793,164.421647,2075.237581,1910.815934,0.110005,14.008226,13.898221,68.758059,324.269065,255.511006,71.887325,107.912008,36.024683,3.133392,89.580628,86.447236,3878.647647,1829.518035,-2049.129612,343.232993,181.154494,-162.078499,11.09175,1.21285,-9.8789,566.69503,77.811802,-488.883228,249.328359,24.82935,-224.499009,16.340905,57.628605,41.2877,2569.85463,829.032275,-1740.822355,3493.181998,532.243375,-2960.938623,5.041878,2.51586,-2.526018,282.57743,40.326044,-242.251386,2960.533116,1020.756594,-1939.776522,1731.070034,2483.307732,752.237698,1708.532717,686.557127,-1021.97559,0.861428,0.193672,-0.667756,1.445329,7.899946,6.454617,827.169144,662.652314,-164.51683,11.159971,43.761358,32.601387,0.816907,0.22928,-0.587627,2.169963,4.446293,2.27633,44311.415594,11395.587681,-32915.827913,0.682322,3.825307,3.142985,0,0.104753,0.104753,5791.619132,3515.387613,-2276.231519,526.114461,2968.384546,2442.270085,3394.202931,2863.211792,-530.991139,10819.554468,5207.018897,-5612.535571,864.717988,1979.179796,1114.461808,0.003255,0,-0.003255,0.172915,0.021781,-0.151134,0.110066,0.152266,0.0422,0.007164,0.05608,0.048916,10.024339,37.652686,27.628347,274.062281,431.950561,157.88828,0.041767,0.515753,0.473986,0.027311,0.005819,-0.021492,0.06128,0.003151,-0.058129,0.552882,2.080379,1.527497,0.164625,0.445843,0.281218,0.330875,0.210205,-0.12067,0.000168,0.002642,0.002474,0.42994,0.067088,-0.362852,0,0,0,3.169653,3.681252,0.511599,0.088249,0.020424,-0.067825,3.213564,10.667888,7.454324,0.851911,7.867857,7.015946,0.029416,4.120854,4.091438,0.022408,3.753712,3.731304,0.012034,0.390929,0.378895,16.982555,5.631501,-11.351054,0.250407,0.904093,0.653686,58.224161,70.254333,12.030172,259.913157,148.642519,-111.270638,46.884056,51.014966,4.13091,,,,101.985819,269.629439,167.64362,1.250302,8.758468,7.508166,0,1.168954,1.168954,0.000114,0,-0.000114,44.544361,14.790042,-29.754319,0.03758,13.584069,13.546489,9.592634,15.398008,5.805374,4.506567,15.638099,11.131532,0.362731,4.039615,3.676884,9.820532,4.901563,-4.918969,2.882685,5.937656,3.054971,61.068954,19.997227,-41.071727,27.841657,72.263091,44.421434,0.154023,2.73448,2.580457,0.151086,7.190794,7.039708,1.135054,5.542888,4.407834,124.762089,329.323159,204.56107,0.169158,0.296954,0.127796,44.217017,16.927866,-27.289151,87.799586,3.257148,-84.542438,1.235848,0.143555,-1.092293,0.041548,2.330997,2.289449,0.277243,44.616286,44.339043,252.897815,76.736728,-176.161087,1.993573,11.72936,9.735787,0.007753,0.309771,0.302018,0.438276,0.860754,0.422478,0.063882,0.010305,-0.053577,1.506058,11.641077,10.135019,11.578786,4.966449,-6.612337,0.564819,0.620236,0.055417,9.934324,3.342839,-6.591485,0.127464,0.73589,0.608426,13.030179,98.192777,85.162598,0.002892,0.232966,0.230074,0.711406,5.869086,5.15768,3.446335,9.50118,6.054845,60.312988,317.589548,257.27656,0.242582,1.598544,1.355962,1.229167,0.012489,-1.216678,7.05492,14.333724,7.278804,37.902462,2.585078,-35.317384,18.030705,6.008721,-12.021984,17.362556,2.704282,-14.658274,0.009158,0.056042,0.046884,0.031901,0.168918,0.137017,0.009278,0.722723,0.713445,0.000005,1.108907,1.108902,617.554325,497.499226,-120.055099,0.357587,15.064438,14.706851,15.98108,3.267887,-12.713193,5.69709,4.71883,-0.978260000000001,0.488245,1.794625,1.30638,7.276003,3.354432,-3.921571,14.082054,1.910204,-12.17185,22.828758,0.03352,-22.795238,0,0,0,,,
2015-11-01,4740.214758,6463.721903,1723.507145,35640.733447,22042.78221,-13597.951237,181577.065728806,120940.949754847,-60636.1159739592,14476.237441,0,-14476.237441,11364.278232,7323.461397,-4040.816835,39507.584507,28105.789331,-11401.795176,,,,8361.05302,11637.977992,3276.924972,46961.531022,41287.309227,-5674.221795,40642.795748,25209.555681,-15433.240067,1989.077571,1953.085025,-35.9925459999993,69449.856648,30499.921515,-38949.935133,182151.680922,120521.834706,-61629.8462159999,83080.426389,38071.369631,-45009.056758,1841.146314,2473.120882,631.974568,1116.77736,2362.334594,1245.557234,1571.896039,1214.386677,-357.509362,0.004547,0.198864,0.194317,22911.148514,22403.516684,-507.631830000002,0.015265,0.003692,-0.011573,24050.382508,18883.792543,-5166.589965,297.41508,557.011638,259.596558,3.95975,28.40917,24.44942,199.69394,285.995761,86.301821,376.040297,440.017327,63.97703,259.90514,94.143215,-165.761925,345.217829,478.206762,132.988933,27.317319,661.739004,634.421685,0.820218,40.180806,39.360588,32.779879,214.492098,181.712219,0,6.383073,6.383073,20.339389,145.72936,125.389971,0.883625,26.059039,25.175414,9.124687,76.796047,67.67136,78.545549,115.353033,36.807484,362.874028,617.746179,254.872151,0.280705,5.156508,4.875803,6.469666,92.136807,85.667141,3.982851,14.348833,10.365982,0.27979,16.112723,15.832933,1.416906,0.755539,-0.661367,0.080343,4.538009,4.457666,6.981524,42.048514,35.06699,0.245059,9.662523,9.417464,0.481048,8.569669,8.088621,2.716868,54.725119,52.008251,239.140065,228.932907,-10.207158,,,,3.883133,92.198315,88.315182,14.429963,47.909635,33.479672,8.692646,62.126965,53.434319,0.267047,4.822653,4.555606,0.176348,6.429288,6.25294,1004.410726,1147.135853,142.725127,1115.107551,593.028279,-522.079272,32.66372,33.558704,0.894984000000001,8.076034,35.571333,27.495299,0.001445,6.365431,6.363986,448.081531,440.03794,-8.04359099999999,427.141156,707.439993,280.298837,51.446829,81.064664,29.617835,524.004739,1057.078509,533.07377,2024.923525,2225.198841,200.275316,17.719606,102.466199,84.746593,44.807343,92.617931,47.810588,357.080293,637.666258,280.585965,1.14783,0.011538,-1.136292,28.828182,42.956767,14.128585,887.941674,307.93387,-580.007804,0,0,0,284.96318,241.685552,-43.277628,351.04801,115.794417,-235.253593,10.405652,0.069464,-10.336188,649.581269,160.742067,-488.839202,4400.720973,4532.318045,131.597072,3869.640994,738.152009,-3131.488985,1282.900339,3427.858715,2144.958376,1410.558379,3007.614297,1597.055918,45.254615,44.725014,-0.529601,0.318537,0.389285,0.070748,1.889046,4.771053,2.882007,4390.42107,2325.790032,-2064.631038,10183.026015,4100.471467,-6082.554548,1041.452892,237.202254,-804.250638,,,,326.349107,183.654544,-142.694563,166.578631,25.106278,-141.472353,424.263918,149.527825,-274.736093,26.047141,1.165061,-24.88208,2653.657816,1241.234581,-1412.423235,34.769078,23.824959,-10.944119,19.798758,22.499303,2.700545,78.392007,32.594858,-45.797149,457.752764,281.67855,-176.074214,,,,1196.344993,813.577518,-382.767475,4.488933,4.18251,-0.306423000000001,41.383705,64.556527,23.172822,3.530939,6.978432,3.447493,2.844487,25.856882,23.012395,3.652459,23.990151,20.337692,47.942969,54.733354,6.790385,0.405014,1.766754,1.36174,2.79261,1.76538,-1.02723,0.125303,1.551111,1.425808,0.462633,2.481975,2.019342,0.772649,2.720409,1.94776,1211.830755,845.012609,-366.818146,238.683326,68.524994,-170.158332,0.003315,49.742625,49.73931,11.261766,40.49821,29.236444,0.390759,3.628518,3.237759,0.039991,0.036434,-0.003557,3752.938264,1147.079221,-2605.859043,,,,42.557459,20.936175,-21.621284,52.175237,46.737447,-5.43779,5.915071,1.240035,-4.675036,20.376649,1.837369,-18.53928,,,,20.259531,7.73256,-12.526971,0.076294,0.553276,0.476982,0.360673,0.289961,-0.070712,17.517679,1.809729,-15.70795,100.884459,51.234538,-49.649921,164.751132,78.078567,-86.672565,42.268255,24.082479,-18.185776,626.266091,563.470198,-62.795893,2.932301,3.109466,0.177165,0.308503,0.0028,-0.305703,10.937794,78.129582,67.191788,479.532149,74.829765,-404.702384,0,31.121706,31.121706,1092.1,695,-397.1,0,0,0,0.261971,0.078968,-0.183003,98.394181,102.268773,3.87459199999999,186.512222,199.445567,12.933345,,,,1450.24017,1963.562826,513.322656,96.232507,632.261213,536.028706,158.074748,1973.619247,1815.544499,0.097115,4.186367,4.089252,48.923195,320.530358,271.607163,69.928736,114.712388,44.783652,0.682892,21.834409,21.151517,3273.494751,1580.147499,-1693.347252,268.139213,122.994084,-145.145129,6.251191,1.367314,-4.883877,373.21269,155.501795,-217.710895,219.117302,25.981238,-193.136064,15.263638,22.998646,7.735008,2460.084955,776.622507,-1683.462448,3197.703924,720.615438,-2477.088486,4.493845,2.338152,-2.155693,196.309965,31.84454,-164.465425,2741.815778,949.344912,-1792.470866,1474.337775,2146.509645,672.17187,1458.06344,465.429951,-992.633489,1.439773,0.335296,-1.104477,0.889571,8.150626,7.261055,754.636612,658.684445,-95.952167,10.502647,50.123901,39.621254,0.949329,0.516184,-0.433145,2.572649,2.350974,-0.221675,41886.904301,10603.960364,-31282.943937,1.195052,4.22019,3.025138,0,0,0,5694.599855,3362.681413,-2331.918442,456.867513,2957.218514,2500.351001,3204.848125,2031.392891,-1173.455234,10694.098301,4936.844028,-5757.254273,790.785807,2080.357565,1289.571758,0.000413,0.011821,0.011408,0.060136,0,-0.060136,0.244522,0,-0.244522,0,0,0,10.281284,10.747888,0.466604,271.225639,238.475372,-32.750267,0.025561,0.324754,0.299193,0.049474,0.003519,-0.045955,0.047372,0.003344,-0.044028,0.29952,1.514057,1.214537,0.078265,0.359386,0.281121,0.766529,0.675,-0.091529,0.000442,0,-0.000442,0.311236,0.358511,0.047275,0,0,0,2.345455,2.957389,0.611934,0.332896,0.010512,-0.322384,3.248873,9.575995,6.327122,17.273849,6.956621,-10.317228,0.023836,3.347247,3.323411,0.025685,2.02109,1.995405,0.001272,0,-0.001272,19.407454,3.868307,-15.539147,0.260124,0.683307,0.423183,59.211338,96.389551,37.178213,227.690857,193.639872,-34.050985,33.320939,48.278242,14.957303,,,,91.300346,384.706635,293.406289,0.920056,12.958799,12.038743,0.000103,1.280457,1.280354,0,0.007228,0.007228,11.718814,9.172878,-2.545936,0.109289,6.75588,6.646591,6.751066,10.199369,3.448303,2.918822,12.24039,9.321568,0.599599,7.433783,6.834184,3.76786,4.230781,0.462921,1.080961,6.571338,5.490377,47.372166,19.360176,-28.01199,9.352779,70.160818,60.808039,0.122692,5.794875,5.672183,0.088074,2.668107,2.580033,2.270569,4.473894,2.203325,236.358858,264.238537,27.879679,0.65002,0.637734,-0.012286,39.57985,8.157359,-31.422491,91.506291,3.685851,-87.82044,1.199542,0.004938,-1.194604,0.162538,2.756286,2.593748,0.17534,48.677854,48.502514,339.519263,84.859262,-254.660001,2.012985,15.410051,13.397066,0.000327,0.229857,0.22953,0.420338,0.560947,0.140609,0.137168,0.008563,-0.128605,5.092309,10.172883,5.080574,2.00397,4.053163,2.049193,1.218189,0.169949,-1.04824,6.593129,1.300079,-5.29305,0.044294,1.005227,0.960933,13.376282,232.045645,218.669363,0.015936,0.129834,0.113898,1.535345,2.880496,1.345151,1.812881,5.038941,3.22606,34.849044,65.122353,30.273309,0.279868,1.277957,0.998089,1.487546,0,-1.487546,6.185227,15.47214,9.286913,31.261968,2.316058,-28.94591,2.203072,50.724047,48.520975,18.569535,2.733993,-15.835542,0.000013,0.285592,0.285579,0.158553,0.228605,0.070052,0.091457,0.591096,0.499639,0.00039,1.230039,1.229649,568.216002,405.224667,-162.991335,7.268711,4.362932,-2.905779,16.446132,3.086938,-13.359194,2.937664,5.562705,2.625041,0.877052,6.909089,6.032037,3.98428,2.22143,-1.76285,10.140197,1.609772,-8.530425,34.123804,0.051322,-34.072482,0,0,0,,,
2015-12-01,5271.698486,5850.679906,578.98142,35479.523931,21765.209176,-13714.314755,181094.67997973,119836.351202685,-61258.3287770454,13799.874267,0,-13799.874267,11135.284284,7132.332688,-4002.951596,37304.23813,29712.376225,-7591.861905,,,,8909.050932,11607.6216,2698.570668,46763.197122,40374.687659,-6388.50946299999,40655.748573,25793.385509,-14862.363064,1998.512745,1861.506522,-137.006223,66177.048477,30512.204732,-35664.843745,179734.829106,120070.401715,-59664.427391,80229.209938,38204.50809,-42024.701848,1869.547506,2078.87771,209.330204,1179.05686,2228.381099,1049.324239,1612.506149,1151.436054,-461.070095,0.015743,0.311236,0.295493,23611.548729,21834.298211,-1777.250518,0.037193,0,-0.037193,23151.648393,18540.389448,-4611.258945,332.089101,417.383974,85.294873,3.561422,28.208484,24.647062,188.329459,235.879969,47.55051,377.765447,364.293627,-13.47182,242.630695,98.159032,-144.471663,357.155691,456.770278,99.614587,39.34931,547.820364,508.471054,2.164527,27.187523,25.022996,21.67,193.77195,172.10195,0,4.934637,4.934637,24.267818,130.717819,106.450001,1.130533,27.303415,26.172882,10.316319,57.280863,46.964544,72.757064,79.114177,6.357113,371.577113,506.39083,134.813717,0.218666,4.360533,4.141867,0.559718,18.450412,17.890694,3.813766,13.964969,10.151203,0.216812,38.583579,38.366767,0.039981,0.515392,0.475411,0.073375,4.226102,4.152727,2.686219,53.892578,51.206359,0.194352,7.082853,6.888501,0.654259,7.174928,6.520669,5.369882,41.839328,36.469446,266.802733,167.523181,-99.279552,,,,5.681139,83.128132,77.446993,20.904529,28.732231,7.827702,1.425685,68.211647,66.785962,1.068336,9.826672,8.758336,1.160428,8.730928,7.5705,1121.97933,1272.163396,150.184066,983.699,362.348077,-621.350923,34.436322,42.159128,7.72280600000001,5.523244,27.974526,22.451282,0.022421,268.716503,268.694082,519.854097,414.499764,-105.354333,507.980956,731.050124,223.069168,72.616388,91.349775,18.733387,614.849075,1329.162368,714.313293,2274.723383,2401.687087,126.963704,13.889952,107.655992,93.76604,40.831676,94.946568,54.114892,362.989453,732.407175,369.417722,0.021256,0.04071,0.019454,23.257314,15.697729,-7.559585,914.342581,319.357783,-594.984798,0,0,0,323.400965,442.177305,118.77634,298.301035,109.404952,-188.896083,9.349264,0.2426,-9.106664,624.119756,184.713616,-439.40614,4121.460783,4316.59085,195.130066999999,3567.455793,625.143406,-2942.312387,1444.277577,3485.659491,2041.381914,1557.50245,2463.333296,905.830846,42.978195,72.038319,29.060124,1.012821,0.9071,-0.105721,3.308369,4.345885,1.037516,3986.227447,2452.459185,-1533.768262,10721.136402,4002.951531,-6718.184871,901.196133,265.456522,-635.739611,,,,382.279429,154.480781,-227.798648,152.260378,33.28091,-118.979468,558.526537,166.635534,-391.891003,31.440295,13.706686,-17.733609,3082.050643,1832.522715,-1249.527928,70.806957,24.263963,-46.542994,23.510617,15.888971,-7.621646,119.939989,106.625132,-13.314857,476.178406,325.164809,-151.013597,,,,904.785919,475.859648,-428.926271,5.611068,4.616506,-0.994562,46.880887,66.90389,20.023003,2.570443,5.330319,2.759876,0.719901,23.472138,22.752237,1.716511,30.162637,28.446126,80.985141,42.88149,-38.103651,0.08005,0.941842,0.861792,2.879309,1.378959,-1.50035,0.119408,5.420802,5.301394,0.612844,6.691288,6.078444,1.150037,4.778077,3.62804,1116.185269,833.259869,-282.9254,251.920039,76.216324,-175.703715,0.013514,118.538629,118.525115,16.868965,8.343862,-8.525103,0.380412,0.157006,-0.223406,0.459522,0.006634,-0.452888,3732.490038,1501.983652,-2230.506386,,,,38.977749,29.177739,-9.80001,57.257631,31.516622,-25.741009,4.747962,0.970787,-3.777175,15.683918,6.41106,-9.272858,,,,22.350057,21.836913,-0.513144,0.08351,3.229724,3.146214,0.325445,0.729563,0.404118,1.68804,2.311762,0.623722,102.633522,64.956006,-37.677516,153.195487,68.416205,-84.779282,44.729962,22.337352,-22.39261,608.561073,895.946639,287.385566,2.764804,5.552494,2.78769,0.451104,0.436321,-0.014783,12.824826,86.266679,73.441853,644.123089,107.504325,-536.618764,10.766314,36.543247,25.776933,1007,635.4,-371.6,0,0,0,1.718608,0.079588,-1.63902,109.910906,164.450665,54.539759,357.804166,253.633464,-104.170702,,,,1853.728431,1767.158326,-86.570105,55.357942,444.947813,389.589871,268.624921,2013.222413,1744.597492,0.098794,19.495052,19.396258,39.624801,176.728751,137.10395,61.754286,74.97514,13.220854,1.129686,16.526724,15.397038,3014.588459,1544.84881,-1469.739649,284.435854,165.426511,-119.009343,5.343187,1.861379,-3.481808,447.195666,135.358148,-311.837518,239.102015,28.850045,-210.25197,11.880956,14.773189,2.892233,2348.311281,931.080128,-1417.231153,3102.466365,713.703973,-2388.762392,4.817302,1.300566,-3.516736,211.938472,30.815603,-181.122869,2944.021667,954.771611,-1989.250056,1430.188595,2563.863976,1133.675381,1502.957492,591.962033,-910.995459,0.808245,0.963156,0.154911,0.577012,13.077221,12.500209,773.360015,589.728751,-183.631264,7.048038,54.534513,47.486475,1.034417,0.351249,-0.683168,2.113335,4.010835,1.8975,37999.417153,10073.19857,-27926.218583,0.828703,3.862039,3.033336,0,0.158664,0.158664,5383.989606,3396.052929,-1987.936677,480.253674,3403.120168,2922.866494,3191.116369,1933.84293,-1257.273439,11312.683452,4759.099756,-6553.583696,835.665855,1929.419271,1093.753416,0.000018,0,-0.000018,0.123579,0,-0.123579,0.105819,0.117071,0.011252,0.000036,0.017966,0.01793,5.35422,11.673175,6.318955,310.415329,237.859828,-72.555501,0.08956,0.201074,0.111514,0.029075,0.057368,0.028293,0.07721,0,-0.07721,0.186823,1.682159,1.495336,0.055296,0.37583,0.320534,0.087683,0.136221,0.048538,0.000403,0.002472,0.002069,0.370947,0.103643,-0.267304,0,0,0,4.007544,20.64231,16.634766,0,0.010466,0.010466,1.908467,7.173599,5.265132,2.596802,9.059479,6.462677,0.036784,3.721386,3.684602,0.021105,1.985193,1.964088,0.114895,0.076972,-0.037923,17.547862,3.329177,-14.218685,0.254941,0.731649,0.476708,78.904196,111.745013,32.840817,140.602129,158.572585,17.970456,30.732157,68.234377,37.50222,,,,107.608413,349.933639,242.325226,1.711731,5.905514,4.193783,0.021012,2.858069,2.837057,0.015166,0,-0.015166,9.659427,6.409453,-3.249974,0.049318,6.400664,6.351346,9.222327,5.922835,-3.299492,3.844548,16.845334,13.000786,0.227269,6.465991,6.238722,7.755527,8.360807,0.60528,12.74094,5.288738,-7.452202,91.977204,13.14907,-78.828134,25.554333,62.72889,37.174557,0.130877,1.96113,1.830253,0.883837,7.805954,6.922117,1.642981,4.101058,2.458077,190.817794,235.066529,44.248735,0.032245,0.295126,0.262881,36.568783,39.990921,3.422138,110.030708,1.431456,-108.599252,0.008484,0,-0.008484,0.498738,1.996032,1.497294,0.244572,39.744085,39.499513,221.452692,37.502187,-183.950505,4.229307,19.595116,15.365809,0.000368,0.128296,0.127928,0.105035,0.756191,0.651156,0.063159,0.039151,-0.024008,1.522905,6.698476,5.175571,12.384489,4.375544,-8.008945,1.14262,1.863403,0.720783,3.317247,0.408121,-2.909126,0.178178,4.163754,3.985576,11.838169,170.373448,158.535279,0.012746,0.333339,0.320593,3.092249,16.185876,13.093627,4.145537,7.758166,3.612629,43.831122,23.079878,-20.751244,0.987836,1.028655,0.040819,0.776843,0.084383,-0.69246,7.085752,15.006653,7.920901,30.851121,5.296207,-25.554914,3.430337,8.740863,5.310526,25.096403,1.981906,-23.114497,0.000013,0,-0.000013,0.010323,0.144336,0.134013,2.491079,0.348507,-2.142572,0.000218,1.254638,1.25442,662.327771,418.835743,-243.492028,8.712348,8.878566,0.166217999999999,18.762329,3.959148,-14.803181,1.739978,14.767639,13.027661,8.063027,1.76415,-6.298877,0.693802,3.590228,2.896426,4.834356,1.22203,-3.612326,30.032014,0.118102,-29.913912,0,1.731375,1.731375,,,
2016-01-01,5581.773309,5178.475788,-403.297521,29264.889161,20358.616015,-8906.27314600001,179116.71082584,116209.555004732,-62907.1558211084,12866.367851,0,-12866.367851,10621.292643,6256.987208,-4364.305435,30470.806435,25472.934612,-4997.871823,,,,7462.702651,10436.208118,2973.505467,44658.939074,37720.626037,-6938.313037,33635.865137,23452.771902,-10183.093235,1889.665344,1518.494468,-371.170876,63586.431975,26972.126967,-36614.305008,165898.887083,107967.660109,-57931.226974,77074.620288,33052.588165,-44022.032123,1485.845536,2180.295902,694.450366,1176.775079,1786.811816,610.036737,1447.287651,991.694602,-455.593048999999,0.319486,0.159603,-0.159883,22272.169026,19705.925452,-2566.243574,0.000024,0,-0.000024,22386.770048,18014.700585,-4372.069463,282.413284,521.112517,238.699233,3.30702,18.622525,15.315505,162.755449,225.340918,62.585469,283.844552,399.360149,115.515597,216.515892,97.06775,-119.448142,295.556691,435.316265,139.759574,28.891158,522.32917,493.438012,0.828211,27.048652,26.220441,21.266286,149.790014,128.523728,0,23.100284,23.100284,26.35661,117.737509,91.380899,0.327989,21.417362,21.089373,4.607052,49.524681,44.917629,49.786345,71.440588,21.654243,244.759668,502.098303,257.338635,0.354999,3.09523,2.740231,1.830401,16.645828,14.815427,3.929362,13.490254,9.560892,3.432792,14.997057,11.564265,0.076697,0.291305,0.214608,0.101895,4.472861,4.370966,1.208573,20.093696,18.885123,0.185356,5.857721,5.672365,0.500275,5.030542,4.530267,2.542945,33.566386,31.023441,303.787593,191.770502,-112.017091,,,,12.100264,75.383084,63.28282,9.773617,45.930441,36.156824,0.929354,106.887085,105.957731,0.127001,10.660636,10.533635,0.144984,14.832976,14.687992,906.241841,999.814042,93.572201,665.885858,366.717751,-299.168107,34.472082,86.437594,51.965512,4.857442,22.367332,17.50989,0.058495,1.315051,1.256556,554.832233,359.891802,-194.940431,447.388405,621.820531,174.432126,58.388863,63.020652,4.631789,810.238576,1238.415649,428.177073,1691.155546,2068.792998,377.637452,11.478294,105.738051,94.259757,42.779567,89.443461,46.663894,272.649629,667.135427,394.485798,0.033505,0.985486,0.951981,25.924135,26.551145,0.627010000000002,688.333555,238.387056,-449.946499,0.000207,0,-0.000207,329.028065,275.171857,-53.856208,289.66496,110.98493,-178.68003,9.640939,0.125033,-9.515906,691.10943,134.936956,-556.172474,3659.597456,3874.221556,214.6241,3136.465716,727.890039,-2408.575677,1079.35366,2650.934385,1571.580725,1276.418488,2553.319649,1276.901161,41.229488,64.545194,23.315706,1.533577,0.695077,-0.8385,2.296938,4.21734,1.920402,3301.213822,2252.988328,-1048.225494,8229.541038,3692.749323,-4536.791715,734.736014,1083.244326,348.508312,,,,311.531016,182.751726,-128.77929,147.085353,26.444311,-120.641042,426.211156,154.122117,-272.089039,21.028864,1.302766,-19.726098,2175.60946,1462.053455,-713.556005,47.882095,16.54798,-31.334115,23.387219,20.633871,-2.753348,75.992542,33.996075,-41.996467,421.331151,286.77085,-134.560301,,,,961.362783,362.622899,-598.739884,4.854716,4.425729,-0.428987,42.894422,65.866844,22.972422,4.567864,2.993819,-1.574045,0.588155,22.766004,22.177849,18.064364,22.263975,4.199611,77.479761,25.595744,-51.884017,2.268078,0.702763,-1.565315,2.666697,0.414117,-2.25258,0.018949,1.073795,1.054846,0.696742,4.275063,3.578321,0.96493,2.901096,1.936166,928.942835,846.155494,-82.787341,160.59772,67.610857,-92.986863,0.018192,77.668762,77.65057,12.386103,6.397102,-5.989001,0.644435,0.113735,-0.5307,0.010099,0.034812,0.024713,3199.334576,1190.730717,-2008.603859,,,,36.917905,20.072266,-16.845639,63.286439,11.788603,-51.497836,5.335868,0.95107,-4.384798,12.96768,1.128811,-11.838869,,,,19.033286,5.823275,-13.210011,0.08775,1.436657,1.348907,0.122909,0.11893,-0.00397900000000001,1.613255,1.736416,0.123161,88.693177,43.772962,-44.920215,144.933881,49.077016,-95.856865,46.700973,14.058323,-32.64265,649.652856,719.124898,69.472042,2.011393,3.484003,1.47261,0.477122,0.568378,0.0912560000000001,9.154229,76.934593,67.780364,202.07884,95.284923,-106.793917,0,10.218126,10.218126,1255.227631,593.144925,-662.082706,0,0.00564,0.00564,0.696637,0.096164,-0.600473,106.495619,98.019886,-8.47573300000001,199.344222,169.498576,-29.845646,,,,1511.355044,1163.785632,-347.569412,83.160548,182.209096,99.048548,232.369901,1658.938476,1426.568575,0.294926,3.230393,2.935467,50.156832,85.848396,35.691564,59.969862,56.599957,-3.369905,1.849499,173.759938,171.910439,3693.275929,1485.747386,-2207.528543,282.86047,95.098072,-187.762398,6.381678,1.463763,-4.917915,548.04352,44.013768,-504.029752,234.481827,28.466968,-206.014859,14.373733,15.079056,0.705323,2192.483513,740.58099,-1451.902523,3168.879184,621.132435,-2547.746749,3.54824,2.037884,-1.510356,228.041056,33.078707,-194.962349,2474.514306,905.134781,-1569.379525,1278.985982,2016.564152,737.57817,1559.225484,726.790053,-832.435431,0.19113,0.182568,-0.00856199999999999,1.049374,10.001536,8.952162,719.573799,609.927319,-109.64648,6.428326,28.135059,21.706733,0.503947,0.118146,-0.385801,1.782865,3.028601,1.245736,37159.255628,8218.316517,-28940.939111,2.07401,3.372384,1.298374,0,0.02084,0.02084,5913.673022,3180.464718,-2733.208304,484.529229,2691.051434,2206.522205,3251.251022,2148.686208,-1102.564814,9587.665858,4679.326688,-4908.33917,806.445118,1511.433611,704.988493,0.000799,0.022701,0.021902,0.72409,0.071165,-0.652925,0.192151,0.011627,-0.180524,0.289093,0,-0.289093,6.218586,8.773156,2.55457,337.616241,237.521735,-100.094506,0.359592,0.205545,-0.154047,0.050447,0.03047,-0.019977,0.058173,0,-0.058173,0.359323,1.398954,1.039631,0.118834,0.36415,0.245316,0.112256,2.282096,2.16984,0.000217,0.000451,0.000234,0.049079,0.042092,-0.006987,,,,1.987156,2.390533,0.403377,0.000193,0.03429,0.034097,2.677505,7.104829,4.427324,0.583268,5.025759,4.442491,0.022661,2.261161,2.2385,0.010652,2.196757,2.186105,0.007683,0.01,0.002317,18.926978,4.476587,-14.450391,0.237001,1.127992,0.890991,97.167836,140.133596,42.96576,168.226627,110.650323,-57.576304,32.870547,33.646926,0.776378999999999,,,,127.6115,233.007426,105.395926,0.099056,1.243919,1.144863,0.009385,0.247524,0.238139,0.033988,0,-0.033988,11.813687,2.066739,-9.746948,0.046001,10.975959,10.929958,5.473042,13.085594,7.612552,6.901274,11.870051,4.968777,1.1015,5.950627,4.849127,2.903291,3.66543,0.762139,0.824897,3.732828,2.907931,127.954711,18.27604,-109.678671,39.53601,59.62325,20.08724,0.026335,5.526172,5.499837,0.484906,1.154292,0.669386,0.883524,6.212008,5.328484,178.215301,131.709316,-46.505985,0.009795,0.865479,0.855684,0.711726,3.666003,2.954277,59.257277,1.764748,-57.492529,0.554282,0.008843,-0.545439,0.172703,4.101678,3.928975,0.283125,27.827565,27.54444,212.864684,191.63733,-21.227354,9.051742,6.171674,-2.880068,0,0.097178,0.097178,0.332991,0.770417,0.437426,0.008161,0.20522,0.197059,4.487716,7.527127,3.039411,1.791469,4.208338,2.416869,0.980048,2.907174,1.927126,1.542258,0.752151,-0.790107,0.206311,2.389884,2.183573,7.623021,137.467586,129.844565,0.001195,0.168942,0.167747,0.621178,9.997609,9.376431,5.741143,3.513147,-2.227996,49.944428,36.651584,-13.292844,0.185619,0.975206,0.789587,0.29883,0.046054,-0.252776,28.583042,11.790556,-16.792486,23.706743,2.361405,-21.345338,14.090747,10.050132,-4.040615,21.499718,2.273784,-19.225934,0,0.016907,0.016907,0.045825,0.040977,-0.004848,2.102172,0.812105,-1.290067,0.000017,0.37674,0.376723,568.699536,306.008922,-262.690614,5.290393,14.43822,9.147827,10.580433,4.779434,-5.800999,4.006659,4.867073,0.860414,0.339088,1.996019,1.656931,0.741164,1.789877,1.048713,3.88459,2.237703,-1.646887,26.587657,0.004554,-26.583103,,,,,,
2016-02-01,4952.480662,6673.480083,1720.999421,32397.539849,22497.94016,-9899.59968899998,182966.911092461,118692.338701138,-64274.5723913233,13540.239764,0,-13540.239764,10509.277693,6886.211035,-3623.066658,30695.167746,25551.736112,-5143.431634,,,,7803.247906,10142.962428,2339.714522,44990.413691,39021.28964,-5969.124051,36625.710247,25771.867654,-10853.842593,1782.692079,1715.44113,-67.2509490000004,62481.427962,26908.502881,-35572.925081,168117.075741,113362.583299,-54754.4924419999,75857.28239,34860.87894,-40996.40345,1906.397282,2123.465264,217.067982,1057.576096,1849.974763,792.398667,1417.463429,954.580675,-462.882754000001,0.149627,0.168744,0.019117,21812.745282,20906.626391,-906.118890999998,0.003705,0,-0.003705,23177.668409,18114.663249,-5063.00516,300.313055,445.81678,145.503725,5.109274,21.113236,16.003962,198.563673,262.775681,64.212008,399.911248,365.994104,-33.917144,265.399387,98.141384,-167.258003,375.445965,425.372474,49.926509,24.33184,533.363403,509.031563,0.83629,32.496829,31.660539,20.86707,147.36871,126.50164,0,19.193397,19.193397,19.212276,117.590174,98.377898,0.80577,18.95346,18.14769,15.625601,59.257681,43.63208,81.273086,72.100218,-9.17286800000001,366.763954,525.364841,158.600887,0.320232,3.064195,2.743963,3.399624,13.966228,10.566604,4.191291,11.584382,7.393091,0.388707,19.099656,18.710949,0.026713,0.602886,0.576173,0.317472,2.871789,2.554317,1.430174,63.567844,62.13767,0.12688,8.49447,8.36759,0.516807,7.431315,6.914508,4.064578,40.449334,36.384756,276.4033,169.933326,-106.469974,,,,10.277347,77.14189,66.864543,21.94865,55.047031,33.098381,1.343373,72.653727,71.310354,0.257584,10.962757,10.705173,0.345256,12.866856,12.5216,1035.550307,1042.699474,7.14916700000003,555.84602,458.626773,-97.2192469999999,46.967523,33.301421,-13.666102,5.744661,22.909827,17.165166,0.076184,204.163425,204.087241,477.120763,342.702303,-134.41846,388.794272,636.867113,248.072841,94.630387,50.408109,-44.222278,864.16927,778.189996,-85.979274,1651.446747,1978.407073,326.960326,12.859663,96.151374,83.291711,39.062867,81.390426,42.327559,231.156654,702.471662,471.315008,0.006111,0.033394,0.027283,31.163611,29.420002,-1.743609,789.23308,327.517151,-461.715929,0,0,0,331.013991,406.380506,75.366515,341.393892,113.955355,-227.438537,10.280258,0.094846,-10.185412,583.571988,173.259855,-410.312133,4451.658957,4198.69125,-252.967707,3615.601688,1020.220519,-2595.381169,1273.248665,3369.879807,2096.631142,1311.005213,2764.992959,1453.987746,41.761531,134.285333,92.523802,0.202557,0.110546,-0.092011,1.93551,12.579546,10.644036,3864.807206,2362.014196,-1502.79301,8675.110336,4236.597923,-4438.512413,903.358242,506.37024,-396.988002,,,,356.373878,181.215724,-175.158154,109.173566,30.496022,-78.677544,344.988565,171.703699,-173.284866,23.236331,1.061917,-22.174414,2316.250019,1556.663237,-759.586782,81.871702,18.332532,-63.53917,22.109825,18.938503,-3.171322,129.818722,39.10321,-90.715512,471.192776,281.747444,-189.445332,,,,689.760686,375.955354,-313.805332,12.647371,3.095513,-9.551858,38.941713,85.109325,46.167612,3.271704,2.853575,-0.418129,29.980739,16.248233,-13.732506,4.919662,28.212572,23.29291,42.336296,40.873297,-1.462999,0.064894,1.391468,1.326574,1.717498,1.4088,-0.308698,0.010921,0.330908,0.319987,0.623886,1.506741,0.882855,0.898147,5.660704,4.762557,961.736822,848.151351,-113.585471,235.972054,58.050905,-177.921149,0.052277,0.112897,0.06062,8.490012,26.885949,18.395937,0.182686,0.038053,-0.144633,0.019204,0.003281,-0.015923,3415.339406,1448.889026,-1966.45038,,,,46.598044,19.373826,-27.224218,50.957204,14.692021,-36.265183,4.25015,1.253127,-2.997023,22.089627,1.319226,-20.770401,,,,20.502797,7.668396,-12.834401,0.051114,0.801238,0.750124,0.232397,0.39038,0.157983,2.419991,3.429357,1.009366,102.180265,61.647959,-40.532306,154.204149,46.831661,-107.372488,49.873245,20.58479,-29.288455,639.114361,689.954449,50.8400879999999,5.908816,3.51095,-2.397866,0.476324,0.249862,-0.226462,5.408007,90.098987,84.69098,177.137582,57.670795,-119.466787,2.474088,33.908588,31.4345,1057.06528,574.18897,-482.87631,0,0,0,0.227764,0.023409,-0.204355,110.464888,152.946859,42.481971,325.317562,172.294407,-153.023155,,,,903.266048,1987.727534,1084.461486,76.052664,668.960895,592.908231,241.212302,1994.670863,1753.458561,0.172929,29.634406,29.461477,37.100477,126.478875,89.378398,62.468916,65.999696,3.53078,1.501741,22.316077,20.814336,3660.904473,1526.261458,-2134.643015,266.822207,153.18076,-113.641447,7.048052,2.724572,-4.32348,546.230044,42.571979,-503.658065,251.973091,31.725952,-220.247139,18.340245,52.647763,34.307518,2204.041727,802.070625,-1401.971102,3447.996664,512.316388,-2935.680276,3.337038,1.659505,-1.677533,266.053065,34.719533,-231.333532,2661.869855,948.381388,-1713.488467,1230.703837,1903.038808,672.334971,1538.189783,421.153358,-1117.036425,0.461022,0.049916,-0.411106,1.178331,6.590369,5.412038,689.199107,604.991956,-84.2071510000001,4.132471,35.246123,31.113652,0.616832,0.086747,-0.530085,1.644022,2.446225,0.802203,36088.566927,8055.108258,-28033.458669,0.727155,6.933923,6.206768,0,0,0,5540.396719,3087.821897,-2452.574822,413.021124,3220.82885,2807.807726,2970.827298,1844.666403,-1126.160895,10309.317916,4969.531952,-5339.785964,715.997006,1585.422016,869.42501,0,0,0,0.458387,0.039392,-0.418995,0.224028,0.063419,-0.160609,0.001715,0,-0.001715,4.717697,12.371622,7.653925,313.309891,213.349881,-99.96001,0.082682,0.275187,0.192505,0.398473,0.006407,-0.392066,0.015897,0,-0.015897,0.427444,3.041798,2.614354,0.030227,0.589224,0.558997,0.33374,0.209215,-0.124525,0,0,0,0.587101,0.404814,-0.182287,,,,3.467256,6.750755,3.283499,0.023456,0.009187,-0.014269,3.415967,8.464381,5.048414,0.847669,5.593124,4.745455,0.077451,3.13853,3.061079,0.247174,1.791349,1.544175,0.057463,0.159684,0.102221,12.592969,6.80131,-5.791659,0.251027,1.231136,0.980109,65.815632,103.911387,38.095755,159.118666,285.714807,126.596141,34.945168,62.943385,27.998217,,,,98.629783,297.960969,199.331186,0.567637,5.800766,5.233129,0.001217,0.600386,0.599169,0.002959,0,-0.002959,0.495228,11.179339,10.684111,0.634011,6.931362,6.297351,16.812852,8.471271,-8.341581,2.53962,9.745881,7.206261,0.207848,2.600149,2.392301,0.593612,4.021916,3.428304,1.420576,3.45435,2.033774,185.715396,13.893168,-171.822228,35.117805,54.521637,19.403832,0.023517,3.524357,3.50084,0.118513,2.736498,2.617985,0.597109,5.520062,4.922953,295.588614,167.0041,-128.584514,0.01924,0.538391,0.519151,14.575089,9.218927,-5.356162,67.459321,3.33484,-64.124481,0.08095,0,-0.08095,0.17699,0.915774,0.738784,0.405948,24.916241,24.510293,181.299545,65.957183,-115.342362,3.367953,7.12493,3.756977,0.006383,0.131063,0.12468,0.154148,0.62109,0.466942,0.001913,0.026803,0.02489,3.988552,20.123407,16.134855,13.797549,5.603825,-8.193724,0.837853,0.148857,-0.688996,0.934028,3.259879,2.325851,0.003814,2.072453,2.068639,7.107397,10.914677,3.80728,0.012434,0.415309,0.402875,1.283074,5.474764,4.19169,4.157828,5.299471,1.141643,41.994518,35.525726,-6.468792,1.189106,0.529893,-0.659213,1.231976,0.24211,-0.989866,4.404078,13.259099,8.855021,29.163534,7.170703,-21.992831,2.145336,8.033743,5.888407,38.164742,2.048147,-36.116595,0.000555,0.010833,0.010278,2.058614,0.065484,-1.99313,0.12091,0.302361,0.181451,0.00067,0.930016,0.929346,396.917538,382.810198,-14.10734,9.840935,10.848715,1.00778,11.284807,3.109345,-8.175462,1.413686,17.715021,16.301335,0.446372,1.649952,1.20358,3.587402,2.102106,-1.485296,4.856118,0.976446,-3.879672,17.223731,0.096352,-17.127379,,,,,,
2016-03-01,6160.527247,6985.319015,824.791767999999,37552.507282,24522.357076,-13030.150206,174256.419643371,117603.632428636,-56652.7872147351,14385.749206,0,-14385.749206,11290.347234,7794.998634,-3495.3486,34868.690922,31512.425086,-3356.265836,,,,8771.475014,11917.002897,3145.527883,47941.211745,42526.292982,-5414.918763,43257.707379,29481.017879,-13776.6895,2079.320147,1665.055049,-414.265098,60666.360603,29091.004268,-31575.356335,178507.567081,125425.429958,-53082.1371229999,75270.503309,37673.106058,-37597.397251,2095.784016,2516.260423,420.476407,1186.917223,2162.752841,975.835618,1554.810611,1087.066504,-467.744107,0.412415,0.202252,-0.210163,23183.745781,23258.095864,74.3500829999975,0.019849,0,-0.019849,24757.465964,19268.197118,-5489.268846,367.964972,550.974291,183.009319,4.780927,26.8089,22.027973,213.362306,253.634428,40.272122,423.351669,417.032893,-6.31877600000001,282.735662,131.605683,-151.129979,392.050293,458.223065,66.172772,35.607385,514.949248,479.341863,2.385053,48.199339,45.814286,23.272449,163.292409,140.01996,0,10.630442,10.630442,25.417521,135.109134,109.691613,4.307736,22.082492,17.774756,11.237845,69.616532,58.378687,72.792792,110.431161,37.638369,416.319114,704.790063,288.470949,0.503393,3.411706,2.908313,0.355112,64.824358,64.469246,3.707536,12.655953,8.948417,0.38277,19.016364,18.633594,0.008204,1.521934,1.51373,0.115935,4.815811,4.699876,1.045824,59.236278,58.190454,0.113883,7.330966,7.217083,0.865616,8.086356,7.22074,3.861264,42.053098,38.191834,254.377567,409.192224,154.814657,,,,9.13753,75.827339,66.689809,24.427656,122.452068,98.024412,1.323459,74.174492,72.851033,0.349981,8.262276,7.912295,0.144467,7.012186,6.867719,1044.841513,1067.53216,22.6906469999999,714.077253,451.811015,-262.266238,41.842516,43.385815,1.543299,4.31741,25.269955,20.952545,0.002393,1.481439,1.479046,463.438232,308.988608,-154.449624,355.174586,647.353012,292.178426,92.735162,47.62865,-45.106512,902.496627,1631.703503,729.206876,2241.108321,2320.000348,78.8920269999999,11.931164,110.263363,98.332199,39.727568,80.547218,40.81965,283.472627,643.781322,360.308695,0.003721,0.003,-0.000721,30.85389,35.904123,5.050233,924.864977,343.087745,-581.777232,0.002257,0,-0.002257,409.250451,343.791222,-65.459229,390.257939,146.707192,-243.550747,9.082896,0.133922,-8.948974,728.16971,187.352224,-540.817486,4868.490521,5259.900946,391.410425,3338.408694,897.253652,-2441.155042,1275.366391,3497.268371,2221.90198,1556.013259,2810.731492,1254.718233,38.712845,292.806622,254.093777,0.459278,0.527495,0.068217,1.196057,3.649069,2.453012,4272.805377,2977.375441,-1295.429936,10770.541461,4418.169064,-6352.372397,941.591629,230.673938,-710.917691,,,,410.343304,164.253083,-246.090221,270.76668,25.915189,-244.851491,505.40865,163.433705,-341.974945,34.205113,1.59024,-32.614873,3151.548998,2462.868182,-688.680816,81.996705,22.38766,-59.609045,31.016651,18.801515,-12.215136,111.936493,43.871416,-68.065077,547.919791,336.868498,-211.051293,,,,1130.427357,728.74613,-401.681227,11.228554,4.133773,-7.094781,45.3142,97.845311,52.531111,1.978473,2.656475,0.678002,32.241829,21.848309,-10.39352,4.143438,28.631274,24.487836,55.727714,37.876316,-17.851398,0.07779,1.628801,1.551011,2.509737,2.992418,0.482681,0.003895,1.187514,1.183619,0.582327,6.645176,6.062849,1.214919,8.519315,7.304396,1134.58546,892.953362,-241.632098,233.801952,107.714067,-126.087885,0.004218,239.72644,239.722222,674.534864,17.995775,-656.539089,0.420202,0.118583,-0.301619,0.00925,0.236598,0.227348,3973.05003,1438.143192,-2534.906838,,,,44.202022,25.39244,-18.809582,71.127839,18.22037,-52.907469,5.56384,2.372209,-3.191631,25.868405,4.917751,-20.950654,,,,26.432656,14.840726,-11.59193,0.207104,1.125697,0.918593,0.108612,5.645704,5.537092,1.478094,3.198063,1.719969,104.747726,79.342306,-25.40542,193.279768,67.737489,-125.542279,46.995089,23.640399,-23.35469,723.058543,895.303967,172.245424,11.571455,14.359923,2.788468,0.581047,0.255446,-0.325601,9.726386,109.05041,99.324024,355.743632,128.746434,-226.997198,11.171603,6.81851,-4.353093,1068.337695,709.838414,-358.499281,0,0.02975,0.02975,0.340358,0.10622,-0.234138,127.008748,115.585109,-11.423639,186.253684,233.805143,47.551459,,,,1354.70979,1599.500467,244.790677,222.103774,1242.284501,1020.180727,404.856175,2129.422534,1724.566359,0.453702,9.746178,9.292476,69.427708,167.268015,97.840307,74.415028,82.222718,7.80768999999999,1.612984,88.497655,86.884671,3996.964777,1834.513748,-2162.451029,291.812541,204.138124,-87.674417,7.593919,8.525257,0.931338,531.832653,83.912931,-447.919722,264.053333,36.185294,-227.868039,15.147755,8.043615,-7.10414,2374.949066,889.387863,-1485.561203,3309.003056,601.862666,-2707.14039,6.560868,1.838355,-4.722513,212.372512,29.603228,-182.769284,3141.584912,1045.36546,-2096.219452,1742.825933,2136.215121,393.389188,1668.671309,550.314679,-1118.35663,0.002258,0.161372,0.159114,1.654731,9.235592,7.580861,916.957456,643.907187,-273.050269,5.435522,113.116933,107.681411,1.242044,0.217505,-1.024539,2.947069,2.424132,-0.522937,29838.281352,8913.40322,-20924.878132,1.135547,4.295361,3.159814,0,0,0,6436.579645,3489.858562,-2946.721083,689.035957,2701.887884,2012.851927,2980.884871,2002.130514,-978.754357,12085.645915,5374.393013,-6711.252902,783.660749,1857.06683,1073.406081,0,0,0,0.079735,0.00413,-0.075605,0.062072,0.172437,0.110365,0.000106,0.059011,0.058905,6.47772,12.86097,6.38325,368.664531,241.248303,-127.416228,0.061957,0.377745,0.315788,0.066802,0.017692,-0.04911,0.023001,0,-0.023001,0.316958,3.198522,2.881564,0.082349,0.373452,0.291103,0.919288,1.169769,0.250481,0.000137,0,-0.000137,0.295027,0.092557,-0.20247,,,,3.569035,8.428938,4.859903,0.000345,0.017521,0.017176,2.995649,9.412153,6.416504,1.499583,16.084519,14.584936,0.019991,4.316971,4.29698,0.003664,2.144309,2.140645,0.03276,0,-0.03276,17.867284,4.695493,-13.171791,0.206051,1.03797,0.831919,138.897435,152.347248,13.449813,232.725227,52.805752,-179.919475,39.904047,23.781053,-16.122994,,,,100.938784,342.603876,241.665092,1.043543,0.122214,-0.921329,0.000203,2.333705,2.333502,0.002605,0.018533,0.015928,26.544472,9.392269,-17.152203,0.339127,4.788154,4.449027,6.901085,24.085536,17.184451,3.960164,11.950614,7.99045,0.663551,3.601347,2.937796,0.462543,9.140283,8.67774,1.095854,6.40097,5.305116,115.602495,17.989359,-97.613136,32.915842,76.610202,43.69436,0.097906,5.223538,5.125632,0.342164,2.436698,2.094534,0.675321,11.790159,11.114838,340.498892,178.584816,-161.914076,0.466429,0.30496,-0.161469,13.826733,12.393571,-1.433162,64.430054,6.14259,-58.287464,4.081472,0,-4.081472,0.257653,2.927249,2.669596,0.060816,20.025177,19.964361,192.375113,84.976002,-107.399111,2.067099,7.252285,5.185186,0.002894,0.03735,0.034456,0.130717,0.142106,0.011389,0.157009,0.466622,0.309613,1.77226,12.277221,10.504961,4.35273,7.475478,3.122748,0.245338,0.188879,-0.056459,2.20598,1.423393,-0.782587,0.022768,3.05627,3.033502,11.946755,18.296524,6.349769,0.054734,0.966213,0.911479,0.998609,14.329783,13.331174,6.640333,6.623818,-0.0165150000000001,42.828506,41.680055,-1.14845099999999,0.0705,0.930887,0.860387,6.696216,0.312368,-6.383848,11.063934,11.461294,0.397360000000001,34.438964,3.993857,-30.445107,10.960322,9.85272,-1.107602,28.237107,1.353632,-26.883475,0.012969,0.012968,-0.000000999999999999265,0.001485,0.078076,0.076591,1.187124,0.518641,-0.668483,0.000112,0.131999,0.131887,530.635525,386.249838,-144.385687,1.97626,11.054244,9.077984,26.205575,3.327948,-22.877627,2.178082,6.587439,4.409357,0.421402,2.195857,1.774455,0.495179,1.912423,1.417244,4.38445,7.730736,3.346286,22.450879,0.058312,-22.392567,,,,,,
2016-04-01,5460.121109,5746.035621,285.914512000001,34999.447436,22995.074062,-12004.373374,177025.691934624,119179.288460944,-57846.4034736806,14157.468859,0,-14157.468859,10967.481895,8046.576137,-2920.905758,33349.981129,28478.670341,-4871.310788,,,,8191.694067,10911.054623,2719.360556,47308.99391,42649.603263,-4659.390647,40425.606586,27062.668168,-13362.938418,2337.801135,1841.968009,-495.833126,61668.417061,27049.013791,-34619.40327,174095.830281,118645.285127,-55450.5451539999,74614.36893,33963.023674,-40651.345256,1954.624397,2270.807912,316.183515,1216.700566,2216.688193,999.987627,1811.201528,1231.173101,-580.028427,0.659558,0.269716,-0.389842,22229.041561,23359.356468,1130.314907,0.005529,0.009481,0.003952,25079.952349,19290.246795,-5789.705554,345.534958,474.541609,129.006651,5.997124,22.186658,16.189534,204.637998,221.971685,17.333687,383.607767,394.184311,10.576544,260.454798,92.772728,-167.68207,364.889012,470.262729,105.373717,30.579646,513.359404,482.779758,1.435043,36.826626,35.391583,44.056153,190.886572,146.830419,0,18.737348,18.737348,24.816998,143.656758,118.83976,1.459373,29.240063,27.78069,10.743307,58.973816,48.230509,75.399208,71.74137,-3.657838,395.499864,617.07485,221.574986,0.339748,2.486223,2.146475,0.666497,12.666689,12.000192,5.92526,10.819939,4.894679,0.45273,21.090057,20.637327,0.02783,0.546623,0.518793,0.428574,3.704431,3.275857,0.826562,13.615033,12.788471,0.29052,8.172059,7.881539,1.535865,8.864379,7.328514,3.579477,41.748375,38.168898,232.980303,165.692849,-67.287454,,,,11.986265,51.995957,40.009692,18.766842,168.131526,149.364684,1.904865,57.963838,56.058973,0.169928,10.691631,10.521703,1.413295,10.472295,9.059,1078.461595,1159.219624,80.7580290000001,800.706351,439.430415,-361.275936,31.303896,33.180017,1.876121,5.144976,24.863211,19.718235,0.000252,232.769029,232.768777,438.673035,288.557047,-150.115988,357.260003,644.020176,286.760173,98.896569,48.61239,-50.284179,743.859707,884.517606,140.657899,1870.983097,2244.91274,373.929643,10.724279,166.775008,156.050729,40.063378,91.13923,51.075852,285.171028,707.968154,422.797126,0.040091,0.011545,-0.028546,28.982459,38.968613,9.986154,833.400157,362.142604,-471.257553,0.046739,0,-0.046739,398.09339,223.815355,-174.278035,340.246228,146.006255,-194.239973,9.898737,0.221556,-9.677181,661.713338,194.21001,-467.503328,4439.821729,5036.504903,596.683174,3783.486895,824.132071,-2959.354824,1226.244704,3476.91405,2250.669346,1497.427637,2736.899115,1239.471478,42.653872,50.915069,8.261197,0.086018,0.228854,0.142836,1.718058,4.595993,2.877935,4297.01615,2784.696276,-1512.319874,9858.138167,4020.995416,-5837.142751,923.81634,227.062696,-696.753644,,,,375.757111,186.590003,-189.167108,203.148697,26.696042,-176.452655,389.079377,132.302643,-256.776734,24.00552,1.882337,-22.123183,2958.145323,1866.529859,-1091.615464,82.065324,21.550701,-60.514623,25.0679,16.394785,-8.673115,119.97594,36.849115,-83.126825,500.353919,328.961021,-171.392898,,,,1225.722832,465.703906,-760.018926,6.296266,2.195198,-4.101068,53.130313,75.068431,21.938118,2.491528,3.060403,0.568875,0.229261,14.18324,13.953979,7.274296,42.00522,34.730924,33.97532,224.139261,190.163941,0.017041,1.464158,1.447117,2.910059,0.773311,-2.136748,0.19643,0.50704,0.31061,1.080628,3.067658,1.98703,1.104938,3.655938,2.551,1049.673386,708.229185,-341.444201,248.259328,86.159763,-162.099565,0.047307,187.378637,187.33133,10.431362,18.774122,8.34276,0.38724,0.167429,-0.219811,0.207595,0,-0.207595,3668.147086,1344.246446,-2323.90064,,,,50.000337,23.149515,-26.850822,61.142404,16.430273,-44.712131,5.656128,2.305133,-3.350995,9.909653,5.889214,-4.020439,,,,21.780163,9.382491,-12.397672,0.189276,3.969312,3.780036,0.22627,1.359962,1.133692,2.09549,3.444828,1.349338,107.34361,67.128784,-40.214826,152.575695,68.306089,-84.269606,48.966743,27.660389,-21.306354,630.254872,881.630769,251.375897,3.494,25.166721,21.672721,1.055309,0.39454,-0.660769,9.846318,102.14588,92.299562,305.229246,104.868972,-200.360274,7.115269,6.457957,-0.657311999999999,893.227843,522.125617,-371.102226,0.00001,0,-0.00001,0.337818,0.119818,-0.218,108.902393,108.518687,-0.383706000000004,212.580392,193.227522,-19.35287,,,,1084.446117,1368.941876,284.495759,74.990318,495.70267,420.712352,231.333687,1827.452374,1596.118687,0.254653,8.529788,8.275135,149.874111,125.022256,-24.851855,87.712029,71.716239,-15.99579,5.462302,48.137822,42.67552,3678.330066,1772.694885,-1905.635181,264.124604,156.051719,-108.072885,6.903763,2.53299,-4.370773,457.662176,92.680625,-364.981551,235.515822,23.098797,-212.417025,19.419545,10.696541,-8.723004,2250.380858,789.87545,-1460.505408,2995.568206,755.204454,-2240.363752,3.881192,1.307806,-2.573386,216.182756,31.810378,-184.372378,3051.89208,981.905314,-2069.986766,1469.33096,2232.894301,763.563341,1451.081521,477.738935,-973.342586,0.018037,0.114728,0.096691,3.109772,8.559362,5.44959,845.882253,636.974799,-208.907454,12.504947,41.982477,29.47753,0.324508,0.120496,-0.204012,2.415747,2.082653,-0.333094,32945.839032,8670.550935,-24275.288097,1.543546,6.713734,5.170188,0,0,0,6244.545908,2956.744275,-3287.801633,535.856492,2213.939662,1678.08317,3051.293825,1962.381372,-1088.912453,10857.201432,4691.26372,-6165.937712,849.69497,1925.858051,1076.163081,0.01629,0,-0.01629,0.00344,0.082898,0.079458,0.105196,0.378177,0.272981,0,0.003394,0.003394,5.999961,6.862191,0.86223,344.183908,241.358397,-102.825511,0.032516,0.350795,0.318279,0.010176,0.090293,0.080117,0.007707,0,-0.007707,0.37011,1.908169,1.538059,0.052586,0.405895,0.353309,0.303837,1.379536,1.075699,0.000268,0,-0.000268,0.121926,0.090936,-0.03099,,,,1.927008,5.990566,4.063558,0.005009,0.103909,0.0989,3.891498,8.15828,4.266782,1.029491,10.480833,9.451342,0.04425,4.480687,4.436437,0.002286,3.537133,3.534847,0.00413,0.004859,0.000729,8.72756,4.304482,-4.423078,0.170404,0.886472,0.716068,97.092156,106.64919,9.557034,222.696807,138.178998,-84.517809,35.548067,26.085336,-9.462731,,,,149.538855,318.539229,169.000374,1.326029,13.116125,11.790096,0.001961,0.419897,0.417936,0,0,0,23.1302,10.354355,-12.775845,0.003953,8.126678,8.122725,8.342482,9.017632,0.67515,2.666888,10.67184,8.004952,0.265,4.405433,4.140433,0.424431,4.962697,4.538266,0.818121,7.238803,6.420682,121.458208,73.875379,-47.582829,44.898851,55.041299,10.142448,0.048765,4.134643,4.085878,0.561952,1.769185,1.207233,0.821481,38.394222,37.572741,379.199714,153.473621,-225.726093,0.008055,1.474005,1.46595,4.652977,5.994139,1.341162,104.678101,1.006036,-103.672065,4.422263,0.042453,-4.37981,0.599549,2.6759,2.076351,0.272526,15.06564,14.793114,232.977022,226.418833,-6.558189,1.546616,9.146478,7.599862,0.002076,1.867568,1.865492,0.055893,0.165343,0.10945,0.006047,0.417327,0.41128,5.260432,8.565961,3.305529,21.829965,4.575865,-17.2541,0.810975,0.07132,-0.739655,4.485318,2.775555,-1.709763,0.208885,7.417369,7.208484,11.223083,139.354589,128.131506,0.254707,0.36345,0.108743,3.895797,6.301821,2.406024,4.871767,5.402496,0.530729,54.798574,24.62672,-30.171854,0.578251,0.899849,0.321598,1.906767,0.453989,-1.452778,8.925908,13.19494,4.269032,25.061442,24.498106,-0.563336,6.435045,7.93414,1.499095,32.001941,4.199478,-27.802463,0.002011,0.019306,0.017295,0.01747,0.029673,0.012203,0.952789,0.986606,0.033817,0.000936,0.104137,0.103201,597.243112,365.158787,-232.084325,14.996898,24.94411,9.947212,53.65118,7.864034,-45.787146,1.625635,3.362096,1.736461,0.353479,1.970168,1.616689,0.85888,1.841232,0.982352,4.031337,4.271993,0.240656,20.940963,0.020992,-20.919971,,,,,,
2016-05-01,6269.647326,5595.653757,-673.993569,35528.700937,22047.92265,-13480.778287,180263.111803738,119467.254419108,-60795.8573846303,14305.780563,0,-14305.780563,10975.080262,8016.508877,-2958.571385,34722.395115,27877.381032,-6845.014083,,,,8692.736674,11611.213296,2918.476622,47868.475755,42063.32466,-5805.151095,41990.084552,26599.719273,-15390.365279,2146.705918,1872.472072,-274.233846,66543.211811,28531.19254,-38012.019271,183512.493842,119624.617656,-63887.8761860002,81431.036035,35271.895868,-46159.140167,2121.553418,2504.948905,383.395487,1383.161825,2205.758854,822.597029000001,1695.645245,1023.760128,-671.885117,0.179315,0.233633,0.054318,23033.176959,23080.184849,47.0078900000008,0.113768,0,-0.113768,24835.298796,18983.139811,-5852.158985,364.924872,555.324485,190.399613,5.367498,17.64748,12.279982,227.514493,257.87859,30.364097,412.625709,426.328377,13.702668,298.239172,158.905965,-139.333207,405.00457,511.299527,106.294957,36.170208,482.744643,446.574435,2.405889,45.842894,43.437005,24.982749,216.165804,191.183055,0,20.817792,20.817792,20.138384,143.614683,123.476299,0.867208,24.402022,23.534814,9.063831,81.60012,72.536289,84.615558,99.259736,14.644178,413.244602,595.211961,181.967359,0.292341,2.013411,1.72107,0.427695,19.614114,19.186419,4.366585,9.198852,4.832267,0.353069,26.121384,25.768315,0.009869,0.895486,0.885617,0.153068,3.045381,2.892313,0.866148,23.379441,22.513293,0.172962,5.945227,5.772265,1.41875,7.025058,5.606308,3.564358,34.236363,30.672005,227.709865,217.995904,-9.71396100000001,,,,5.344226,38.282504,32.938278,17.548463,134.782967,117.234504,0.84489,51.014245,50.169355,0.288468,10.662717,10.374249,3.672178,7.118363,3.446185,1083.835182,990.957301,-92.877881,792.246645,504.717234,-287.529411,48.605474,32.665034,-15.94044,10.129113,27.477975,17.348862,0.079191,97.567257,97.488066,479.006526,344.456789,-134.549737,497.321938,626.22519,128.903252,94.89412,43.640092,-51.254028,630.943565,1065.073087,434.129522,2048.647377,2615.483791,566.836414,12.283011,140.702679,128.419668,47.316541,81.127275,33.810734,368.964073,812.740983,443.77691,6.26624,0.003113,-6.263127,30.58164,74.790143,44.208503,817.658023,393.962059,-423.695964,0.002488,0.009496,0.007008,329.12301,328.439463,-0.683547000000033,363.780617,131.95204,-231.828577,12.452632,0.155504,-12.297128,651.00205,298.534403,-352.467647,4523.38581,4246.963336,-276.422474,3992.539996,877.081717,-3115.458279,1382.690688,3231.954607,1849.263919,1670.215568,2734.100379,1063.884811,48.859708,106.04189,57.182182,0.563012,0.160834,-0.402178,5.035382,9.209827,4.174445,3426.440327,2453.387495,-973.052832,9764.489124,4073.894304,-5690.59482,972.78442,180.834585,-791.949835,,,,386.011756,173.173119,-212.838637,245.080655,23.566424,-221.514231,474.128781,173.299337,-300.829444,26.981619,1.398562,-25.583057,4033.914266,1897.795731,-2136.118535,104.436447,19.282807,-85.15364,26.974129,15.784516,-11.189613,122.761404,33.346476,-89.414928,506.700366,284.66612,-222.034246,,,,1097.666503,494.69103,-602.975473,6.07533,5.450166,-0.625164,47.086296,72.052231,24.965935,4.624783,6.086841,1.462058,0.601299,13.468057,12.866758,3.853341,23.928363,20.075022,99.45686,130.408944,30.952084,0.147321,1.697111,1.54979,4.236661,0.962844,-3.273817,0.070759,1.647785,1.577026,0.775074,5.024524,4.24945,20.705775,3.489269,-17.216506,1212.686517,824.813385,-387.873132,330.778837,89.756652,-241.022185,0.031119,284.448628,284.417509,82.329367,17.107505,-65.221862,0.430076,0.037389,-0.392687,0.027771,0,-0.027771,4023.667705,1409.123172,-2614.544533,,,,40.935307,30.173881,-10.761426,68.33696,67.942878,-0.394082000000012,8.204344,1.968517,-6.235827,17.198846,3.946901,-13.251945,,,,24.348174,9.32261,-15.025564,0.13401,1.511934,1.377924,0.428866,4.288405,3.859539,11.382911,9.525669,-1.857242,85.778565,49.154597,-36.623968,149.485867,81.186949,-68.298918,52.873336,21.876001,-30.997335,675.243447,1165.879845,490.636398,1.888607,4.962016,3.073409,0.49998,0.024375,-0.475605,11.892312,61.136636,49.244324,563.401826,101.109845,-462.291981,7.176485,8.271986,1.095501,1086.33087,511.285086,-575.045784,0,0,0,0.331,0.095861,-0.235139,107.970862,93.008853,-14.962009,193.032564,238.240431,45.207867,,,,1467.887711,1174.586818,-293.300893,92.62706,536.107769,443.480709,234.853368,1720.129158,1485.27579,0.182382,51.251981,51.069599,127.610302,186.399135,58.788833,78.872276,75.41265,-3.459626,1.590999,116.858439,115.26744,4124.94596,1585.916826,-2539.029134,296.0386,157.757004,-138.281596,7.286994,3.198664,-4.08833,458.833852,88.102922,-370.73093,227.565917,32.274869,-195.291048,19.101473,8.111948,-10.989525,2452.187448,855.942852,-1596.244596,3250.965492,716.023733,-2534.941759,6.505295,2.517491,-3.987804,208.564153,31.296593,-177.26756,3161.899674,966.955942,-2194.943732,1844.995273,2273.430462,428.435189,1609.327162,420.752099,-1188.575063,0.105952,0.171133,0.065181,1.138455,5.415244,4.276789,806.825972,632.870895,-173.955077,8.748538,40.018233,31.269695,0.661046,0.099704,-0.561342,1.672175,1.758889,0.086714,37530.479866,8537.250073,-28993.229793,0.491227,7.258228,6.767001,0,0.00265,0.00265,6189.522858,3674.898225,-2514.624633,813.749241,2424.670573,1610.921332,3344.557189,2186.489468,-1158.067721,9882.309309,5223.71594,-4658.593369,958.666385,1875.005811,916.339426,0,0,0,0.016873,0.01111,-0.005763,0.225762,0.109053,-0.116709,0,0,0,8.651122,7.654296,-0.996826,382.340767,262.065279,-120.275488,0.213268,0.635787,0.422519,0.013146,0.202841,0.189695,0.008776,0,-0.008776,0.566962,2.450875,1.883913,0.045173,0.512611,0.467438,0.923912,0.32645,-0.597462,0.001794,0,-0.001794,0.114393,0.132874,0.018481,,,,4.449278,3.100946,-1.348332,0.019874,0,-0.019874,3.067266,7.93146,4.864194,8.794266,32.397663,23.603397,0.03592,4.106623,4.070703,0.011525,2.547278,2.535753,0.035563,0.086756,0.051193,14.739001,5.155372,-9.583629,0.234336,1.191933,0.957597,50.911185,85.334035,34.42285,187.465912,330.742076,143.276164,37.179646,52.274132,15.094486,,,,138.82178,267.017246,128.195466,1.101883,9.256043,8.15416,0,0.186939,0.186939,0.000372,0,-0.000372,32.981788,3.230273,-29.751515,0.018537,6.62025,6.601713,15.41095,8.577729,-6.833221,8.048688,10.920266,2.871578,0.374638,2.726714,2.352076,0.240549,7.246114,7.005565,10.434312,6.631364,-3.802948,47.59134,13.691992,-33.899348,17.840868,78.466307,60.625439,0.130646,2.470355,2.339709,1.835178,6.21391,4.378732,1.086122,6.957079,5.870957,327.281993,140.96567,-186.316323,0.048111,0.215659,0.167548,1.828462,13.01636,11.187898,63.744285,0.372242,-63.372043,0.097922,0.35812,0.260198,0.323914,1.343199,1.019285,0.145565,20.015737,19.870172,278.02161,40.956921,-237.064689,13.796792,24.681377,10.884585,0.002281,0.437085,0.434804,0.332728,0.506469,0.173741,0.01951,0.052538,0.033028,2.010854,7.820212,5.809358,6.325674,5.250847,-1.074827,0.330155,0.189822,-0.140333,0.359373,0.932642,0.573269,0.176426,3.517803,3.341377,14.412256,7.365134,-7.047122,0.050437,0.033249,-0.017188,5.302543,17.388051,12.085508,4.002218,7.541667,3.539449,34.035032,24.610987,-9.424045,0.09558,0.719848,0.624268,0.646776,0.562822,-0.083954,43.010604,10.135531,-32.875073,26.573883,2.987781,-23.586102,8.836472,31.872984,23.036512,39.772985,2.511892,-37.261093,0,0.019641,0.019641,0.018439,0.109076,0.090637,0.388102,90.546603,90.158501,0.058315,0.276309,0.217994,607.592482,382.18575,-225.406732,13.103227,32.48984,19.386613,25.647766,2.63148,-23.016286,3.517583,4.777464,1.259881,0.452781,1.975579,1.522798,0.905919,1.813495,0.907576,3.576672,3.652387,0.0757150000000002,21.714532,0.057124,-21.657408,,,,,,
2016-06-01,7020.23784,5522.963473,-1497.274367,36700.813459,23870.898267,-12829.915192,184096.979333917,120392.362566471,-63704.6167674456,14430.148211,0,-14430.148211,11444.957817,8458.706344,-2986.251473,38401.522939,31075.044491,-7326.478448,,,,9464.201095,11680.996915,2216.79582,49125.009094,43677.253137,-5447.75595699999,43046.823849,28173.441475,-14873.382374,2338.002469,1813.866108,-524.136361,68583.213922,29824.118762,-38759.09516,188707.616308,125097.629231,-63609.987077,83502.716852,37498.348222,-46004.36863,2099.127573,2411.949713,312.82214,1230.220749,2253.444787,1023.224038,1763.258544,1166.788946,-596.469598,0.6422,0.278587,-0.363613,24233.097433,24257.726902,24.6294689999995,0,0,0,24891.911661,19419.526235,-5472.385426,323.580895,473.285346,149.704451,6.151998,18.986411,12.834413,219.699921,237.147149,17.447228,437.921683,399.692448,-38.229235,306.638972,172.40938,-134.229592,389.60949,488.955546,99.346056,41.220845,654.654437,613.433592,4.037534,165.143195,161.105661,26.199957,147.637,121.437043,0,11.733127,11.733127,22.656115,130.241663,107.585548,0.483524,21.983447,21.499923,6.647611,61.227776,54.580165,77.428895,106.801582,29.372687,421.676612,640.459844,218.783232,0.093487,2.961297,2.86781,0.467714,45.366859,44.899145,3.585434,10.078035,6.492601,1.857864,29.558199,27.700335,0.250651,0.762569,0.511918,0.170005,3.817392,3.647387,0.840867,18.420235,17.579368,0.123889,9.315663,9.191774,2.217694,7.415942,5.198248,4.561798,45.686579,41.124781,216.084014,165.926178,-50.157836,,,,3.654437,46.230351,42.575914,19.984168,58.131963,38.147795,1.045273,43.292262,42.246989,0.598502,11.361118,10.762616,1.757135,12.522951,10.765816,1427.754939,981.033907,-446.721032,1004.883813,345.995595,-658.888218,41.421814,30.417141,-11.004673,3.479182,23.938978,20.459796,0.03296,3.650929,3.617969,522.908594,342.276402,-180.632192,506.461437,698.389102,191.927665,95.167548,77.608199,-17.559349,666.434273,1490.646264,824.211991,2196.71202,2459.943685,263.231665,13.412694,138.32216,124.909466,47.431706,88.745617,41.313911,394.545884,758.822992,364.277108,2.307247,0,-2.307247,33.921734,31.076164,-2.84557,887.812647,310.763348,-577.049299,0,0,0,391.601031,299.370623,-92.230408,423.85251,102.941193,-320.911317,13.844414,0.606145,-13.238269,659.821527,181.158683,-478.662844,4921.750182,5020.686969,98.9367870000005,4022.553019,663.537498,-3359.015521,1421.228871,3798.096581,2376.86771,1742.975789,3351.343435,1608.367646,50.039035,105.514403,55.475368,0.223404,0.187663,-0.035741,3.441775,3.325905,-0.11587,4207.291311,2555.183152,-1652.108159,9412.766659,3956.703652,-5456.063007,921.215086,266.873076,-654.34201,,,,387.215257,181.473236,-205.742021,235.655015,20.860378,-214.794637,489.260871,135.502829,-353.758042,22.012615,5.210027,-16.802588,3393.536348,2098.160932,-1295.375416,121.484079,16.910301,-104.573778,39.535109,22.153612,-17.381497,131.35069,34.586701,-96.763989,506.645885,292.481536,-214.164349,,,,1500.39228,376.01077,-1124.38151,4.226197,8.014325,3.788128,40.3276,70.804109,30.476509,3.435536,4.270731,0.835195,0.276516,28.657839,28.381323,22.910523,20.191296,-2.719227,119.275447,64.10187,-55.173577,0.040965,1.987265,1.9463,4.337701,0.557669,-3.780032,0.01696,10.091874,10.074914,1.092253,2.270779,1.178526,0.55984,5.63663,5.07679,1443.831146,1073.798709,-370.032437,302.48653,92.153735,-210.332795,0.011334,134.988692,134.977358,77.006865,59.937587,-17.069278,0.739169,0.325573,-0.413596,0.087227,0,-0.087227,3880.402719,1444.287169,-2436.11555,,,,42.792903,30.306956,-12.485947,65.809102,15.978784,-49.830318,7.225939,1.198835,-6.027104,14.536969,1.106646,-13.430323,,,,29.825676,17.140753,-12.684923,0.10821,1.457118,1.348908,0.312775,1.186423,0.873648,22.386733,5.58927,-16.797463,92.760274,45.966681,-46.793593,161.679094,63.174346,-98.504748,47.586912,21.0421,-26.544812,715.303219,1109.017282,393.714063,4.004372,7.481617,3.477245,0.47152,0.03836,-0.43316,6.951547,90.931014,83.979467,462.095798,155.802528,-306.29327,9.345217,6.201131,-3.144086,939.331602,550.705522,-388.62608,0,0.068091,0.068091,0.511157,0.029695,-0.481462,110.390475,99.342135,-11.04834,374.948051,323.728328,-51.219723,,,,1604.444929,1055.967759,-548.47717,86.913871,525.846564,438.932693,305.997349,1892.403142,1586.405793,0.143395,14.36747,14.224075,138.164036,137.943784,-0.220252000000016,64.056899,81.442627,17.385728,2.231922,54.868991,52.637069,3536.393437,1744.887812,-1791.505625,317.937767,190.834915,-127.102852,6.422441,4.413812,-2.008629,509.131329,96.303936,-412.827393,198.865561,26.986617,-171.878944,15.798551,8.244994,-7.553557,2469.157152,802.681081,-1666.476071,3955.070455,931.613197,-3023.457258,4.070946,1.833575,-2.237371,216.989016,32.195869,-184.793147,3296.131083,1016.837801,-2279.293282,1832.728111,2222.642467,389.914356,1662.009667,465.5634,-1196.446267,0.022657,0.017789,-0.004868,0.698008,5.818205,5.120197,836.082523,646.082736,-189.999787,10.971427,34.75323,23.781803,0.374494,0.412518,0.038024,0.996982,3.979047,2.982065,38556.162955,8838.335513,-29717.827442,1.126424,3.399395,2.272971,0,0,0,6201.284257,3681.21341,-2520.070847,576.306102,3294.692922,2718.38682,3391.618984,2245.034119,-1146.584865,11029.426258,5161.389229,-5868.037029,757.010687,1972.235945,1215.225258,0.014389,0,-0.014389,0.223084,0.013872,-0.209212,0.06726,0.213987,0.146727,0,0.012249,0.012249,4.720517,3.909828,-0.810689,428.063343,235.609957,-192.453386,0.250275,0.567847,0.317572,0.282065,0.059226,-0.222839,0.771623,0.015433,-0.75619,0.733342,2.193055,1.459713,0.064533,0.4303,0.365767,0.282212,0.250028,-0.032184,0.001854,0.00059,-0.001264,0.431825,0.095748,-0.336077,,,,3.656283,3.478944,-0.177339,0.001025,0.039644,0.038619,2.231586,6.648861,4.417275,15.139484,17.925603,2.786119,0.034381,3.422428,3.388047,0.096015,1.44541,1.349395,0.275947,0.062339,-0.213608,15.623111,3.707797,-11.915314,0.239287,1.104025,0.864738,57.908226,93.781397,35.873171,279.04976,155.143991,-123.905769,33.437268,55.550405,22.113137,,,,138.223848,329.950845,191.726997,0.271324,3.576976,3.305652,0.005991,3.068289,3.062298,0.002005,0.028935,0.02693,15.620324,9.94564,-5.674684,22.700333,4.36013,-18.340203,13.651531,13.871201,0.219669999999999,3.325611,9.979479,6.653868,0.18766,4.715699,4.528039,0.565582,10.048075,9.482493,0.57419,4.690305,4.116115,53.361507,16.246061,-37.115446,32.944813,53.142733,20.19792,0.188653,2.343475,2.154822,0.260028,2.354982,2.094954,0.299077,25.185697,24.88662,458.424901,183.296066,-275.128835,0.048711,1.247804,1.199093,8.091654,4.033275,-4.058379,136.32363,2.269241,-134.054389,0.353007,0,-0.353007,0.367749,3.818711,3.450962,0.804987,19.653889,18.848902,176.995748,55.435792,-121.559956,23.674297,14.941838,-8.732459,0.000004,0.122046,0.122042,0.095976,0.120856,0.02488,0.01126,0.035661,0.024401,4.854487,8.483271,3.628784,6.718302,5.450675,-1.267627,0.000908,0.053806,0.052898,0.567686,2.249587,1.681901,0.00005,4.720223,4.720173,15.841794,9.448012,-6.393782,0.032393,0.119244,0.086851,1.69589,11.350196,9.654306,5.150907,5.334453,0.183546,42.92165,44.287841,1.366191,0.067922,1.241373,1.173451,0.915459,0.353179,-0.56228,10.26428,29.86305,19.59877,25.767399,2.029399,-23.738,10.189828,10.646078,0.456249999999999,38.448896,3.687975,-34.760921,0.00101,0.051266,0.050256,0.02959,0.197076,0.167486,0.725426,0.606101,-0.119325,0.000024,0.368055,0.368031,582.374157,402.994139,-179.380018,4.086274,40.990912,36.904638,15.823679,4.035077,-11.788602,2.013509,10.956211,8.942702,0.558276,1.832896,1.27462,3.216289,2.237814,-0.978475,4.434632,5.670589,1.235957,28.93899,0.095588,-28.843402,,,,,,
2016-07-01,7127.317827,5535.720381,-1591.597446,33886.989192,21480.205322,-12406.78387,183125.227806091,122011.273083197,-61113.9547228936,13211.651986,0,-13211.651986,9696.477521,7090.423122,-2606.054399,34759.771652,27980.800345,-6778.971307,,,,9149.912317,11320.197612,2170.285295,44663.212208,39171.250523,-5491.961685,40282.910835,25170.160407,-15112.750428,2310.625445,1999.936901,-310.688544,68896.473766,28902.326836,-39994.14693,181890.155237,115810.281952,-66079.873285,84225.028208,35688.966947,-48536.061261,1975.016736,2356.858713,381.841977,1257.659282,2459.31757,1201.658288,1729.236452,1232.300862,-496.93559,0.806224,0.390673,-0.415551,21641.583885,20925.237673,-716.346212,0.000718,0.02121,0.020492,23021.628323,18246.01285,-4775.615473,315.441508,464.748419,149.306911,4.528926,22.506886,17.97796,240.5735,233.270767,-7.30273299999999,408.972487,398.204367,-10.76812,277.671442,120.272531,-157.398911,331.060571,489.999776,158.939205,43.803384,506.376355,462.572971,2.326595,49.210529,46.883934,16.355617,171.157525,154.801908,0,21.249182,21.249182,35.149701,164.232888,129.083187,0.680486,30.794329,30.113843,12.068276,52.358387,40.290111,82.245204,89.888083,7.64287899999999,401.297228,650.362853,249.065625,0.249173,3.263184,3.014011,1.443508,14.750432,13.306924,4.296155,10.368297,6.072142,0.499839,12.754092,12.254253,0.009098,0.520915,0.511817,0.384139,4.676723,4.292584,0.773799,43.561551,42.787752,0.272524,5.304997,5.032473,1.361275,6.261074,4.899799,2.941142,32.174482,29.23334,197.51578,162.734186,-34.781594,,,,4.080954,35.218068,31.137114,20.709023,28.753363,8.04434,0.763279,62.998795,62.235516,0.073628,9.599566,9.525938,1.740917,13.784514,12.043597,1210.629879,1049.990781,-160.639098,1122.912443,549.042614,-573.869829,38.821352,23.120751,-15.700601,5.27697,23.605014,18.328044,0.025067,94.990935,94.965868,485.548489,349.414419,-136.13407,511.537159,601.502937,89.965778,108.987262,60.751459,-48.235803,697.338718,1062.534675,365.195957,2109.400846,2590.762746,481.3619,11.568503,219.051965,207.483462,45.445936,109.849907,64.403971,388.654529,674.200893,285.546364,4.476006,0.0214,-4.454606,26.902989,51.058519,24.15553,742.043616,284.837817,-457.205799,0.011124,0.036893,0.025769,442.418306,363.361868,-79.056438,432.73732,105.787506,-326.949814,12.493901,0.179779,-12.314122,731.750688,162.573338,-569.17735,4155.557258,4545.801043,390.243785000001,3410.166604,583.265975,-2826.900629,1372.641854,3119.955467,1747.313613,1429.118233,2537.453683,1108.33545,45.68112,69.184609,23.503489,1.717816,0.185697,-1.532119,2.421573,16.822736,14.401163,3922.111854,2850.785525,-1071.326329,9382.727198,4000.729185,-5381.998013,877.122735,189.805123,-687.317612,,,,358.605713,129.463171,-229.142542,213.403662,23.279826,-190.123836,374.287498,147.904871,-226.382627,22.949171,1.620281,-21.32889,3588.658932,1818.575319,-1770.083613,63.657818,21.55507,-42.102748,27.353128,21.058392,-6.294736,68.754905,32.925675,-35.82923,523.798065,281.378411,-242.419654,,,,1334.824135,414.971137,-919.852998,13.298219,6.779917,-6.518302,50.915405,127.343614,76.428209,3.514337,2.929249,-0.585088,29.262874,23.390045,-5.872829,4.443821,24.963859,20.520038,59.146599,32.706557,-26.440042,0.082842,1.492774,1.409932,4.0318,0.638524,-3.393276,0.001756,0.37424,0.372484,1.021677,2.76584,1.744163,0.64392,4.580078,3.936158,1201.109222,712.493012,-488.61621,312.847191,72.986725,-239.860466,0.024248,151.008737,150.984489,241.613541,4.826193,-236.787348,1.067272,0.155859,-0.911413,0.146527,0.009028,-0.137499,3562.823817,1396.337521,-2166.486296,,,,44.69016,17.588703,-27.101457,69.453334,39.324986,-30.128348,6.558216,6.274727,-0.283488999999999,18.230039,6.032762,-12.197277,,,,34.15163,10.223331,-23.928299,0.209234,1.712267,1.503033,0.092877,1.007808,0.914931,22.231965,3.84863,-18.383335,112.094488,51.030591,-61.063897,152.308791,48.908613,-103.400178,53.747027,23.058323,-30.688704,714.448438,614.90501,-99.5434280000001,4.782352,5.905968,1.123616,0.302316,0.062153,-0.240163,6.43118,139.44882,133.01764,680.233521,93.456354,-586.777167,4.78223,25.861737,21.079507,1214.169727,523.099105,-691.070622,0.000226,0.043614,0.043388,1.006805,0.275328,-0.731477,159.669486,101.826821,-57.842665,270.82924,190.888001,-79.941239,,,,1397.457325,1023.102872,-374.354453,84.851944,307.844227,222.992283,274.211645,2175.051025,1900.83938,0.15316,19.855137,19.701977,120.080304,137.772122,17.691818,68.485128,62.944466,-5.540662,2.471156,66.383863,63.912707,3803.946495,1624.17302,-2179.773475,296.597183,197.458017,-99.139166,7.370844,2.483661,-4.887183,551.032657,38.703023,-512.329634,225.705368,25.459567,-200.245801,20.349957,12.117704,-8.232253,2572.413233,820.382518,-1752.030715,3533.032297,1075.508106,-2457.524191,4.887331,2.915784,-1.971547,258.408385,27.48049,-230.927895,3056.87266,967.55973,-2089.31293,1431.274809,2176.817791,745.542982,1757.825254,426.886912,-1330.938342,0.047144,0.044397,-0.002747,1.058135,4.820823,3.762688,899.232371,690.989064,-208.243307,12.988927,35.622992,22.634065,0.002137,0.117881,0.115744,0.611526,1.321084,0.709558,39461.764017,9125.304833,-30336.459184,0.924358,5.498001,4.573643,0,0,0,5895.401044,3508.070874,-2387.33017,682.615715,2325.032311,1642.416596,3224.520328,2066.404303,-1158.116025,11247.597002,5167.53283,-6080.064172,817.220158,1957.757499,1140.537341,0.242686,0,-0.242686,0.05222,0.348814,0.296594,0.227589,0.106909,-0.12068,0,0,0,7.680395,4.026136,-3.654259,400.422951,445.500738,45.077787,0.38201,0.340275,-0.041735,0.02283,0.043663,0.020833,0.021027,0,-0.021027,0.442153,2.38362,1.941467,0.436932,2.488432,2.0515,0.803349,0.545409,-0.25794,0,0,0,0.162881,0.096844,-0.066037,,,,1.460007,6.281477,4.82147,0,0,0,3.092718,8.053185,4.960467,0.916252,21.948657,21.032405,0.062016,2.578884,2.516868,0.092721,2.392143,2.299422,0.01397,0.006342,-0.007628,23.57286,3.065281,-20.507579,0.317147,1.282347,0.9652,88.062648,314.27175,226.209102,267.634055,167.080569,-100.553486,39.39646,39.903927,0.507467000000005,,,,176.223807,218.941263,42.717456,0.38808,0.807266,0.419186,0.026458,0.366515,0.340057,0.03551,0,-0.03551,22.291639,186.45626,164.164621,0.082196,4.44022,4.358024,5.148364,35.756073,30.607709,2.360355,19.290974,16.930619,0.470842,6.526402,6.05556,0.126926,6.869301,6.742375,1.02538,3.854939,2.829559,58.060547,13.238547,-44.822,9.255644,120.931313,111.675669,0.013178,2.696665,2.683487,0.253263,1.135885,0.882622,0.834961,3.373416,2.538455,370.25671,146.999686,-223.257024,0.0812,0.717766,0.636566,1.382864,5.785474,4.40261,92.058208,1.127866,-90.930342,0.036598,0.005065,-0.031533,0.452555,1.043103,0.590548,1.170401,14.058471,12.88807,400.178606,47.750051,-352.428555,5.709086,12.75752,7.048434,0.063978,0.172526,0.108548,0.321483,0.203,-0.118483,0.163752,0.115182,-0.04857,5.478083,27.42875,21.950667,13.095003,7.077455,-6.017548,0.107552,0.216735,0.109183,1.79185,1.006867,-0.784983,0.049932,7.812846,7.762914,20.663567,145.105224,124.441657,0.032648,0.198957,0.166309,2.142362,14.127213,11.984851,2.101685,5.971493,3.869808,44.154014,26.486387,-17.667627,0.223306,0.660905,0.437599,0.000171,0.337717,0.337546,5.58473,12.769627,7.184897,27.587959,2.898174,-24.689785,4.690515,6.887881,2.197366,41.178459,4.95937,-36.219089,0,0,0,0.021199,0.127691,0.106492,0.783587,0.315221,-0.468366,0.000652,0.19304,0.192388,505.601818,347.643904,-157.957914,8.849007,3.603296,-5.245711,33.798107,2.234126,-31.563981,2.010972,4.263696,2.252724,0.241594,3.018329,2.776735,1.052894,3.455607,2.402713,3.143135,5.708794,2.565659,28.694625,0.581776,-28.112849,,,,,,
2016-08-01,7132.036886,6050.564267,-1081.472619,35755.440933,21863.232113,-13892.20882,183573.40154537,123537.581378103,-60035.8201672669,14541.165019,0,-14541.165019,11393.94852,8033.418313,-3360.530207,37973.120652,27759.285139,-10213.835513,,,,10430.819529,11702.38953,1271.570001,49754.946264,43228.119562,-6526.826702,41238.424549,25927.685586,-15310.738963,2260.209658,1753.014456,-507.195201999999,73333.259068,29770.609328,-43562.64974,194046.044823,122529.442652,-71516.6021709999,89140.313371,37560.094449,-51580.218922,2135.777136,2485.041639,349.264503,1219.950759,2357.960273,1138.009514,1725.566017,988.983272,-736.582744999999,1.371009,0.170599,-1.20041,24193.484164,23268.262664,-925.2215,0.009684,0.008197,-0.001487,25561.4621,19959.856898,-5601.605202,362.475028,479.729278,117.25425,3.866549,17.213099,13.34655,224.810443,260.674907,35.864464,420.841804,387.046475,-33.795329,329.449508,127.998526,-201.450982,364.129753,515.227408,151.097655,34.609407,451.230978,416.621571,1.198147,38.067338,36.869191,21.653628,164.946425,143.292797,0,18.377847,18.377847,22.563235,140.161141,117.597906,0.252672,24.116785,23.864113,6.509576,68.562906,62.05333,90.896103,91.198946,0.30284300000001,434.0706,714.365045,280.294445,0.610956,2.42817,1.817214,0.24318,12.325822,12.082642,3.680683,10.486261,6.805578,6.279108,25.498742,19.219634,0.114597,0.371835,0.257238,0.529659,5.022813,4.493154,0.945111,32.120452,31.175341,0.14186,13.86339,13.72153,0.759243,4.105967,3.346724,3.431203,37.165836,33.734633,256.649067,160.038186,-96.610881,,,,2.889319,33.027647,30.138328,25.248709,48.710261,23.461552,0.782471,56.69432,55.911849,0.19837,12.610563,12.412193,1.625107,15.077757,13.45265,1358.951641,1174.570196,-184.381445,1102.14666,458.37061,-643.77605,36.807355,27.643998,-9.163357,5.602171,24.865239,19.263068,0.028211,28.77118,28.742969,556.51367,334.165657,-222.348013,576.159929,681.371169,105.21124,111.735125,56.912534,-54.822591,695.426196,961.342811,265.916615,2880.383354,2951.90701,71.5236559999998,10.150763,180.802609,170.651846,54.466316,84.329667,29.863351,420.861743,768.861191,347.999448,0.131299,0.010533,-0.120766,29.056544,55.325252,26.268708,741.317732,317.054198,-424.263534,0.004654,0.00877,0.004116,291.609484,407.247915,115.638431,426.189893,157.335158,-268.854735,8.606114,0.004629,-8.601485,544.863267,163.51032,-381.352947,4430.362767,4677.397539,247.034772,3866.088538,690.673829,-3175.414709,1376.495212,3472.082044,2095.586832,1207.647438,2456.858953,1249.211515,39.645881,95.045049,55.399168,0.03434,0.164252,0.129912,1.647315,1.983368,0.336053,4237.605252,2294.92253,-1942.682722,10196.230106,4143.16685,-6053.063256,929.444055,211.571748,-717.872307,,,,373.631326,139.850788,-233.780538,150.06444,23.184054,-126.880386,443.308796,120.968078,-322.340718,21.958976,1.245505,-20.713471,2825.685972,1721.122883,-1104.563089,99.997502,16.554045,-83.443457,28.467893,20.991129,-7.476764,51.768561,39.447512,-12.321049,491.240153,334.951703,-156.28845,,,,1292.954092,617.012242,-675.94185,20.153926,48.684886,28.53096,103.286246,73.485641,-29.800605,4.961498,2.154937,-2.806561,45.772853,235.923336,190.150483,13.97032,24.561913,10.591593,99.448451,36.347696,-63.100755,0.075202,3.070361,2.995159,3.774462,0.936536,-2.837926,0.140374,0.356894,0.21652,3.079849,7.010449,3.9306,0.516034,126.965655,126.449621,1154.723021,766.805919,-387.917102,273.484533,69.319835,-204.164698,0.058008,76.256297,76.198289,112.668042,95.343194,-17.324848,0.708091,0.108511,-0.59958,0.048476,0.141062,0.092586,4149.36764,1370.233101,-2779.134539,,,,26.478581,22.792864,-3.685717,63.319318,53.464052,-9.855266,7.215397,0.869503,-6.345894,22.286939,1.951998,-20.334941,,,,25.39471,9.759897,-15.634813,0.133434,1.217229,1.083795,0.05358,0.959872,0.906292,27.105354,5.391733,-21.713621,98.946106,40.606232,-58.339874,186.287362,49.449143,-136.838219,50.746035,15.957019,-34.789016,633.242921,604.184251,-29.05867,5.051483,3.695227,-1.356256,0.277566,0.855888,0.578322,8.244856,100.244886,92.00003,633.08881,106.049057,-527.039753,16.778744,10.798459,-5.980285,877.921801,544.61944,-333.302361,0,0,0,0.179544,0.16311,-0.016434,198.51926,98.539203,-99.980057,267.853271,362.290571,94.4373,,,,1717.865676,2229.189227,511.323551,68.189064,186.459675,118.270611,266.985228,1392.190308,1125.20508,0.375335,12.314577,11.939242,110.092472,161.46684,51.374368,56.21383,72.566488,16.352658,2.515593,47.954139,45.438546,3910.775004,1889.661325,-2021.113679,292.619605,172.088617,-120.530988,10.885247,2.108139,-8.777108,532.774252,74.552237,-458.222015,241.002101,34.296635,-206.705466,30.875619,11.677427,-19.198192,2771.501295,852.831232,-1918.670063,3959.250884,1063.349958,-2895.900926,2.67447,2.950804,0.276334,285.276656,27.509255,-257.767401,3264.030166,981.300097,-2282.730069,1508.211552,2113.544772,605.33322,1590.847887,541.163142,-1049.684745,0.091526,0.075828,-0.015698,0.994229,7.334862,6.340633,952.9658,678.233954,-274.731846,9.39308,46.271808,36.878728,0.128288,0.083764,-0.044524,1.135533,2.715801,1.580268,43230.217158,9369.065335,-33861.151823,1.075243,3.884819,2.809576,0,0,0,6014.05494,3517.644572,-2496.410368,493.481575,2849.432314,2355.950739,3645.479533,1948.588161,-1696.891372,11438.674695,5465.475715,-5973.19898,843.716576,1958.478545,1114.761969,0.000857,0.024215,0.023358,0.03415,0.043474,0.009324,0.070898,0,-0.070898,0,0,0,9.252961,5.822524,-3.430437,331.938916,288.253527,-43.685389,0.057121,0.508918,0.451797,0.082838,0.012766,-0.070072,0.014076,0.023916,0.00984,0.501239,3.59527,3.094031,0.328201,0.483966,0.155765,0.154598,0.212201,0.057603,0,0,0,0.741721,0.045791,-0.69593,,,,5.904668,2.643307,-3.261361,0,0,0,2.322834,9.015999,6.693165,4.201301,75.809874,71.608573,0.046171,4.138315,4.092144,0.115567,2.52265,2.407083,0.315282,0.0154,-0.299882,19.682009,4.391829,-15.29018,0.437555,1.849411,1.411856,86.244726,201.824522,115.579796,256.045371,191.408029,-64.637342,28.293829,68.475641,40.181812,,,,125.244966,290.497501,165.252535,0.893914,2.494082,1.600168,0.008195,0.476333,0.468138,0.004819,0.028048,0.023229,9.906027,9.688183,-0.217843999999999,0.060497,5.747033,5.686536,11.773802,25.309363,13.535561,4.565635,20.033618,15.467983,0.103971,8.326142,8.222171,0.605235,9.543307,8.938072,0.770715,5.993126,5.222411,69.32707,29.162714,-40.164356,26.855832,43.327703,16.471871,0.036739,3.259852,3.223113,0.097545,1.510756,1.413211,1.252261,3.893894,2.641633,336.527496,177.134806,-159.39269,0.039761,0.497857,0.458096,7.436704,4.279919,-3.156785,90.34472,1.524021,-88.820699,2.968199,0.118367,-2.849832,0.796447,1.454175,0.657728,0.757268,15.589153,14.831885,278.510406,46.756814,-231.753592,54.238873,10.599792,-43.639081,0.001572,0.26638,0.264808,0.121412,0.207065,0.085653,0.001439,0.054648,0.053209,3.613654,21.603432,17.989778,37.566655,4.397878,-33.168777,0.001228,0.762574,0.761346,1.092585,1.011057,-0.0815279999999998,0.011186,3.785415,3.774229,16.868414,11.516191,-5.35222300000001,0.008214,0.194491,0.186277,4.076756,10.781132,6.704376,2.826918,6.322725,3.495807,54.220625,15.944902,-38.275723,0.267002,1.22011,0.953108,0.240623,0.445908,0.205285,6.089705,10.932891,4.843186,35.711382,1.881661,-33.829721,3.222104,13.857275,10.635171,39.800863,3.550011,-36.250852,0,0,0,0.097666,0.191392,0.093726,2.35249,0.850441,-1.502049,0.000715,0.035934,0.035219,563.042014,416.563697,-146.478317,3.208218,6.226211,3.017993,9.64462,2.901923,-6.742697,3.280838,3.896956,0.616118,0.546466,1.717659,1.171193,0.915124,1.382343,0.467219,3.464284,1.524638,-1.939646,28.037886,0.071555,-27.966331,,,,,,
2016-09-01,6781.876566,5709.275996,-1072.60057,33460.994597,23231.683359,-10229.311238,182637.571006066,124282.07045971,-58355.5005463559,14660.201456,0,-14660.201456,11284.953325,7738.95603,-3545.997295,37353.127916,29560.733877,-7792.394039,,,,9602.691073,11392.941464,1790.250391,48886.323172,42353.155422,-6533.16775000001,38806.389754,26895.296597,-11911.093157,2142.364389,1891.887568,-250.476821,69935.828195,32220.689358,-37715.138837,185994.791524,124431.111807,-61563.6797169998,85502.407998,39430.327276,-46072.080722,1958.216408,2426.089733,467.873325,1053.68849,2466.735449,1413.046959,1685.549964,1271.361344,-414.188619999999,0.926635,0.744459,-0.182176,23750.409722,22661.47482,-1088.934902,0.000013,0.023572,0.023559,25135.91345,19691.680602,-5444.232848,330.982707,419.5285,88.545793,3.974625,23.246301,19.271676,216.133069,230.900001,14.766932,371.796005,463.909669,92.113664,290.807955,121.8141,-168.993855,352.55353,459.190057,106.636527,31.49808,482.456644,450.958564,3.87097,48.572759,44.701789,29.626429,153.27328,123.646851,0,33.798706,33.798706,23.975698,154.968456,130.992758,0.858956,21.190306,20.33135,4.251799,65.939685,61.687886,83.734953,102.33173,18.596777,395.943142,730.747406,334.804264,0.367412,5.482611,5.115199,0.464838,13.388373,12.923535,3.312477,12.646188,9.333711,0.312584,18.215438,17.902854,0.002602,0.961619,0.959017,0.142553,4.539562,4.397009,2.943867,62.373712,59.429845,0.055193,7.222873,7.16768,1.158602,7.302932,6.14433,2.810668,44.194345,41.383677,227.673222,184.417642,-43.25558,,,,3.878463,31.427369,27.548906,20.578887,52.31962,31.740733,3.620792,50.446122,46.82533,0.093329,17.336752,17.243423,1.597424,8.324879,6.727455,1228.466335,1222.673796,-5.79253900000003,993.432868,394.59117,-598.841698,28.083671,35.420993,7.337322,5.239023,27.40122,22.162197,0,5.552271,5.552271,521.662724,316.873007,-204.789717,698.436575,715.843345,17.4067700000001,81.200126,58.125034,-23.075092,686.610236,987.852802,301.242566,2420.430416,2626.202166,205.77175,15.387423,179.799713,164.41229,40.359343,109.57814,69.218797,474.356916,680.550339,206.193423,0.004586,0.009831,0.005245,42.536683,31.848047,-10.688636,730.646401,303.610823,-427.035578,0.00411,0,-0.00411,408.094617,332.813374,-75.281243,366.864886,112.196316,-254.66857,11.84517,0.023135,-11.822035,710.669685,216.557293,-494.112392,4327.240067,5240.25478,913.014713,3806.745307,808.993177,-2997.75213,1455.042015,3199.426105,1744.38409,1342.267417,2611.064611,1268.797194,35.361583,308.974729,273.613146,0.095925,0.151042,0.055117,5.483902,2.385588,-3.098314,3526.448117,2749.710993,-776.737124,9322.712755,4304.449697,-5018.263058,833.386755,248.867098,-584.519657,,,,372.885539,136.76571,-236.119829,251.347516,18.729544,-232.617972,484.948794,128.801773,-356.147021,20.51083,1.775657,-18.735173,2897.692621,1729.338688,-1168.353933,86.160072,21.043009,-65.117063,30.032355,26.06568,-3.966675,55.664684,43.325535,-12.339149,486.549202,281.403568,-205.145634,,,,1192.256038,467.819757,-724.436281,12.978113,49.262241,36.284128,42.264624,77.404653,35.140029,3.78422,2.567744,-1.216476,0.240133,10.392266,10.152133,2.056058,22.44871,20.392652,10.812077,55.551638,44.739561,0.035084,1.63681,1.601726,3.102733,0.465935,-2.636798,0.017431,2.505474,2.488043,1.542245,65.570643,64.028398,1.572559,9.999558,8.426999,930.811298,915.56497,-15.2463279999999,275.915964,39.979113,-235.936851,0.006589,135.423683,135.417094,17.96738,19.57229,1.60491,0.747269,2.360735,1.613466,0.014653,0.032062,0.017409,3585.045186,1302.296903,-2282.748283,,,,36.539506,24.817017,-11.722489,57.719516,18.670641,-39.048875,4.362276,1.979888,-2.382388,15.765919,2.032486,-13.733433,,,,30.682271,21.193069,-9.489202,0.31537,0.403498,0.088128,0.143696,0.340305,0.196609,15.247986,3.110767,-12.137219,91.323515,48.975581,-42.347934,189.960488,58.638526,-131.321962,45.67982,20.315958,-25.363862,621.183955,632.775785,11.5918300000001,5.058774,22.611919,17.553145,0.716885,0.133246,-0.583639,9.115045,90.647203,81.532158,572.193046,94.397276,-477.79577,3.684259,6.437022,2.752763,1124.805763,532.548012,-592.257751,0,0,0,0.268171,0.057256,-0.210915,163.200978,95.72414,-67.476838,355.468311,237.25837,-118.209941,,,,1614.78664,1484.298607,-130.488033,90.378304,312.220565,221.842261,293.333022,1855.030381,1561.697359,0.007282,3.672654,3.665372,98.396778,123.950578,25.5538,55.073699,80.921066,25.847367,6.999279,23.430379,16.4311,4103.27299,1905.567567,-2197.705423,280.383694,181.754725,-98.628969,8.084136,2.371421,-5.712715,497.677754,129.494698,-368.183056,234.319026,38.339093,-195.979933,23.638261,12.795467,-10.842794,2506.132271,951.319786,-1554.812485,3449.304302,980.968674,-2468.335628,2.310294,2.897985,0.587691,271.606328,30.892441,-240.713887,3039.588499,931.099554,-2108.488945,1642.029742,2326.703378,684.673636,1537.694766,467.139757,-1070.555009,0.00203,0.368635,0.366605,1.067273,14.927419,13.860146,834.83765,764.941264,-69.896386,8.751361,46.200833,37.449472,0.00448,0.101982,0.097502,0.911996,2.865237,1.953241,42026.907738,9507.100718,-32519.80702,0.737785,2.812274,2.074489,0,0.044881,0.044881,5081.17584,3655.563106,-1425.612734,1028.368645,3847.921586,2819.552941,3315.011941,2605.683919,-709.328022,10392.332955,5627.524456,-4764.808499,757.057411,1956.093088,1199.035677,0,0,0,0.08828,0,-0.08828,0.136152,0.012552,-0.1236,0,0,0,6.190304,49.972417,43.782113,264.81407,419.817863,155.003793,0.211243,0.398076,0.186833,0.17253,0.014664,-0.157866,0.027,0.004731,-0.022269,0.474726,2.062202,1.587476,0.494351,0.680349,0.185998,0.615308,0.367646,-0.247662,0,0,0,0.158896,0.030087,-0.128809,,,,3.363009,5.902658,2.539649,0,0,0,2.794774,11.483281,8.688507,0.681725,9.210025,8.5283,0.039489,2.979699,2.94021,0.106775,1.557852,1.451077,0.084567,0.053887,-0.03068,15.892137,4.472028,-11.420109,0.269365,1.56842,1.299055,105.452938,161.372626,55.919688,226.869521,149.143666,-77.725855,24.422512,31.383537,6.961025,,,,90.688163,261.897486,171.209323,1.056793,3.468098,2.411305,0.016186,0.405947,0.389761,0.000324,0,-0.000324,0.091647,4.984319,4.892672,25.682797,5.174884,-20.507913,27.914256,18.015449,-9.898807,3.659473,33.9334,30.273927,0.09925,6.166084,6.066834,1.025427,10.551136,9.525709,0.682164,3.799009,3.116845,68.436434,33.955015,-34.481419,9.566001,63.56945,54.003449,0.010192,4.362529,4.352337,0.805682,4.56974,3.764058,1.43893,4.105237,2.666307,275.704522,132.388503,-143.316019,0.102486,0.599351,0.496865,27.537356,4.335653,-23.201703,85.258546,5.028493,-80.230053,0.900301,0.022028,-0.878273,0.212733,3.848582,3.635849,0.062358,39.962072,39.899714,260.676837,240.394326,-20.282511,3.750283,12.135825,8.385542,0.004956,0.105864,0.100908,0.988659,4.555415,3.566756,0.028976,0.033374,0.004398,1.964558,22.417501,20.452943,4.697643,4.287327,-0.410316,0.00568,0.818415,0.812735,2.281095,0.919327,-1.361768,0.086952,2.161218,2.074266,11.821109,38.26899,26.447881,0.0001,0.289278,0.289178,1.714578,13.755809,12.041231,3.954034,5.287996,1.333962,51.170934,35.657336,-15.513598,0.21555,1.909987,1.694437,0,1.125331,1.125331,9.902897,7.966337,-1.93656,22.888702,2.553459,-20.335243,4.034381,9.385334,5.350953,30.861885,4.118391,-26.743494,0,0,0,0.189882,0.006407,-0.183475,0.025722,0.28421,0.258488,0.000013,0.526597,0.526584,583.092047,338.718042,-244.374005,3.768639,4.279455,0.510816,104.192734,5.04132,-99.151414,6.684115,5.832243,-0.851872,2.521292,2.003846,-0.517446,0.778137,4.298172,3.520035,3.732493,3.992985,0.260492,29.624201,1.049042,-28.575159,,,,,,
2016-10-01,6700.419433,5238.730316,-1461.689117,36055.517114,22974.536845,-13080.980269,184350.227469369,122360.89342141,-61989.3340479591,15601.72038,0,-15601.72038,11379.906054,7557.791686,-3822.114368,39221.997512,30509.574602,-8712.42291,,,,8910.706911,11394.31447,2483.60755900001,50203.063908,42754.475124,-7448.58878399999,41677.797124,27105.820272,-14571.976852,2236.293921,2100.021284,-136.272637000001,72497.978813,35411.913274,-37086.065539,192023.37723,128440.311585,-63583.065645,87858.532603,42657.354383,-45201.17822,1842.689667,2413.605679,570.916012,1136.97677,2427.754797,1290.778027,1589.012823,1147.506841,-441.505982,0.005334,0.571255,0.565921,23844.750698,22607.643891,-1237.106807,0.000659,0,-0.000659,26358.31321,20146.831233,-6211.481977,323.466923,483.283384,159.816461,5.502426,32.801914,27.299488,199.964671,253.109954,53.145283,337.164814,399.624733,62.459919,262.382623,107.222925,-155.159698,334.794432,505.211048,170.416616,30.837164,501.684286,470.847122,1.531653,38.538213,37.00656,16.788985,190.482885,173.6939,0,24.027475,24.027475,16.841398,126.047313,109.205915,0.574052,20.484767,19.910715,3.693665,62.095307,58.401642,73.677325,113.669342,39.992017,384.916204,665.153635,280.237431,0.208036,4.148516,3.94048,0.308169,84.223195,83.915026,4.648916,13.830145,9.181229,0.37333,25.590732,25.217402,0.044741,0.916781,0.87204,0.055545,5.7685,5.712955,1.049369,29.685896,28.636527,0.183395,8.468098,8.284703,0.599644,7.543701,6.944057,10.515712,41.355662,30.83995,211.291405,184.984878,-26.306527,,,,4.177709,58.097001,53.919292,18.568604,34.761161,16.192557,0.769471,90.042063,89.272592,0.774338,7.850911,7.076573,2.138815,15.918088,13.779273,1107.397524,1117.354086,9.95656200000008,933.912572,378.887154,-555.025418,29.785756,41.385648,11.599892,5.573015,24.531584,18.958569,0.018254,3.095008,3.076754,460.257047,374.938779,-85.318268,608.188101,697.601741,89.41364,43.312815,48.555136,5.242321,611.487765,909.006168,297.518403,2329.912296,2651.250679,321.338383,12.674824,246.851826,234.177002,39.455821,94.260808,54.804987,479.989622,669.963064,189.973442,0.897965,0.01028,-0.887685,33.645557,37.144258,3.498701,818.596702,322.908842,-495.68786,0,0.041385,0.041385,428.159958,409.647841,-18.512117,387.979836,123.743838,-264.235998,14.960126,0.130078,-14.830048,804.347691,178.061885,-626.285806,5081.480366,4582.738875,-498.741491,3906.486055,793.849797,-3112.636258,1489.276008,3364.800953,1875.524945,1455.124683,2732.144213,1277.01953,35.293942,114.230454,78.936512,0.011592,0.087982,0.07639,12.19036,5.071285,-7.119075,4396.694263,2670.923302,-1725.770961,9252.952366,4271.495917,-4981.456449,908.022427,208.07099,-699.951437,,,,378.70897,147.154808,-231.554162,226.109085,27.684608,-198.424477,439.941134,163.410075,-276.531059,25.745132,1.923379,-23.821753,2949.907376,1972.773433,-977.133943,78.997554,43.172377,-35.825177,23.915389,39.824595,15.909206,114.696103,46.818625,-67.877478,515.655687,335.571634,-180.084053,,,,1282.822082,664.039042,-618.78304,15.728113,6.348046,-9.380067,45.176843,78.242309,33.065466,4.559344,6.734287,2.174943,0.992591,21.226918,20.234327,8.461082,31.397754,22.936672,27.715187,48.346179,20.630992,0.120711,1.987986,1.867275,2.650678,1.033868,-1.61681,0.066123,0.761636,0.695513,1.177426,2.562138,1.384712,0.974705,8.854444,7.879739,1161.110179,1007.718089,-153.39209,309.136718,47.167975,-261.968743,0.006723,95.818167,95.811444,18.213443,5.243807,-12.969636,0.070502,0.242743,0.172241,0.055579,0.276889,0.22131,3820.07166,1462.720052,-2357.351608,,,,38.939795,25.481039,-13.458756,63.378875,17.747563,-45.631312,6.523842,1.715087,-4.808755,25.114753,5.418668,-19.696085,,,,24.66985,9.954952,-14.714898,0.457897,0.864269,0.406372,0.044116,0.459194,0.415078,13.743882,3.603363,-10.140519,108.369123,153.48585,45.116727,167.704178,64.058472,-103.645706,51.484626,16.542615,-34.942011,696.52788,714.575847,18.047967,2.830256,7.765595,4.935339,0.445509,0.503561,0.058052,12.460299,109.231757,96.771458,749.244293,72.859255,-676.385038,15.226065,37.504472,22.278407,1088.911237,508.979041,-579.932196,0,0,0,0.199684,0.096387,-0.103297,136.486409,126.527685,-9.958724,268.404134,214.528425,-53.875709,,,,1356.295308,1280.238514,-76.0567940000001,122.961437,157.524331,34.562894,219.934793,1747.927201,1527.992408,0.326631,11.82956,11.502929,54.667416,157.123576,102.45616,44.993185,69.551467,24.558282,2.33376,78.170546,75.836786,4539.931849,2127.237923,-2412.693926,271.079256,161.003086,-110.07617,8.233533,3.842411,-4.391122,454.988557,64.276013,-390.712544,224.426576,29.402082,-195.024494,25.080741,15.562355,-9.518386,2595.211987,936.137924,-1659.074063,3692.353454,1128.694013,-2563.659441,4.566126,4.692074,0.125948,273.200703,28.391832,-244.808871,3148.662392,945.068907,-2203.593485,1227.979229,2554.203328,1326.224099,1605.707426,446.693144,-1159.014282,1.912568,0.194861,-1.717707,0.485558,522.2033,521.717742,895.138188,835.031077,-60.107111,4.787107,89.725802,84.938695,0.002104,0.367461,0.365357,2.430397,3.280373,0.849976,43793.540304,12616.015735,-31177.524569,0.548922,4.124493,3.575571,0,0.070963,0.070963,5107.698721,3832.153963,-1275.544758,565.596846,3099.497889,2533.901043,3346.779115,2338.580801,-1008.198314,11692.255872,5785.406137,-5906.849735,816.406624,1894.207794,1077.80117,0.000962,0.004249,0.003287,0.054446,0.014716,-0.03973,0.154076,0.00417,-0.149906,0,0,0,14.028101,4.432992,-9.595109,278.91333,448.692405,169.779075,0.061443,0.352205,0.290762,0.670822,0.071891,-0.598931,0.017025,0.031723,0.014698,0.417158,1.929785,1.512627,0.328243,2.565899,2.237656,0.210714,0.279733,0.069019,0,0,0,0.304485,0.050037,-0.254448,,,,4.173218,8.311764,4.138546,0,0,0,2.098886,7.959524,5.860638,0.993031,46.618758,45.625727,0.020685,3.565606,3.544921,0.075297,1.802949,1.727652,0.032076,0,-0.032076,17.620445,5.691266,-11.929179,0.286047,1.011829,0.725782,95.419613,88.175598,-7.244015,409.373889,252.397694,-156.976195,36.035554,44.93005,8.894496,,,,99.358424,385.247569,285.889145,0.656806,11.348717,10.691911,0.000437,0.246461,0.246024,0,0,0,7.739369,4.636686,-3.102683,0.137408,4.489522,4.352114,7.674271,16.225799,8.551528,6.465575,23.937717,17.472142,0.632222,10.214041,9.581819,1.277338,6.401257,5.123919,10.813384,6.589231,-4.224153,103.294345,18.719941,-84.574404,10.203579,110.743927,100.540348,0.031192,2.441484,2.410292,0.599267,4.824571,4.225304,0.841216,4.129699,3.288483,375.299573,167.445896,-207.853677,0.059744,1.136186,1.076442,11.057067,6.71182,-4.345247,0.656681,0.486912,-0.169769,1.664262,0.139075,-1.525187,0.449333,4.301129,3.851796,0.622476,16.320879,15.698403,168.614106,96.679299,-71.934807,9.551733,11.305752,1.754019,0,0.051533,0.051533,0.114152,0.436415,0.322263,0.020731,0.076147,0.055416,3.76321,5.879392,2.116182,24.321786,6.743011,-17.578775,1.021241,0.227954,-0.793287,1.88425,0.456229,-1.428021,0.002079,0.362852,0.360773,14.111685,37.463591,23.351906,0.013212,0.209244,0.196032,2.77009,12.274826,9.504736,2.311097,4.405468,2.094371,41.222303,21.546411,-19.675892,0.783307,0.842455,0.059148,0.003127,0.700188,0.697061,6.858448,10.835828,3.97738,36.351631,2.708214,-33.643417,11.993403,14.858565,2.865162,39.921436,3.468524,-36.452912,0,0,0,0.096938,0.002601,-0.094337,1.283856,176.006317,174.722461,0.001492,0.467578,0.466086,586.725559,464.262137,-122.463422,14.5979,10.980508,-3.617392,15.72746,3.260581,-12.466879,2.071341,5.56535,3.494009,9.697944,1.935703,-7.762241,1.98232,3.927076,1.944756,21.31469,1.675485,-19.639205,34.351283,0.714502,-33.636781,,,,,,
2016-11-01,7350.124616,5631.987765,-1718.136851,35594.827246,20796.069877,-14798.757369,186884.470508433,121204.51267133,-65679.9578371038,15174.653669,0,-15174.653669,11302.05731,6988.065792,-4313.991518,41344.150026,27557.735056,-13786.41497,,,,9240.625402,11897.20038,2656.574978,49773.175693,41183.873312,-8589.302381,41277.514084,24966.935846,-16310.578238,2589.727691,1962.436691,-627.291,71920.303207,32893.054918,-39027.248289,191238.587397,123034.22637,-68204.3610269999,87306.199367,40918.78068,-46387.418687,1956.90104,2557.152468,600.251428,1051.316903,2104.694264,1053.377361,1827.787058,1200.665976,-627.121082000001,0.028257,0.305197,0.27694,24401.196903,21669.193689,-2732.003214,0,0,0,25371.97879,19514.679623,-5857.299167,288.573064,480.398684,191.82562,3.361334,22.917868,19.556534,198.538679,239.940745,41.402066,383.695041,407.176742,23.481701,265.001428,126.844331,-138.157097,382.395746,570.755422,188.359676,29.128347,489.666113,460.537766,1.024974,34.349744,33.32477,21.529346,219.233266,197.70392,0,13.907778,13.907778,31.98236,141.978059,109.995699,1.002919,29.629219,28.6263,1.128241,64.467817,63.339576,64.437612,81.435151,16.997539,438.697082,732.036544,293.339462,0.522976,6.015111,5.492135,0.328909,19.618327,19.289418,4.068298,14.779591,10.711293,1.721915,25.033603,23.311688,0.076156,0.761896,0.68574,0.115625,5.146701,5.031076,1.144598,35.498371,34.353773,0.476457,7.437193,6.960736,0.78986,8.090098,7.300238,4.697796,42.892331,38.194535,251.375178,152.883355,-98.491823,,,,9.887659,101.770949,91.88329,38.742063,30.029286,-8.712777,2.206709,70.336148,68.129439,0.08964,7.953752,7.864112,0.248924,8.481601,8.232677,1023.473904,1105.353913,81.880009,1131.138066,473.105613,-658.032453,21.875818,32.608383,10.732565,5.875012,24.57019,18.695178,0.01499,2.938093,2.923103,566.86673,395.487352,-171.379378,622.878995,671.832725,48.95373,49.663529,50.136227,0.472698000000001,692.063234,923.676702,231.613468,2150.718126,3034.872885,884.154759,14.115847,176.092388,161.976541,54.241456,85.442157,31.200701,475.09938,729.370067,254.270687,5.611379,0.247889,-5.36349,31.574714,20.888942,-10.685772,842.406794,299.046955,-543.359839,0.000205,0.051883,0.051678,326.819463,311.96594,-14.853523,428.343236,145.334971,-283.008265,11.050348,0.15454,-10.895808,607.495666,154.376311,-453.119355,4642.539611,4317.007573,-325.532038,4613.229954,883.912531,-3729.317423,1418.271083,3069.038724,1650.767641,1255.778868,2394.934376,1139.155508,45.719265,49.19629,3.477025,0.031678,0.125559,0.093881,2.583511,2.616083,0.032572,3672.985138,2258.473879,-1414.511259,9547.954327,3881.076342,-5666.877985,1037.832507,198.738636,-839.093871,,,,352.459122,180.513932,-171.94519,218.063976,23.437139,-194.626837,428.153883,155.193836,-272.960047,20.717119,1.227128,-19.489991,2807.501746,1960.048944,-847.452802,86.884829,15.937689,-70.94714,35.512404,29.51623,-5.996174,113.769223,37.405659,-76.363564,497.738154,288.765885,-208.972269,,,,1564.415229,452.7747,-1111.640529,21.318089,6.187168,-15.130921,39.276378,120.458494,81.182116,2.684313,2.643225,-0.0410879999999998,1.245118,14.675357,13.430239,1.413397,27.367889,25.954492,72.470103,316.144293,243.67419,0.126426,1.964096,1.83767,3.309515,0.521436,-2.788079,0.162679,0.719239,0.55656,0.665146,3.009534,2.344388,0.808947,133.532167,132.72322,1088.547288,738.441147,-350.106141,260.974267,106.706025,-154.268242,0.02272,144.137648,144.114928,16.951244,4.034873,-12.916371,0.139374,0.803525,0.664151,0.005642,0.084379,0.078737,3936.330407,1396.36616,-2539.964247,,,,52.182487,12.637191,-39.545296,62.201566,39.352539,-22.849027,7.330618,2.742487,-4.588131,28.451545,3.7523,-24.699245,,,,28.162441,9.895041,-18.2674,0.056473,1.745873,1.6894,0.138422,0.61545,0.477028,2.81903,4.210043,1.391013,108.943898,45.741747,-63.202151,162.312875,40.362233,-121.950642,56.755562,24.850274,-31.905288,707.386449,625.802606,-81.583843,4.489612,5.67073,1.181118,0.723398,0.138653,-0.584745,9.21188,87.563758,78.351878,504.649878,126.267215,-378.382663,3.162732,6.283349,3.120617,1038.383496,601.079718,-437.303778,0,0,0,0.564398,0.073203,-0.491195,113.828861,263.755444,149.926583,265.324775,243.911782,-21.412993,,,,1491.937874,1402.071596,-89.866278,86.007795,136.481373,50.473578,398.734822,1925.742481,1527.007659,0.009799,3.418107,3.408308,95.253068,238.396075,143.143007,59.905413,98.124289,38.218876,3.430713,142.639392,139.208679,3542.287179,2060.915441,-1481.371738,284.963294,207.62392,-77.339374,6.456671,3.373308,-3.083363,410.24994,54.11698,-356.13296,232.244213,32.399008,-199.845205,24.578021,16.896159,-7.681862,2683.764799,974.980305,-1708.784494,4022.667281,1014.186065,-3008.481216,5.920761,3.351685,-2.569076,196.833148,27.387567,-169.445581,3245.43313,1013.929979,-2231.503151,1433.847879,2425.258124,991.410245,1702.592404,491.339853,-1211.252551,2.010414,0.115519,-1.894895,0.870357,6.827726,5.957369,834.854127,680.672312,-154.181815,20.635122,29.550484,8.915362,0.026809,0.048363,0.021554,1.98248,1.834403,-0.148077,42608.875933,12069.823779,-30539.052154,0.318433,3.550791,3.232358,0,0,0,5791.907586,3433.617757,-2358.289829,560.74726,3206.391241,2645.643981,3366.346478,2031.014238,-1335.33224,11335.202965,5438.80195,-5896.401015,714.679562,1808.18032,1093.500758,0,0.06394,0.06394,0.136997,0.032981,-0.104016,0.07635,0.050717,-0.025633,0,0,0,6.097802,5.545804,-0.551997999999999,298.212602,252.101351,-46.111251,0.172779,0.22595,0.053171,0.200409,0.151185,-0.049224,0.007203,0,-0.007203,0.209832,1.85771,1.647878,0.152663,0.27917,0.126507,0.284386,0.318773,0.0343869999999999,0,0,0,0.372946,0.046743,-0.326203,,,,5.13386,3.168009,-1.965851,0,0,0,3.524351,8.288877,4.764526,3.739276,11.493726,7.75445,0.10593,5.311485,5.205555,0.024954,1.951973,1.927019,0.186222,0.057385,-0.128837,17.284776,3.726895,-13.557881,0.379296,1.830758,1.451462,55.379776,179.044002,123.664226,539.515117,142.726722,-396.788395,26.571269,47.370443,20.799174,,,,135.386243,205.372984,69.986741,1.179948,6.250939,5.070991,0.005382,0.913885,0.908503,0,0,0,42.30406,21.809533,-20.494527,0.504305,49.216727,48.712422,23.163208,8.50976,-14.653448,6.824167,9.601823,2.777656,0.094809,11.043154,10.948345,0.827546,4.111634,3.284088,0.999802,4.968936,3.969134,71.4442,11.53209,-59.91211,28.487782,68.971436,40.483654,0.008336,2.789723,2.781387,0.35745,12.347024,11.989574,0.997342,5.504875,4.507533,360.094317,175.723723,-184.370594,0.141695,0.893194,0.751499,3.548574,11.028982,7.480408,88.762408,4.942934,-83.819474,0.294246,0.052187,-0.242059,0.138061,7.503582,7.365521,1.110981,10.791595,9.680614,292.06936,94.228066,-197.841294,3.515803,7.231205,3.715402,0.087415,0.155676,0.068261,1.084985,0.510578,-0.574407,0.014289,0.046422,0.032133,2.353508,8.759347,6.405839,9.518816,8.556152,-0.962663999999998,0.989736,0.703444,-0.286292,4.986638,58.395609,53.408971,0.205394,1.127177,0.921783,8.101882,97.906012,89.80413,0.005723,0.042259,0.036536,2.256747,9.983783,7.727036,4.870472,5.091986,0.221514,49.636037,67.784425,18.148388,1.091394,1.669905,0.578511,0.044186,0.22871,0.184524,6.367481,9.677665,3.310184,24.288214,2.321957,-21.966257,13.891761,8.24789,-5.643871,45.764259,3.599746,-42.164513,0,0,0,0.082027,0.376749,0.294722,0.267395,177.933567,177.666172,0.000216,1.16685,1.166634,623.515959,381.579159,-241.9368,5.191141,44.402553,39.211412,33.70714,1.84862,-31.85852,10.654555,6.44285,-4.211705,0.880186,3.479896,2.59971,8.452936,4.294548,-4.158388,11.938475,0.914537,-11.023938,26.100873,0.012199,-26.088674,,,,,,
2016-12-01,7021.157214,7187.391477,166.234262999998,35179.189872,22978.04351,-12201.146362,189508.14094772,126069.939479222,-63438.2014684978,13940.990951,0,-13940.990951,10337.063192,6659.959693,-3677.103499,36024.23275,32182.86758,-3841.36517,,,,9930.922953,11556.996772,1626.073819,46637.81666,40149.863046,-6487.953614,40876.484535,27097.639052,-13778.845483,2426.062111,2143.15828,-282.903831,68571.51854,34392.626714,-34178.891826,183772.43737,126642.122328,-57130.3150420001,82872.666356,43477.109383,-39395.556973,1823.687329,2462.252244,638.564915,1028.083049,2215.069182,1186.986133,1897.047315,1194.281019,-702.766296000001,0.401336,0.555238,0.153902,23160.296546,21097.662801,-2062.633745,0.00037,0,-0.00037,23477.520114,19052.200245,-4425.319869,332.013633,492.178464,160.164831,3.404642,22.95765,19.553008,189.356097,256.297516,66.941419,353.857714,371.418208,17.560494,238.085471,124.148968,-113.936503,343.962279,539.820084,195.857805,43.78836,475.189203,431.400843,2.55311,63.956077,61.402967,31.978177,197.940215,165.962038,0,29.88146,29.88146,34.225696,134.819576,100.59388,0.786502,32.306147,31.519645,1.209331,60.621458,59.412127,62.580361,80.477181,17.89682,366.412135,678.389004,311.976869,0.187073,4.518651,4.331578,21.213624,15.530396,-5.683228,3.36051,14.592369,11.231859,0.823222,23.464626,22.641404,0.06975,1.331424,1.261674,0.174801,3.202078,3.027277,0.950164,37.249743,36.299579,0.937169,6.183205,5.246036,0.770582,9.644761,8.874179,3.021695,46.056187,43.034492,300.55484,175.732861,-124.821979,,,,15.082969,87.097293,72.014324,24.611001,97.842606,73.231605,0.777617,64.863714,64.086097,0.080144,27.875685,27.795541,1.923632,18.226938,16.303306,1288.015903,1156.196181,-131.819722,1076.053648,411.460027,-664.593621,32.418611,25.106092,-7.312519,5.261204,30.568243,25.307039,0.010673,1.72547,1.714797,532.003178,395.460201,-136.542977,682.888337,712.170299,29.281962,45.874938,51.891132,6.016194,795.93389,988.88354,192.94965,2462.987043,2564.397045,101.410002,12.490099,209.76266,197.272561,45.553977,118.69636,73.142383,572.678709,696.71767,124.038961,0.000442,0.148104,0.147662,25.892619,14.754752,-11.137867,884.376981,310.569802,-573.807179,0.000386,0,-0.000386,323.215102,222.411302,-100.8038,379.412653,175.646036,-203.766617,10.512145,0.752967,-9.759178,566.951403,193.7458,-373.205603,4770.128988,4288.689051,-481.439937,4036.072642,794.578104,-3241.494538,1344.01594,3439.802512,2095.786572,1269.900034,2413.630477,1143.730443,34.086699,62.315793,28.229094,1.651672,0.205267,-1.446405,2.557576,2.78553,0.227954,3584.59561,2921.620642,-662.974968,9686.200318,4363.396045,-5322.804273,887.060839,243.51719,-643.543649,,,,339.150263,159.578317,-179.571946,256.532664,22.899709,-233.632955,539.941894,197.790058,-342.151836,24.866482,4.337373,-20.529109,3250.064476,2230.803994,-1019.260482,65.708311,23.277924,-42.430387,24.480615,22.839746,-1.640869,85.019267,41.847629,-43.171638,491.401773,324.087356,-167.314417,,,,1263.396063,371.325633,-892.07043,5.025393,50.442502,45.417109,29.634873,133.580983,103.94611,2.706405,4.62683,1.920425,0.549974,10.748178,10.198204,3.007537,28.513027,25.50549,52.376755,99.272609,46.895854,0.147919,0.988866,0.840947,2.630072,4.290884,1.660812,0.102364,1.767441,1.665077,5.493004,2.494659,-2.998345,0.655784,4.085212,3.429428,1156.708351,1062.577859,-94.130492,261.68565,110.369301,-151.316349,0.067029,156.670696,156.603667,21.319526,16.346619,-4.972907,0.116058,0.181841,0.065783,0.04981,0.007233,-0.042577,4059.134356,1503.973813,-2555.160543,,,,49.977675,34.036757,-15.940918,55.679953,17.586564,-38.093389,7.298444,5.734426,-1.564018,17.765072,8.424866,-9.340206,,,,24.564576,19.937558,-4.627018,0.147196,2.110811,1.963615,0.043352,0.338894,0.295542,2.089349,3.205276,1.115927,126.622363,59.749437,-66.872926,148.484656,56.816723,-91.667933,52.295347,39.05925,-13.236097,640.667176,734.795932,94.128756,2.245101,77.694996,75.449895,0.648046,0.266425,-0.381621,9.463093,113.201947,103.738854,778.186026,129.868304,-648.317722,6.818328,13.189178,6.37085,1124.851157,720.437854,-404.413303,0,0.022748,0.022748,1.719267,0.032918,-1.686349,111.747982,105.123606,-6.624376,382.081664,715.714135,333.632471,,,,1413.0579,2202.891228,789.833328,72.031278,174.062887,102.031609,266.82167,2082.53897,1815.7173,0.022065,3.561034,3.538969,74.589133,156.412056,81.822923,56.163963,81.930981,25.767018,1.69886,49.539374,47.840514,3441.325185,2094.699567,-1346.625618,298.380832,230.53125,-67.849582,5.953437,3.603924,-2.349513,412.414743,96.973533,-315.44121,213.401303,29.401521,-183.999782,18.04347,21.019116,2.975646,2404.742507,1028.695163,-1376.047344,3314.674326,699.570495,-2615.103831,6.821763,2.875145,-3.946618,180.740937,26.314809,-154.426128,3087.543139,1128.360549,-1959.18259,1190.50392,2343.562836,1153.058916,1511.211212,588.140351,-923.070861,0.593609,0.120263,-0.473346,0.459939,12.969589,12.50965,812.438788,775.158013,-37.2807750000001,14.5646,91.426956,76.862356,0.050327,0.201032,0.150705,1.851287,3.233002,1.381715,39378.216082,11681.799504,-27696.416578,0.491174,3.540269,3.049095,0,0,0,5464.975771,4291.327874,-1173.647897,564.028772,3019.390634,2455.361862,3359.586117,2657.668035,-701.918082,12188.62801,5651.912137,-6536.715873,689.371284,1857.959896,1168.588612,0,0.007274,0.007274,0.235706,0.116914,-0.118792,0.064605,0.020356,-0.044249,0,0,0,11.005772,4.086376,-6.919396,298.985134,288.863964,-10.12117,0.07159,0.411857,0.340267,0.043177,1.773144,1.729967,0.007385,0,-0.007385,0.441204,1.962533,1.521329,0.011413,0.724841,0.713428,0.637873,0.472669,-0.165204,0,0,0,0.209009,0.020103,-0.188906,,,,3.109365,9.463638,6.354273,0,0,0,1.389234,7.601045,6.211811,0.921512,30.735927,29.814415,0.02699,2.66488,2.63789,0.280062,1.804346,1.524284,0.029347,0.038159,0.008812,20.926106,4.560777,-16.365329,0.310706,1.076381,0.765675,82.866772,305.680335,222.813563,279.19922,215.238703,-63.960517,23.511929,40.92255,17.410621,,,,112.21615,331.662614,219.446464,0.38824,2.029852,1.641612,0.057899,0.474014,0.416115,0,0.018467,0.018467,0.325747,4.695797,4.37005,0.135332,5.381753,5.246421,8.530991,8.845365,0.314373999999999,3.27686,12.393718,9.116858,0.108479,6.786054,6.677575,0.396945,7.628983,7.232038,0.646355,5.822064,5.175709,141.58748,30.677653,-110.909827,33.534603,47.048568,13.513965,0.028246,1.230973,1.202727,0.494376,25.24789,24.753514,1.123965,114.375497,113.251532,478.91484,140.205568,-338.709272,0.009263,0.928023,0.91876,12.723925,4.5534,-8.170525,45.569396,4.817361,-40.752035,0.08785,0,-0.08785,1.084947,1.454346,0.369399,1.340821,10.901109,9.560288,180.989406,60.094168,-120.895238,1.775367,7.538495,5.763128,0.004266,0.105443,0.101177,0.303252,0.454993,0.151741,0.031427,0.464304,0.432877,24.561506,7.13986,-17.421646,29.718494,19.127561,-10.590933,1.317995,2.118332,0.800337,3.391451,1.483784,-1.907667,0.014135,0.403972,0.389837,4.696871,36.784103,32.087232,0.003941,0.047266,0.043325,1.255742,6.775756,5.520014,4.860602,8.26207,3.401468,45.512027,22.118155,-23.393872,0.828792,0.831275,0.00248300000000001,0.001637,0.648084,0.646447,7.439187,15.679195,8.240008,23.873974,31.557751,7.683777,15.683425,17.814247,2.130822,49.260402,6.203224,-43.057178,0,0,0,0.015593,0.12469,0.109097,0.05199,0.39731,0.34532,0.014316,0.334841,0.320525,619.765167,431.067997,-188.69717,6.881609,8.691702,1.810093,93.915876,1.393494,-92.522382,7.09902,7.368286,0.269266,0.534545,1.835,1.300455,0.487918,1.00708,0.519162,5.64111,8.256832,2.615722,25.932869,0.077266,-25.855603,,,,,,
2017-01-01,6874.982969,4066.443502,-2808.539467,32828.822951,21290.275554,-11538.547397,195351.73324,127130.89912,-68220.83412,13434.987602,0,-13434.987602,10547.477952,6278.675615,-4268.802337,34523.36858,26063.036434,-8460.332146,,,,9406.406741,11989.747688,2583.340947,47763.889366,40402.383357,-7361.506009,38502.02636,24600.549453,-13901.476907,2780.702548,1482.731378,-1297.97117,69637.487653,30992.81594,-38644.671713,185863.491752,118003.622933,-67859.868819,86179.00215,37490.917056,-48688.085094,1595.713299,2454.76246,859.049161,1208.50127,1950.559504,742.058234,1912.187993,853.454578,-1058.733415,0.18154,0.070325,-0.111215,24282.29969,20868.614415,-3413.685275,0.0052,0,-0.0052,23481.589676,19533.768942,-3947.820734,317.905659,570.510605,252.604946,3.453909,14.288197,10.834288,166.56388,256.14758,89.5837,312.160676,355.255917,43.095241,216.257844,108.805045,-107.452799,309.464462,550.617312,241.15285,30.888602,509.559467,478.670865,1.263456,91.571787,90.308331,28.543762,196.336386,167.792624,0,16.605734,16.605734,18.458165,161.247413,142.789248,0.62195,20.395331,19.773381,1.861919,59.03234,57.170421,58.763903,117.860612,59.096709,273.360778,613.426001,340.065223,0.408678,2.989873,2.581195,0.508723,20.921393,20.41267,4.067093,12.067684,8.000591,2.804822,45.110305,42.305483,0.079438,0.99815,0.918712,0.092625,3.884707,3.792082,2.023045,39.19038,37.167335,0.763046,7.848645,7.085599,0.63698,6.058568,5.421588,4.042366,45.111695,41.069329,276.818311,140.411663,-136.406648,,,,15.420651,75.848646,60.427995,18.443092,39.040888,20.597796,4.54224,81.729713,77.187473,0.11392,23.10455,22.99063,0.267693,16.508317,16.240624,1035.147746,1229.641922,194.494176,1304.085687,348.008117,-956.07757,20.294963,26.115365,5.820402,4.058555,24.132118,20.073563,0.016288,4.986216,4.969928,580.521926,362.553959,-217.967967,749.567439,755.790302,6.22286299999996,29.79624,48.807354,19.011114,1062.531206,1289.2764,226.745194,2229.891393,2736.534787,506.643394,10.101418,214.406354,204.304936,37.504514,108.417069,70.912555,272.286735,638.571155,366.28442,0.000943,0.021666,0.020723,25.053724,15.367804,-9.68592,818.191507,281.993987,-536.19752,0,0,0,343.94288,289.123151,-54.819729,328.369596,155.34629,-173.023306,11.014488,0.098488,-10.916,634.728671,166.382922,-468.345749,4340.855063,3732.258477,-608.596586,4006.33793,749.807275,-3256.530655,1389.870123,3181.64263,1791.772507,1072.146479,2326.516916,1254.370437,30.448424,80.877452,50.429028,0.922783,0.421211,-0.501572,2.372877,7.55435,5.181473,3762.970225,2436.454765,-1326.51546,8781.566083,3898.753538,-4882.812545,810.592704,853.799645,43.206941,,,,323.916085,163.017655,-160.89843,193.462344,30.997428,-162.464916,369.54553,146.634134,-222.911396,21.929508,2.550282,-19.379226,3059.358068,1724.167802,-1335.190266,61.816559,16.591034,-45.225525,24.27265,12.447027,-11.825623,106.111357,37.79289,-68.318467,464.029476,258.225712,-205.803764,,,,1221.516333,314.388857,-907.127476,14.792365,2.709901,-12.082464,78.920625,98.481921,19.561296,2.689252,3.559669,0.870417,39.2804,17.5362,-21.7442,1.866933,20.130228,18.263295,76.780716,48.249071,-28.531645,0.047755,2.371238,2.323483,2.432351,1.461498,-0.970853,0.005209,0.645286,0.640077,0.557017,1.536511,0.979494,0.837734,7.391218,6.553484,997.621087,900.420971,-97.200116,243.555197,119.687711,-123.867486,0.049581,84.385653,84.336072,17.904143,28.527052,10.622909,0.125082,0.148078,0.022996,0.042069,0.097851,0.055782,3645.42593,1418.75223,-2226.6737,,,,36.809984,33.062595,-3.747389,57.045644,21.526409,-35.519235,6.516504,1.929516,-4.586988,13.034069,4.806996,-8.227073,,,,25.076836,9.165214,-15.911622,0.105802,1.832463,1.726661,0.050962,0.235338,0.184376,2.487946,3.057031,0.569085,88.379187,151.788118,63.408931,166.31982,67.337021,-98.982799,52.082765,14.931968,-37.150797,721.39354,646.871073,-74.522467,4.448388,4.701702,0.253314,0.715115,0.505249,-0.209866,8.199393,74.700954,66.501561,890.494295,164.133553,-726.360742,5.646366,4.87074,-0.775626000000001,1146.643996,571.172756,-575.47124,0.000026,0,-0.000026,0.956389,0.220147,-0.736242,137.490976,298.659673,161.168697,201.154269,400.179847,199.025578,,,,1980.212991,1023.002503,-957.210488,82.192259,110.534088,28.341829,458.795853,1418.716244,959.920391,0.304247,4.471041,4.166794,101.929411,152.442409,50.512998,69.714021,59.269696,-10.444325,1.318606,26.234114,24.915508,3791.919252,1702.952164,-2088.967088,315.411876,266.016265,-49.395611,7.66829,2.351143,-5.317147,537.643224,132.223132,-405.420092,260.499447,21.917734,-238.581713,24.894174,17.817098,-7.077076,2381.374261,834.931297,-1546.442964,3973.421169,653.714391,-3319.706778,11.501907,1.636055,-9.865852,255.73142,28.062184,-227.669236,2883.146071,1117.382246,-1765.763825,1214.290713,2355.508644,1141.217931,1707.568113,543.060064,-1164.508049,1.563872,0.187367,-1.376505,1.01033,5.235569,4.225239,827.116694,638.57823,-188.538464,7.035647,36.12152,29.085873,0.007983,0.12506,0.117077,2.449492,2.529603,0.080111,41376.337903,10071.93052,-31304.407383,0.669646,3.402155,2.732509,0,0.00266,0.00266,5953.996106,3368.084222,-2585.911884,604.700489,3711.127515,3106.427026,3375.066059,2228.864002,-1146.202057,10503.667285,5030.781446,-5472.885839,864.64277,1637.869366,773.226596,0.000103,0,-0.000103,0.315539,0.02665,-0.288889,0.32705,0.06722,-0.25983,,,,9.30988,6.158026,-3.151854,309.599593,242.11457,-67.485023,0.00347,0.343162,0.339692,0.603505,0.064197,-0.539308,0.087209,0,-0.087209,0.517847,2.573804,2.055957,0.122374,0.691105,0.568731,0.192868,0.783242,0.590374,,,,0.466788,0.37329,-0.093498,,,,3.426058,3.677713,0.251655,,,,2.091207,7.356566,5.265359,1.617914,38.94606,37.328146,0.012894,2.670207,2.657313,0.013968,1.741775,1.727807,0.013659,0,-0.013659,14.578616,3.529379,-11.049237,0.26682,1.471268,1.204448,100.15065,147.590192,47.439542,497.476342,50.565732,-446.91061,26.155003,85.625429,59.470426,,,,137.443515,331.479214,194.035699,0.869841,3.94415,3.074309,0.006825,0.249989,0.243164,0,0,0,29.832815,6.691375,-23.14144,0.317709,11.437129,11.11942,18.969951,7.849575,-11.120376,3.562012,10.404336,6.842324,0.379947,5.989105,5.609158,0.276016,5.86149,5.585474,0.550454,4.129474,3.57902,140.884414,20.433574,-120.45084,77.014825,44.882202,-32.132623,0.1122,1.982279,1.870079,0.775811,3.426505,2.650694,0.956917,3.584578,2.627661,571.408758,137.076565,-434.332193,0.058452,1.134592,1.07614,11.841456,6.902153,-4.939303,48.382551,0.691227,-47.691324,0.010509,0.103064,0.092555,0.410799,6.25408,5.843281,0.686614,16.536227,15.849613,185.872975,27.846426,-158.026549,1.365977,8.33458,6.968603,0.000513,0.056583,0.05607,0.278786,0.245433,-0.033353,0.033907,0.080897,0.04699,3.088185,11.39368,8.305495,12.062299,7.968355,-4.093944,0.766226,0.055746,-0.71048,4.101438,0.611238,-3.4902,0.035638,5.448987,5.413349,4.475044,10.230187,5.755143,0.10923,0.271268,0.162038,1.60152,14.122642,12.521122,6.264888,4.719017,-1.545871,53.205598,64.025732,10.820134,1.841218,0.531703,-1.309515,0.014357,0.600081,0.585724,14.033013,8.169847,-5.863166,19.420666,2.352482,-17.068184,22.299139,9.413573,-12.885566,53.018574,5.160422,-47.858152,,,,0.104264,0.241963,0.137699,1.983645,0.425715,-1.55793,0.000742,0.816891,0.816149,463.908287,347.042103,-116.866184,14.268039,6.39485,-7.873189,100.274405,3.124455,-97.14995,4.04588,5.675042,1.629162,0.248083,2.119643,1.87156,8.239125,4.831434,-3.407691,5.537774,0.559956,-4.977818,16.451401,0.02971,-16.421691,,,,,,
2017-02-01,6029.678533,4511.748528,-1517.930005,32386.533398,22994.825255,-9391.708143,191832.88388,127438.24074,-64394.64314,14121.107956,0,-14121.107956,10269.154936,6800.664905,-3468.490031,29926.675098,25391.505213,-4535.169885,,,,9218.852338,11160.458842,1941.606504,47174.985194,39285.213938,-7889.771256,37155.165463,26505.397764,-10649.767699,2224.052306,1768.516124,-455.536182,58084.866381,31326.572066,-26758.294315,169374.682278,119238.322434,-50136.359844,72501.114093,38240.676653,-34260.43744,1929.499742,2428.644412,499.14467,1011.47217,2364.231651,1352.759481,1601.964389,1128.462216,-473.502173,0.528938,1.275696,0.746758,23265.290459,21138.290502,-2126.999957,0,0.003048,0.003048,23909.694735,18146.923436,-5762.771299,326.274934,532.57162,206.296686,2.743745,18.019247,15.275502,198.386312,229.544348,31.158036,393.618235,426.992964,33.3747289999999,278.979004,118.703585,-160.275419,349.907934,469.264413,119.356479,27.592227,476.399731,448.807504,1.224688,40.618078,39.39339,29.577701,188.702209,159.124508,0,18.984092,18.984092,22.574941,149.314007,126.739066,1.34947,23.796392,22.446922,0.793801,48.153209,47.359408,73.738277,103.838376,30.100099,382.333323,651.567482,269.234159,0.445009,2.915764,2.470755,0.226552,34.69654,34.469988,3.702627,13.234875,9.532248,0.487622,27.007326,26.519704,0.009596,0.572265,0.562669,0.040727,5.41361,5.372883,2.226602,33.86724,31.640638,0.440614,5.237191,4.796577,0.59496,5.687522,5.092562,6.290691,40.79784,34.507149,313.107754,122.723928,-190.383826,,,,6.722818,74.045141,67.322323,23.865434,91.202263,67.336829,0.973923,117.863809,116.889886,0.240654,5.484878,5.244224,0.262785,12.310224,12.047439,1210.509366,987.443395,-223.065971,1086.440089,407.398584,-679.041505,26.405728,29.444121,3.038393,6.200012,30.446161,24.246149,0.021468,1.747659,1.726191,461.447188,362.590373,-98.856815,602.908471,671.363952,68.4554810000001,37.867173,42.716556,4.849383,931.103519,917.842535,-13.260984,2005.732,2647.764664,642.032664,8.522743,231.879586,223.356843,75.743487,114.134492,38.391005,317.218085,625.994347,308.776262,0.000049,0.162248,0.162199,27.466075,22.439661,-5.026414,756.804799,264.160345,-492.644454,0,0.016836,0.016836,411.090982,338.857655,-72.233327,357.894235,108.069785,-249.82445,8.241997,0.270461,-7.971536,615.128821,165.184967,-449.943854,3930.864864,4377.830768,446.965904,4419.71529,728.591786,-3691.123504,1353.19898,3446.890717,2093.691737,1271.18937,2408.679254,1137.489884,33.082626,85.337458,52.254832,0.950882,0.633296,-0.317586,2.66725,8.036513,5.369263,3624.564677,2503.363995,-1121.200682,8668.112259,4232.652345,-4435.459914,864.590556,952.526858,87.936302,,,,333.836053,172.926327,-160.909726,134.428073,27.912028,-106.516045,330.296837,171.747875,-158.548962,22.321744,5.412588,-16.909156,2340.75578,1549.09169,-791.66409,46.944644,22.219684,-24.72496,21.771051,26.175308,4.404257,156.276472,37.752313,-118.524159,486.812133,292.140008,-194.672125,,,,1021.983368,427.681735,-594.301633,27.628196,4.519055,-23.109141,74.270976,141.673102,67.402126,4.109056,6.332566,2.22351,0.779403,15.905681,15.126278,12.129049,19.392374,7.263325,110.252573,38.278622,-71.973951,0.062375,4.151923,4.089548,2.532538,0.674351,-1.858187,0.03713,0.635679,0.598549,0.701465,91.364089,90.662624,0.376816,17.843967,17.467151,906.422712,992.866105,86.4433929999999,260.140565,93.735414,-166.405151,0.038244,116.875057,116.836813,13.794882,86.29456,72.499678,0.405152,0.065644,-0.339508,0.322479,0.366368,0.043889,3408.281139,1618.675958,-1789.605181,,,,38.726415,47.112958,8.386543,54.482683,14.345532,-40.137151,7.140264,1.933026,-5.207238,26.436398,3.639121,-22.797277,,,,21.626658,6.974532,-14.652126,0.213357,0.563308,0.349951,0.041048,0.281792,0.240744,2.118551,3.947481,1.82893,100.352823,40.52408,-59.828743,149.099815,52.504681,-96.595134,40.716357,17.943238,-22.773119,641.932259,682.714336,40.782077,9.004267,6.660908,-2.343359,0.292694,0.49021,0.197516,7.849877,107.146922,99.297045,656.106175,82.23439,-573.871785,7.860463,7.33734,-0.523123,1062.69031,641.881339,-420.808971,0,0.03118,0.03118,0.324682,0.112202,-0.21248,134.55393,111.073986,-23.479944,382.631755,432.292756,49.661001,,,,2029.820027,1065.20206,-964.617967,106.809052,172.728008,65.918956,318.082082,1691.952786,1373.870704,7.512674,20.127965,12.615291,73.400085,292.508863,219.108778,79.415996,59.46056,-19.955436,2.346457,76.294165,73.947708,3474.321761,1937.826253,-1536.495508,263.345744,267.85945,4.51370599999996,6.937188,4.712376,-2.224812,494.288617,99.270084,-395.018533,221.456033,39.249391,-182.206642,24.505672,18.133488,-6.372184,2212.004852,830.809466,-1381.195386,3136.406875,696.952649,-2439.454226,6.049573,5.032261,-1.017312,236.195987,27.950173,-208.245814,2698.47746,1008.814598,-1689.662862,1216.023199,2341.648737,1125.625538,1568.815901,516.558221,-1052.25768,0.666487,0.196066,-0.470421,1.665285,6.552575,4.88729,807.223184,577.86163,-229.361554,5.503858,35.521292,30.017434,0.000012,0.229222,0.22921,2.161886,4.003118,1.841232,32763.353316,9797.825864,-22965.527452,0.229424,6.160689,5.931265,0,0,0,4870.282987,3572.106146,-1298.176841,440.534254,4067.015073,3626.480819,2864.570561,2049.105887,-815.464674,9872.176562,5200.590602,-4671.58596,661.325781,1870.703368,1209.377587,0,0,0,0.100914,0.026389,-0.074525,0.007436,0,-0.007436,,,,7.142481,3.129714,-4.012767,307.771552,279.138359,-28.633193,0.119514,0.45113,0.331616,0.167945,0.032592,-0.135353,0.002471,0,-0.002471,0.402306,2.216002,1.813696,0.094265,0.700651,0.606386,0.336219,1.215787,0.879568,,,,0.347667,0.041945,-0.305722,,,,4.045637,2.330046,-1.715591,,,,12.618539,8.400186,-4.218353,1.206547,187.325048,186.118501,0.037815,2.997943,2.960128,0.012867,1.469499,1.456632,0.072716,0.007546,-0.06517,15.360647,2.938507,-12.42214,0.267649,1.025897,0.758248,61.690088,198.371979,136.681891,348.126033,91.89791,-256.228123,29.446183,21.736611,-7.709572,,,,132.804846,313.128219,180.323373,6.094685,0.373796,-5.720889,0.007814,0.996787,0.988973,0,0,0,11.156881,6.161845,-4.995036,0.081319,8.19086,8.109541,8.264954,7.446114,-0.81884,7.651585,38.468098,30.816513,0.06843,4.442961,4.374531,0.496691,4.539105,4.042414,0.91409,5.004734,4.090644,177.297611,33.663775,-143.633836,47.382842,112.755516,65.372674,0.04787,2.414149,2.366279,0.165462,4.18134,4.015878,1.634113,62.932146,61.298033,499.363382,155.582925,-343.780457,0.201098,0.908193,0.707095,0.895216,2.811354,1.916138,27.748699,1.522464,-26.226235,7.423717,0.069578,-7.354139,0.387537,2.671178,2.283641,1.5727,13.716802,12.144102,102.523184,28.780896,-73.742288,1.875813,6.961826,5.086013,0.001613,1.71759,1.715977,0.101155,1.373374,1.272219,0.024182,0.050841,0.026659,4.199685,24.966719,20.767034,1.470433,2.469952,0.999519,0.87262,0.167273,-0.705347,2.604055,2.106898,-0.497157,0.041206,5.389171,5.347965,5.093957,12.142405,7.048448,0.026183,0.023682,-0.002501,3.736979,12.363746,8.626767,5.896506,7.374915,1.478409,38.936057,62.556716,23.620659,0.749706,1.067392,0.317686,8.223887,2.975835,-5.248052,8.744416,7.931333,-0.813082999999999,19.233016,3.916574,-15.316442,4.205411,15.787006,11.581595,53.923619,5.252436,-48.671183,,,,0.175809,0,-0.175809,4.798412,0.189631,-4.608781,0.000309,0.734166,0.733857,488.02892,423.807259,-64.221661,17.476359,6.914673,-10.561686,17.854219,1.60433,-16.249889,1.141495,3.835929,2.694434,0.367735,1.284097,0.916362,0.312234,3.700195,3.387961,3.118476,1.358723,-1.759753,20.356785,0.101287,-20.255498,,,,,,
2017-03-01,6971.858388,5568.695933,-1403.162455,36881.144117,25691.543753,-11189.600364,191936.583436,127013.148175,-64923.435261,16840.104706,0,-16840.104706,11403.866154,8051.139447,-3352.726707,37282.493434,31211.171669,-6071.321765,,,,10387.514446,12929.695965,2542.181519,54346.878273,45974.678721,-8372.19955200001,42775.731335,30494.741723,-12280.989612,2525.550067,2124.756009,-400.794058,67167.360445,33613.93322,-33553.427225,194749.663818,135663.2684,-59086.395418,83479.619711,41586.558032,-41893.061679,2225.099324,2790.453744,565.35442,1348.963364,2567.297879,1218.334515,1784.485136,1262.699838,-521.785298,0.703356,3.205604,2.502248,26292.531486,24952.927813,-1339.603673,0.004013,0,-0.004013,28054.346787,21021.750908,-7032.595879,420.20031,587.528237,167.327927,10.997203,25.007342,14.010139,224.496878,271.260871,46.763993,439.969705,476.493887,36.524182,308.229271,181.826198,-126.403073,391.376123,527.239175,135.863052,36.513613,564.985505,528.471892,2.437733,47.748573,45.31084,80.273138,234.455117,154.181979,0,29.152406,29.152406,42.320496,162.082067,119.761571,0.792145,28.707234,27.915089,3.346724,66.160304,62.81358,80.67433,96.237782,15.563452,440.827037,746.105376,305.278339,0.309241,3.588401,3.27916,0.316155,18.806961,18.490806,4.092341,13.106338,9.013997,0.691517,29.724758,29.033241,0.014488,0.776074,0.761586,0.050947,4.511465,4.460518,2.022224,45.576573,43.554349,0.567346,9.254842,8.687496,1.113114,7.176798,6.063684,4.691912,41.162395,36.470483,331.297461,151.286055,-180.011406,,,,11.254027,61.615337,50.36131,21.935426,115.987759,94.052333,1.899609,142.010664,140.111055,0.209911,15.956013,15.746102,1.580748,8.811397,7.230649,1178.313212,1634.932575,456.619363,1234.954597,322.096369,-912.858228,22.535408,28.251611,5.716203,7.089138,27.42932,20.340182,1.417779,2.726777,1.308998,601.756925,424.133814,-177.623111,585.304981,810.119608,224.814627,43.254757,59.601851,16.347094,1042.311899,939.375951,-102.935948,2402.247238,2773.068503,370.821265,10.626354,245.250181,234.623827,35.163757,152.136758,116.973001,358.033619,796.230743,438.197124,0.003609,0,-0.003609,28.618416,19.429666,-9.18875,888.242402,329.609648,-558.632754,0.013639,0.122392,0.108753,360.943204,433.373792,72.430588,364.124991,121.246149,-242.878842,9.760039,0.158733,-9.601306,663.791959,191.466894,-472.325065,4656.916852,4965.451773,308.534920999999,4625.893044,848.596981,-3777.296063,1560.454078,3760.667354,2200.213276,1259.660048,2766.11666,1506.456612,39.813871,72.766596,32.952725,0.852013,0.236694,-0.615319,1.262663,2.992993,1.73033,3863.337165,3508.273024,-355.064141,10075.093166,4819.882799,-5255.210367,1012.026352,273.563687,-738.462665,,,,386.552141,176.413281,-210.13886,272.078151,42.310769,-229.767382,492.378858,174.241419,-318.137439,23.748445,1.794762,-21.953683,2782.668244,2546.112512,-236.555732,62.452633,22.553781,-39.898852,27.576577,27.38046,-0.196117000000001,163.555693,44.512653,-119.04304,603.586518,332.373487,-271.213031,,,,1697.876462,538.63686,-1159.239602,6.087598,6.679603,0.592005,83.5927,167.980118,84.387418,3.197776,5.414998,2.217222,2.493427,19.645077,17.15165,2.967523,26.550963,23.58344,71.633759,46.725096,-24.908663,0.419928,1.607205,1.187277,3.267468,1.232341,-2.035127,0.16756,0.638736,0.471176,0.575207,4.435242,3.860035,0.922964,5.828172,4.905208,1246.95187,1013.669821,-233.282049,256.355495,98.697434,-157.658061,0.000208,113.412819,113.412611,13.632955,4.928257,-8.704698,0.311505,0.096664,-0.214841,0.01091,0,-0.01091,3905.66148,1825.996576,-2079.664904,,,,38.186051,41.339344,3.153293,53.17445,17.541548,-35.632902,6.394929,2.652589,-3.74234,16.996638,2.903016,-14.093622,,,,27.725069,10.637825,-17.087244,0.10709,0.461489,0.354399,0.180601,0.522247,0.341646,2.340633,4.109518,1.768885,99.857353,53.853418,-46.003935,181.934476,117.517755,-64.416721,62.785842,29.049636,-33.736206,759.4506,838.805848,79.355248,5.069646,11.522549,6.452903,0.395093,0.259404,-0.135689,10.928799,86.525751,75.596952,992.378548,91.584851,-900.793697,10.373458,8.571423,-1.802035,1263.479562,699.423397,-564.056165,0,0.477426,0.477426,0.658881,0.260628,-0.398253,133.233737,279.319882,146.086145,295.380993,493.668016,198.287023,,,,2165.040393,1495.159947,-669.880446,148.765064,339.978106,191.213042,456.101728,2057.992258,1601.89053,0.061685,14.695038,14.633353,59.10226,211.747308,152.645048,78.599162,106.159392,27.56023,1.02138,38.247323,37.225943,4143.919068,2114.526422,-2029.392646,309.347275,278.822281,-30.524994,6.469938,6.489576,0.0196379999999996,503.988769,147.491678,-356.497091,262.269893,23.375349,-238.894544,27.971199,50.117829,22.14663,2603.728706,819.41082,-1784.317886,3081.407125,713.197864,-2368.209261,6.2322,1.707625,-4.524575,227.378217,32.796973,-194.581244,3185.25969,1142.535933,-2042.723757,1807.412057,2695.128227,887.71617,1809.868655,621.74164,-1188.127015,0.36594,0.081303,-0.284637,1.6626,6.408222,4.745622,1028.843363,791.62858,-237.214783,5.96244,50.230777,44.268337,0.006277,0.341424,0.335147,2.684877,2.972393,0.287516,34204.696467,9625.836323,-24578.860144,0.328454,6.237326,5.908872,0,0,0,6611.541963,4359.516823,-2252.02514,803.301535,3591.435717,2788.134182,3351.302074,2447.305515,-903.996559,13043.099673,5803.110541,-7239.989132,895.79045,2178.323773,1282.533323,0,0.009147,0.009147,0.241078,0.13899,-0.102088,0.099596,0.021028,-0.078568,,,,7.921253,4.053162,-3.868091,410.698225,296.677987,-114.020238,0.140536,0.358907,0.218371,0.031875,0.227964,0.196089,0.050572,0.008981,-0.041591,0.617649,1.692881,1.075232,0.057674,0.910004,0.85233,0.525203,0.166712,-0.358491,,,,0.297385,0.218153,-0.079232,,,,5.883365,10.304145,4.42078,,,,2.55373,9.906348,7.352618,1.013147,53.396867,52.38372,0.076941,3.281543,3.204602,0.044326,1.52973,1.485404,0.022633,0,-0.022633,22.531716,4.774207,-17.757509,0.350547,1.082231,0.731684,160.768512,263.269092,102.50058,356.505376,120.038502,-236.466874,67.898437,53.074322,-14.824115,,,,112.187067,411.725746,299.538679,1.094402,11.704196,10.609794,0.001043,0.573514,0.572471,0.000414,0.418356,0.417942,0.634723,6.369356,5.734633,0.205222,9.757706,9.552484,19.41098,15.372456,-4.038524,4.070109,11.980327,7.910218,0.6128,6.50578,5.89298,0.572447,9.447334,8.874887,1.102141,12.189838,11.087697,197.925553,30.824659,-167.100894,101.014171,87.128359,-13.885812,0.001,7.964813,7.963813,0.295687,4.216928,3.921241,0.377581,24.697484,24.319903,597.346577,148.484877,-448.8617,0.050209,1.015264,0.965055,3.323648,7.608011,4.284363,18.112394,2.487089,-15.625305,0.08903,0,-0.08903,0.070483,6.79003,6.719547,2.051046,32.085851,30.034805,66.386479,47.802605,-18.583874,2.047457,24.738259,22.690802,0.000573,0.087046,0.086473,0.145532,0.310106,0.164574,0.02655,0.11852,0.09197,4.145904,14.871095,10.725191,7.783051,6.25054,-1.532511,0.642116,0.181443,-0.460673,4.349431,1.432335,-2.917096,0.022868,13.719657,13.696789,6.571906,19.674256,13.10235,0.000513,0.047316,0.046803,1.877852,18.707273,16.829421,5.863755,4.146115,-1.71764,38.200364,42.085612,3.885248,0.856953,1.484975,0.628022,0.022781,0.403238,0.380457,23.608385,17.036784,-6.571601,22.561295,23.796201,1.234906,1.821284,11.478238,9.656954,83.932295,4.64935,-79.282945,,,,0.091108,0.0052,-0.085908,0.03574,0.770591,0.734851,0.000003,0.766202,0.766199,502.882463,436.128419,-66.754044,4.792383,14.924635,10.132252,11.106093,3.857595,-7.248498,3.057169,5.248001,2.190832,0.534465,2.294283,1.759818,1.181828,1.830008,0.64818,5.240201,3.077205,-2.162996,25.158573,0.104657,-25.053916,,,,,,
2017-04-01,5977.447101,4895.872047,-1081.575054,35498.715834,22960.174026,-12538.541808,193780.704215,126673.452777,-67107.251438,14726.930659,0,-14726.930659,10752.494877,7526.824226,-3225.670651,34668.166026,28627.073879,-6041.092147,,,,9370.133129,12016.004852,2645.871723,49491.256537,41564.566166,-7926.690371,41367.689003,26786.249632,-14581.439371,2559.010186,1943.063238,-615.946948,67156.58011,32125.559828,-35031.020282,186346.747924,123764.586962,-62582.160962,82246.88678,39045.041567,-43201.845213,1910.99091,2351.759919,440.769009,1295.802121,2355.023171,1059.22105,1978.610287,1159.738286,-818.872001,0.890869,0.583168,-0.307701,24333.546175,22701.020959,-1632.525216,0.00424,0.002595,-0.001645,25157.710362,18863.545207,-6294.165155,341.043222,434.126455,93.083233,5.815802,40.41149,34.595688,180.958865,254.654897,73.696032,385.868295,387.491455,1.62315999999998,272.367607,117.503769,-154.863838,358.159804,518.404131,160.244327,35.286402,584.135955,548.849553,2.106526,63.302231,61.195705,41.264428,219.637353,178.372925,0,18.652506,18.652506,30.330951,160.961442,130.630491,1.418041,24.993876,23.575835,2.16133,70.758286,68.596956,84.249284,125.538245,41.288961,372.593117,639.579212,266.986095,0.5316,5.906069,5.374469,0.296843,15.855373,15.55853,4.138033,10.176817,6.038784,0.82764,17.341115,16.513475,0.355307,0.486557,0.13125,0.142097,7.360166,7.218069,1.433315,13.223429,11.790114,0.395107,4.385072,3.989965,1.273233,7.409824,6.136591,3.722297,42.800865,39.078568,363.743317,126.295615,-237.447702,,,,6.86902,42.707624,35.838604,15.754032,33.545156,17.791124,1.708527,102.55798,100.849453,0.08853,15.761785,15.673255,0.756173,12.555474,11.799301,1102.514171,1004.291946,-98.222225,1114.842346,379.675755,-735.166591,28.533355,34.100084,5.566729,4.591353,26.4412,21.849847,0.073221,1.507335,1.434114,492.540459,448.150546,-44.389913,410.25466,667.775044,257.520384,34.280979,45.718721,11.437742,909.881784,1088.690039,178.808255,2336.371701,2809.337627,472.965926,9.13598,294.926267,285.790287,47.733411,173.197621,125.46421,359.576303,923.644843,564.06854,4.144661,0.0276,-4.117061,36.982381,20.929934,-16.052447,869.662893,298.761978,-570.900915,0,0.013183,0.013183,403.38779,297.050925,-106.336865,442.791979,93.912144,-348.879835,8.66949,0.325567,-8.343923,756.595786,179.227825,-577.367961,4447.560895,4720.943516,273.382621000001,3881.507618,1061.119472,-2820.388146,1341.087229,3742.250815,2401.163586,1162.001842,2444.510658,1282.508816,45.252838,75.701694,30.448856,0.82635,0.167562,-0.658788,12.567023,2.083468,-10.483555,3687.544794,2758.53502,-929.009774,9660.559254,4179.276922,-5481.282332,989.113946,238.94421,-750.169736,,,,354.047362,173.092801,-180.954561,306.647148,32.587607,-274.059541,428.672148,176.56064,-252.111508,25.516894,3.76179,-21.755104,2995.980041,1420.74564,-1575.234401,38.299155,19.504393,-18.794762,27.868732,32.556811,4.688079,106.851001,48.634548,-58.216453,579.913238,289.008462,-290.904776,,,,1347.111132,667.037252,-680.07388,31.896021,4.656152,-27.239869,77.600121,180.723374,103.123253,4.722479,2.65914,-2.063339,1.403158,185.742222,184.339064,18.358771,31.939051,13.58028,53.204888,52.681529,-0.523358999999999,0.757441,1.891715,1.134274,2.838485,2.155553,-0.682932,0.048943,1.412625,1.363682,2.205512,17.870115,15.664603,4.948209,8.639747,3.691538,1404.495923,751.865669,-652.630254,260.194066,56.869838,-203.324228,0.012401,155.595034,155.582633,13.098963,8.622141,-4.476822,0.235953,0.085068,-0.150885,0.145507,0.447037,0.30153,4276.043949,1369.856145,-2906.187804,,,,33.120504,34.594477,1.473973,61.712588,29.859101,-31.853487,6.365782,2.666779,-3.699003,15.318614,2.194692,-13.123922,,,,21.427184,14.463862,-6.963322,0.344497,0.329094,-0.015403,0.227733,1.308266,1.080533,1.798567,7.095541,5.296974,95.440899,63.145361,-32.295538,184.501852,57.724146,-126.777706,42.351662,16.69869,-25.652972,794.071802,739.403689,-54.6681130000001,1.77757,5.808942,4.031372,0.353495,0.333941,-0.019554,9.860199,102.562784,92.702585,1092.841649,75.163599,-1017.67805,5.661279,5.040731,-0.620548,1012.438511,793.707677,-218.730834,0,0.046495,0.046495,0.290552,0.231111,-0.059441,111.464795,148.24458,36.779785,172.91265,425.069035,252.156385,,,,1621.122077,1413.586089,-207.535988,95.931099,188.638768,92.707669,354.939023,1509.133959,1154.194936,0.137628,17.791631,17.654003,65.801463,289.026108,223.224645,71.490282,55.818527,-15.671755,1.413717,141.741197,140.32748,3730.469824,1939.39926,-1791.070564,253.330739,221.539051,-31.791688,5.488103,3.206007,-2.282096,422.730101,108.439986,-314.290115,219.741062,22.938376,-196.802686,24.899656,15.129541,-9.770115,2327.597674,863.490384,-1464.10729,3951.863366,676.563773,-3275.299593,7.09088,0.769975,-6.320905,216.332792,34.90806,-181.424732,2789.168932,1033.878691,-1755.290241,1608.469174,2520.169549,911.700375,1635.531927,528.589964,-1106.941963,0.215177,0.039593,-0.175584,1.37421,6.790031,5.415821,950.560415,683.791937,-266.768478,9.684932,38.606334,28.921402,0.007274,0.225381,0.218107,2.053187,4.490487,2.4373,37471.938155,9839.701224,-27632.236931,0.361618,7.81779,7.456172,0,0,0,6184.858251,4429.381373,-1755.476878,661.627,2644.877633,1983.250633,3397.441916,2139.225399,-1258.216517,11182.131751,5970.373152,-5211.758599,863.285203,2028.519175,1165.233972,0.000103,0.003707,0.003604,0.053487,0.021029,-0.032458,0.008064,0.011379,0.003315,,,,42.312785,6.315528,-35.997257,358.195459,255.339838,-102.855621,1.726982,0.647825,-1.079157,0.157943,0.056777,-0.101166,0.006617,0.020793,0.014176,0.442407,1.466398,1.023991,0.339611,0.670979,0.331368,0.279727,0.096564,-0.183163,,,,0.206734,1.623253,1.416519,,,,4.347359,4.071428,-0.275931,,,,3.131954,10.802074,7.67012,1.774407,36.297125,34.522718,0.087295,2.842828,2.755533,0.04863,1.355006,1.306376,0.063542,0.015969,-0.047573,18.992712,3.463517,-15.529195,0.323358,1.260222,0.936864,108.691994,220.19304,111.501046,243.415425,130.688553,-112.726872,33.175947,36.849024,3.673077,,,,139.985956,375.899028,235.913072,1.445219,9.676399,8.23118,0.003899,0.285156,0.281257,0,0,0,13.625874,5.15505,-8.470824,28.034294,3.599571,-24.434723,10.418449,17.312855,6.894406,4.808048,10.322376,5.514328,0.562783,3.946353,3.38357,0.165188,10.068464,9.903276,1.23066,5.537503,4.306843,139.922275,23.247118,-116.675157,141.150362,71.877808,-69.272554,0.000484,4.344141,4.343657,0.4264,1.820808,1.394408,1.102057,84.253966,83.151909,598.855998,203.773656,-395.082342,0.128581,0.256592,0.128011,10.443206,4.122789,-6.320417,1.16824,0.900346,-0.267894,0.497105,0.010609,-0.486496,0.665089,1.794277,1.129188,0.851289,24.336792,23.485503,120.809031,93.933111,-26.87592,3.978794,8.364246,4.385452,0,0.169744,0.169744,0.349547,0.325852,-0.023695,0.007247,0.438882,0.431635,6.005098,7.087211,1.082113,4.55613,4.739814,0.183684,1.743813,0.170845,-1.572968,1.752259,1.022113,-0.730146,0.109872,2.868062,2.75819,10.843257,50.438049,39.594792,0.00066,0.325333,0.324673,1.121102,12.652079,11.530977,4.680156,6.900163,2.220007,42.060819,16.766722,-25.294097,0.805777,1.49681,0.691033,0.03143,0.345955,0.314525,9.265405,15.777878,6.512473,20.742618,4.536516,-16.206102,3.778928,7.037984,3.259056,73.804201,1.682515,-72.121686,,,,0.133458,0.020945,-0.112513,1.404788,0.372996,-1.031792,0.062384,0.050985,-0.011399,636.049105,438.428859,-197.620246,7.186349,5.12643,-2.059919,17.820636,1.243744,-16.576892,2.111426,6.768122,4.656696,0.303801,2.323121,2.01932,11.508357,4.831541,-6.676816,13.150696,2.342036,-10.80866,21.589795,0.373715,-21.21608,,,,,,
2017-05-01,6413.01285,4941.481347,-1471.531503,36488.141595,23732.006285,-12756.13531,193091.873512,126810.266599,-66281.606913,15782.686394,0,-15782.686394,11491.075728,8220.956059,-3270.119669,37948.679715,28480.572148,-9468.107567,,,,10117.976091,12509.343202,2391.367111,53499.126178,44839.472726,-8659.653452,42973.140483,27939.054477,-15034.086006,2798.417055,1926.309927,-872.107128,72248.262396,31411.999635,-40836.262761,200577.338083,128051.825674,-72525.512409,89956.054554,38450.508946,-51505.545608,2205.357795,2407.045472,201.687677,1256.365606,2452.827325,1196.461719,2066.925237,1178.409638,-888.515599,0.388966,0.273034,-0.115932,26331.309893,24962.559775,-1368.750118,0.275015,0.257857,-0.017158,27167.816285,19876.912951,-7290.903334,371.742541,509.873013,138.130472,6.993502,29.664106,22.670604,214.096296,230.850498,16.754202,429.856622,451.064345,21.207723,281.196641,114.661451,-166.53519,470.588557,500.155029,29.566472,39.557496,541.191199,501.633703,2.641923,51.193642,48.551719,25.534956,274.704238,249.169282,0,33.563468,33.563468,20.746797,171.317287,150.57049,0.25931,26.056863,25.797553,1.253517,88.564026,87.310509,78.273337,104.168729,25.895392,437.877138,600.441136,162.563998,0.260509,4.126237,3.865728,1.154864,19.761923,18.607059,4.388496,11.068141,6.679645,1.678256,26.953293,25.275037,0.015665,0.429191,0.413526,0.134499,4.149296,4.014797,6.005714,26.687919,20.682205,1.328579,6.267418,4.938839,2.011273,6.898934,4.887661,4.555482,32.663135,28.107653,313.493603,157.327361,-156.166242,,,,8.099025,39.72794,31.628915,15.765056,77.209994,61.444938,1.823871,73.459231,71.63536,0.118697,19.272321,19.153624,1.64294,9.405142,7.762202,1290.981245,1097.865791,-193.115454,1224.348386,332.028549,-892.319837,41.308528,43.175328,1.8668,6.808387,27.202134,20.393747,0.072466,1.239186,1.16672,578.192173,362.746372,-215.445801,455.998673,643.253895,187.255222,55.131406,51.445255,-3.686151,770.913315,1017.40265,246.489335,2472.436986,3320.111811,847.674825,8.429542,259.71301,251.283468,51.647678,214.202968,162.55529,414.973662,896.079747,481.106085,3.638482,0,-3.638482,31.972653,39.583633,7.61098,934.679825,342.935627,-591.744198,0.000501,0.061162,0.060661,400.567848,571.071225,170.503377,480.18897,137.70359,-342.48538,14.480382,0.434185,-14.046197,624.326775,178.567118,-445.759657,4600.458543,5029.513347,429.054804,4290.529584,841.487762,-3449.041822,1405.790126,3525.928923,2120.138797,1345.850104,2480.460385,1134.610281,37.716011,62.001561,24.28555,1.245786,0.131663,-1.114123,4.39504,3.386802,-1.008238,4212.239892,2566.218164,-1646.021728,9481.514488,4488.648175,-4992.866313,1039.189473,196.983612,-842.205861,,,,371.868906,163.665198,-208.203708,265.341434,70.222378,-195.119056,412.46326,174.801573,-237.661687,27.83763,1.527922,-26.309708,3460.021727,1751.600721,-1708.421006,35.998462,21.873275,-14.125187,26.917273,21.267758,-5.649515,100.131014,48.07577,-52.055244,572.533336,358.84538,-213.687956,,,,1414.738741,480.634432,-934.104309,21.739048,5.542847,-16.196201,74.526522,111.092185,36.565663,4.577556,5.194608,0.617051999999999,33.24124,12.46115,-20.78009,14.670154,25.527206,10.857052,72.415652,42.581184,-29.834468,1.193085,2.639769,1.446684,3.062487,1.342433,-1.720054,0.031839,1.690318,1.658479,0.629933,14.042088,13.412155,1.465176,4.114228,2.649052,1380.083239,1035.487112,-344.596127,299.549751,139.649124,-159.900627,0.06925,61.022097,60.952847,15.275949,27.725996,12.450047,0.242848,0.234112,-0.00873600000000002,0.011324,0,-0.011324,4099.43295,1480.950839,-2618.482111,,,,32.763955,42.629436,9.865481,62.464253,47.434254,-15.029999,7.584248,1.988801,-5.595447,21.117573,3.633824,-17.483749,,,,25.905195,8.240975,-17.66422,0.169827,0.497652,0.327825,0.16616,1.247787,1.081627,5.684186,5.630307,-0.0538790000000002,110.938983,68.472986,-42.465997,191.239674,131.412948,-59.826726,56.425527,40.125051,-16.300476,841.235277,1049.892876,208.657599,2.229838,8.918943,6.689105,0.256115,0.678755,0.42264,13.410943,79.72036,66.309417,879.3377,91.145172,-788.192528,4.693855,5.936776,1.242921,1274.553968,688.618437,-585.935531,0,0,0,0.396854,0.305543,-0.091311,132.858004,151.801814,18.94381,282.832395,430.58715,147.754755,,,,1954.160364,1580.118048,-374.042316,72.552697,127.627371,55.074674,395.899739,1545.145796,1149.246057,0.018738,19.807268,19.78853,78.212115,120.421144,42.209029,88.188741,79.75862,-8.430121,1.225195,41.238462,40.013267,4531.090559,2056.889205,-2474.201354,321.533076,269.689134,-51.843942,5.890886,3.673236,-2.21765,462.894647,155.984237,-306.91041,222.250018,26.26956,-195.980458,30.370961,11.312452,-19.058509,2563.892852,861.079217,-1702.813635,4277.783742,787.937849,-3489.845893,8.992033,0.944837,-8.047196,209.537869,28.875692,-180.662177,3268.524399,1265.684573,-2002.839826,1727.417696,2346.376381,618.958685,1853.681603,443.530702,-1410.150901,0.000005,0.530818,0.530813,0.680894,4.720352,4.039458,1049.898483,596.876088,-453.022395,8.116555,38.605642,30.489087,0.185257,0.134183,-0.051074,1.806642,2.121306,0.314664,41801.610037,10193.30036,-31608.309677,0.688823,7.236668,6.547845,0,0,0,5958.859572,4494.864327,-1463.995245,739.168986,2565.595702,1826.426716,3651.616251,1912.881069,-1738.735182,10966.969725,5168.369826,-5798.599899,843.807755,2120.561897,1276.754142,0.026512,0.038074,0.011562,0.01713,0.046799,0.029669,0.217057,0.014404,-0.202653,,,,5.823095,5.49321,-0.329885,372.087345,255.139506,-116.947839,0.001235,0.470018,0.468783,0.253655,0.017512,-0.236143,0.000905,0.027668,0.026763,0.501633,1.804604,1.302971,0.209273,0.892158,0.682885,0.529411,0.465613,-0.063798,,,,0.239542,1.834862,1.59532,,,,9.574304,4.846229,-4.728075,,,,3.188772,8.322852,5.13408,0.830492,41.048113,40.217621,0.048495,5.477221,5.428726,0.020348,1.406138,1.38579,0.263201,0.016007,-0.247194,18.33993,2.931901,-15.408029,0.280401,1.890167,1.609766,76.171396,242.108606,165.93721,276.65328,158.821877,-117.831403,37.734306,48.536056,10.80175,,,,191.751165,283.426395,91.67523,1.161286,4.466176,3.30489,0.00162,1.873644,1.872024,0.000014,0,-0.000014,50.938207,9.585447,-41.35276,0.342639,4.144147,3.801508,7.823014,17.215917,9.392903,6.871761,11.560271,4.68851,0.082652,4.685065,4.602413,0.477536,14.441957,13.964421,1.1188,9.866744,8.747944,88.366084,17.751776,-70.614308,87.077492,51.41456,-35.662932,0.051422,2.578223,2.526801,0.364851,2.724583,2.359732,1.551573,15.081871,13.530298,389.331764,164.178853,-225.152911,0.027321,1.205501,1.17818,8.569353,5.701826,-2.867527,49.093159,2.135111,-46.958048,0.511393,0,-0.511393,0.863449,5.467787,4.604338,0.919171,21.615339,20.696168,200.235699,123.258643,-76.977056,1.144879,7.231266,6.086387,0.003659,0.069627,0.065968,0.539883,0.385512,-0.154371,0.119372,0.102851,-0.016521,6.367615,6.351472,-0.0161429999999996,7.941086,12.451711,4.510625,0.473635,1.058265,0.58463,1.00516,55.709365,54.704205,0.000159,5.794383,5.794224,16.10118,23.624214,7.523034,0.011602,0.109645,0.098043,5.022482,22.108932,17.08645,6.395208,5.462989,-0.932219,46.445551,31.495771,-14.94978,1.64044,1.511944,-0.128496,0.000564,0.460568,0.460004,11.769113,12.503373,0.734259999999999,26.843755,3.490216,-23.353539,23.21886,10.172172,-13.046688,73.921443,2.105062,-71.816381,,,,0.098379,0.561324,0.462945,2.452871,0.306671,-2.1462,0.011384,0.035561,0.024177,762.657195,398.742283,-363.914912,5.990419,7.745353,1.754934,106.756986,1.293083,-105.463903,21.346613,3.447223,-17.89939,1.165702,2.096679,0.930977,0.855102,2.393327,1.538225,5.376133,0.95947,-4.416663,23.61605,0.027144,-23.588906,,,,,,
2017-06-01,6079.159001,5258.226254,-820.932747,36237.815983,23768.073395,-12469.742588,192764.098524,128759.178092,-64004.920432,15695.486247,0,-15695.486247,11363.743886,8402.114295,-2961.629591,39626.60522,30805.776296,-8820.828924,,,,9676.47163,12375.560301,2699.088671,53173.058242,46591.106368,-6581.951874,42498.750276,28397.797243,-14100.953033,2751.853356,1967.700117,-784.153239,72990.53016,33172.014658,-39818.515502,198390.703433,133071.439994,-65319.263439,88938.219127,41161.620166,-47776.598961,2075.876206,2665.791545,589.915339,1349.973173,2577.039298,1227.066125,2054.420918,1353.68685,-700.734068,2.377588,0.616501,-1.761087,25864.098327,25240.56705,-623.531276999998,0.000041,0,-0.000041,27308.959915,21350.539318,-5958.420597,315.355916,755.230592,439.874676,81.292822,19.684032,-61.60879,216.04542,256.063839,40.018419,416.030989,388.719498,-27.311491,291.366031,118.380849,-172.985182,410.388853,500.450684,90.061831,42.508763,532.271645,489.762882,2.283457,43.90056,41.617103,20.895148,313.960405,293.065257,0,26.300169,26.300169,24.120383,179.119876,154.999493,0.254839,28.614352,28.359513,1.375128,161.268631,159.893503,75.401085,118.259281,42.858196,426.688997,646.946083,220.257086,0.249095,2.678285,2.42919,1.130492,54.173603,53.043111,4.010383,11.857411,7.847028,2.585456,37.065215,34.479759,0.062771,0.880327,0.817556,0.146709,8.10132,7.954611,3.167729,72.655151,69.487422,0.269496,8.466934,8.197438,1.046924,10.108564,9.06164,3.700389,49.018206,45.317817,257.164696,159.58925,-97.575446,,,,6.726612,37.705056,30.978444,15.638869,48.473827,32.834958,1.198525,56.648413,55.449888,0.136324,27.271866,27.135542,0.076686,16.840886,16.7642,1068.093115,1005.463345,-62.6297699999999,918.785771,435.8994,-482.886371,36.359412,23.123325,-13.236087,5.288012,32.866922,27.57891,0.065558,1.656363,1.590805,507.510224,300.271412,-207.238812,532.624116,648.466339,115.842223,44.153896,58.656496,14.5026,849.419868,1088.987915,239.568047,2577.144422,2952.363874,375.219452,11.257073,174.954553,163.69748,48.883044,99.114659,50.231615,455.566709,863.02463,407.457921,0.001423,0.006258,0.004835,34.444184,55.341711,20.897527,871.382193,267.488264,-603.893929,0,0.068535,0.068535,479.140571,419.157227,-59.983344,573.233892,96.936526,-476.297366,12.518081,0.154718,-12.363363,550.539744,184.950811,-365.588933,4300.729498,4676.395342,375.665844,4169.05062,1028.374193,-3140.676427,1357.39817,3492.510878,2135.112708,1186.678657,2720.222252,1533.543595,41.865789,158.570036,116.704247,0.848826,0.19098,-0.657846,2.459366,1.836695,-0.622671,3833.438763,2553.487125,-1279.951638,9989.946481,4496.455768,-5493.490713,949.570668,283.062168,-666.5085,,,,416.383404,186.280372,-230.103032,284.100393,41.1598,-242.940593,441.783567,140.519004,-301.264563,24.940338,1.888301,-23.052037,3067.165752,2146.312188,-920.853564,41.308897,26.952897,-14.356,38.350664,43.616814,5.26615,91.340811,49.118348,-42.222463,592.582135,533.012208,-59.569927,,,,1502.628865,785.85439,-716.774475,10.233089,6.175883,-4.057206,96.614992,143.605719,46.990727,5.892618,2.772401,-3.120217,40.447588,12.116012,-28.331576,8.200265,26.929448,18.729183,65.326108,47.530442,-17.795666,1.135709,2.237783,1.102074,3.249322,1.288044,-1.961278,0.220411,0.561527,0.341116,1.011657,90.771349,89.759692,0.801108,5.903988,5.10288,1386.312609,876.558322,-509.754287,332.031837,72.694814,-259.337023,0.063829,83.086575,83.022746,14.603118,4.420115,-10.183003,0.720019,0.20348,-0.516539,0.238786,0.035,-0.203786,4315.494233,1523.28728,-2792.206953,,,,36.659177,23.151262,-13.507915,62.450438,43.067659,-19.382779,4.475546,2.124048,-2.351498,12.496298,1.468774,-11.027524,,,,33.712035,15.393408,-18.318627,0.143957,0.623386,0.479429,0.230901,1.488123,1.257222,2.390146,4.861677,2.471531,115.311567,51.944296,-63.367271,191.716935,90.563088,-101.153847,50.201206,97.776436,47.57523,849.183926,769.742036,-79.4418900000001,3.350517,5.497317,2.1468,1.142913,0.660877,-0.482036,10.073112,93.406845,83.333733,1057.916625,93.126055,-964.79057,1.627275,9.557426,7.930151,1345.101661,881.449767,-463.651894,0,0,0,1.092742,0.327802,-0.76494,131.735874,184.150789,52.414915,190.884627,656.484782,465.600155,,,,1695.230482,1505.512599,-189.717883,72.838942,99.414171,26.575229,334.400174,1767.575423,1433.175249,0.190147,25.836092,25.645945,65.252557,91.358946,26.106389,94.416812,101.069716,6.65290400000001,1.311197,58.563337,57.25214,3938.534642,2354.285496,-1584.249146,288.70095,162.813234,-125.887716,10.289146,32.447513,22.158367,489.785432,130.032126,-359.753306,210.590518,26.03946,-184.551058,20.170389,14.19109,-5.979299,2724.147768,1078.744875,-1645.402893,3936.786431,566.974853,-3369.811578,8.217826,4.431394,-3.786432,217.450031,31.051701,-186.39833,3297.031404,1079.723737,-2217.307667,1729.883087,2606.824805,876.941718,1632.867383,624.983279,-1007.884104,0.026095,0.041538,0.015443,0.873754,29.844791,28.971037,925.374711,678.716539,-246.658172,8.301986,33.94391,25.641924,0.205535,0.193461,-0.012074,0.460114,2.263778,1.803664,42291.924396,9710.26651,-32581.657886,0.353404,6.341277,5.987873,0,0,0,6075.253048,4226.968141,-1848.284907,796.13507,4017.519217,3221.384147,3743.624674,2050.459749,-1693.164925,11166.656343,5594.960361,-5571.695982,836.497031,2230.885109,1394.388078,0,0,0,0.152024,0.003661,-0.148363,0.000115,0.059949,0.059834,,,,6.183023,4.160569,-2.022454,479.92425,282.757941,-197.166309,0.505395,0.278961,-0.226434,0.091116,0.012688,-0.078428,0.009299,0.020244,0.010945,0.480815,2.303557,1.822742,0.156811,0.81348,0.656669,0.167022,0.529379,0.362357,,,,0.221157,0.349949,0.128792,,,,2.78522,5.67879,2.89357,,,,1.689294,17.29849,15.609196,0.705849,22.497442,21.791593,0.036576,3.191649,3.155073,0.082003,1.167972,1.085969,0.239869,0,-0.239869,19.701818,4.057988,-15.64383,0.334549,0.852763,0.518214,57.437042,166.136973,108.699931,374.339401,91.663105,-282.676296,36.880011,44.457486,7.577475,,,,136.563791,299.721816,163.158025,1.623671,2.292538,0.668867,0,1.560047,1.560047,0.005351,0,-0.005351,92.295261,25.075433,-67.219828,0.578264,4.91804,4.339776,8.619325,8.089929,-0.529396,5.186505,24.962595,19.77609,0.159188,4.728025,4.568837,0.500955,6.989996,6.489041,1.420998,7.113493,5.692495,67.300272,29.64468,-37.655592,16.243203,57.379094,41.135891,0.016637,3.192718,3.176081,0.582531,1.419923,0.837392,1.033001,43.06109,42.028089,531.839648,217.111748,-314.7279,0.025577,0.503381,0.477804,31.959055,5.84965,-26.109405,10.041505,3.342624,-6.698881,0.011023,0.01953,0.008507,0.23638,6.28476,6.04838,0.737078,17.859547,17.122469,270.254233,64.775142,-205.479091,2.134134,11.7177,9.583566,0.000008,0.480762,0.480754,0.144053,2.097937,1.953884,0.017552,0.156086,0.138534,2.991277,6.624375,3.633098,9.191328,5.701106,-3.490222,0.800736,1.145886,0.34515,1.979227,0.673154,-1.306073,0.119158,1.211078,1.09192,18.181886,104.342906,86.16102,0.00622,0.222765,0.216545,0.724864,11.382418,10.657554,8.654826,5.758383,-2.896443,44.699707,64.678267,19.97856,1.370839,0.817022,-0.553817,0.001224,0.308286,0.307062,13.039805,16.396046,3.356241,19.339592,3.153348,-16.186244,10.364908,14.183147,3.818239,60.760357,6.288343,-54.472014,,,,4.214805,0.032096,-4.182709,0.581135,0.615128,0.0339930000000001,0.039906,0.054336,0.01443,706.829367,489.189573,-217.639794,25.369776,12.410166,-12.95961,29.981925,1.25517,-28.726755,3.685155,5.245274,1.560119,0.543368,1.392988,0.84962,5.745402,2.464707,-3.280695,6.843075,1.182617,-5.660458,26.1433,0.082507,-26.060793,,,,,,
